nombre,tirosTotalesAnotados,tirosTotalesIntentados,tirosTotalesPorcentaje,tiros3Anotados,tiros3Intentados,tiros3Porcentaje,tiros2Anotados,tiros2Intentados,tiros2Porcentaje,tirosLibresAnotados,tirosLibresIntentados,tirosLibresPorcentaje,rebotesOfensivos,rebotesDefensivos,rebotesTotales,asistencias,robos,perdidas,tapones,faltas,puntos,temporada
"Acres,Mark",138,285,.484,3,4,.750,135,281,.480,83,120,.692,154,277,431,67,36,70,25,248,362,1989/1990
"Adams,Michael",398,989,.402,158,432,.366,240,557,.431,267,314,.850,49,176,225,495,121,141,3,133,1221,1989/1990
"Aguirre,Mark",438,898,.488,31,93,.333,407,805,.506,192,254,.756,117,188,305,145,34,121,19,201,1099,1989/1990
"Ainge,Danny",506,1154,.438,108,289,.374,398,865,.460,222,267,.831,69,257,326,453,113,185,18,238,1342,1989/1990
"Alarie,Mark",371,785,.473,10,49,.204,361,736,.490,108,133,.812,151,223,374,142,60,101,39,219,860,1989/1990
"Alford,Steve",63,138,.457,7,22,.318,56,116,.483,35,37,.946,2,23,25,39,15,16,3,22,168,1989/1990
"Allen,Randy",106,239,.444,0,7,.000,106,232,.457,23,43,.535,49,89,138,23,16,28,19,102,235,1989/1990
"Anderson,Greg",219,432,.507,0,0,,219,432,.507,91,170,.535,112,261,373,24,32,80,54,176,529,1989/1990
"Anderson,Nick",372,753,.494,1,17,.059,371,736,.504,186,264,.705,107,209,316,124,69,138,34,140,931,1989/1990
"Anderson,Richard",88,211,.417,37,100,.370,51,111,.459,18,23,.783,33,94,127,55,20,26,9,64,231,1989/1990
"Anderson,Ron",379,841,.451,3,21,.143,376,820,.459,165,197,.838,81,214,295,143,72,78,13,143,926,1989/1990
"Anderson,Willie",532,1082,.492,7,26,.269,525,1056,.497,217,290,.748,115,257,372,364,111,198,58,252,1288,1989/1990
"Ansley,Michael",231,465,.497,0,0,,231,465,.497,164,227,.722,187,175,362,40,24,50,17,152,626,1989/1990
"Armstrong,B.J.",190,392,.485,3,6,.500,187,386,.484,69,78,.885,19,83,102,199,46,83,6,105,452,1989/1990
"Bagley,John",100,218,.459,1,18,.056,99,200,.495,29,39,.744,26,63,89,296,40,90,4,77,230,1989/1990
"Bailey,Thurl",470,977,.481,0,8,.000,470,969,.485,222,285,.779,116,294,410,137,32,139,100,175,1162,1989/1990
"Bannister,Ken",77,161,.478,0,1,.000,77,160,.481,52,110,.473,39,73,112,18,17,44,7,92,206,1989/1990
"Barkley,Charles",706,1177,.600,20,92,.217,686,1085,.632,557,744,.749,361,548,909,307,148,243,50,250,1989,1989/1990
"Barros,Dana",299,738,.405,95,238,.399,204,500,.408,89,110,.809,35,97,132,205,53,123,1,97,782,1989/1990
"Battle,John",275,544,.506,2,13,.154,273,531,.514,102,135,.756,27,72,99,154,28,89,3,115,654,1989/1990
"Battle,Kenny",93,170,.547,1,4,.250,92,166,.554,55,82,.671,44,80,124,38,35,32,11,94,242,1989/1990
"Bedford,William",54,125,.432,1,6,.167,53,119,.445,9,22,.409,15,43,58,4,3,21,17,39,118,1989/1990
"Benjamin,Benoit",362,688,.526,0,1,.000,362,687,.527,235,321,.732,156,501,657,159,59,187,187,217,959,1989/1990
"Bennett,Winston",137,286,.479,0,0,,137,286,.479,64,96,.667,84,104,188,54,23,62,10,133,338,1989/1990
"Bird,Larry",718,1517,.473,65,195,.333,653,1322,.494,319,343,.930,90,622,712,562,106,243,61,173,1820,1989/1990
"Blab,Uwe",39,98,.398,0,0,,39,98,.398,20,37,.541,29,79,108,25,1,35,22,102,98,1989/1990
"Blab,Uwe",33,87,.379,0,0,,33,87,.379,17,31,.548,28,71,99,24,1,30,22,93,83,1989/1990
"Blab,Uwe",6,11,.545,0,0,,6,11,.545,3,6,.500,1,8,9,1,0,5,0,9,15,1989/1990
"Blackman,Rolando",626,1256,.498,13,43,.302,613,1213,.505,287,340,.844,88,192,280,289,77,174,21,128,1552,1989/1990
"Blaylock,Mookie",212,571,.371,18,80,.225,194,491,.395,63,81,.778,42,98,140,210,82,111,14,110,505,1989/1990
"Bogues,Muggsy",326,664,.491,5,26,.192,321,638,.503,106,134,.791,48,159,207,867,166,146,3,168,763,1989/1990
"Bol,Manute",56,169,.331,9,48,.188,47,121,.388,25,49,.510,33,243,276,36,13,51,238,194,146,1989/1990
"Bowie,Anthony",119,293,.406,6,21,.286,113,272,.415,40,54,.741,36,82,118,96,42,59,5,80,284,1989/1990
"Bowie,Sam",347,834,.416,10,31,.323,337,803,.420,294,379,.776,206,484,690,91,38,125,121,211,998,1989/1990
"Branch,Adrian",25,61,.410,1,1,1.000,24,60,.400,14,22,.636,8,12,20,4,6,8,0,14,65,1989/1990
"Breuer,Randy",298,696,.428,0,1,.000,298,695,.429,126,193,.653,154,263,417,97,42,96,108,196,722,1989/1990
"Breuer,Randy",86,186,.462,0,0,,86,186,.462,32,51,.627,43,84,127,13,9,28,33,63,204,1989/1990
"Breuer,Randy",212,510,.416,0,1,.000,212,509,.417,94,142,.662,111,179,290,84,33,68,75,133,518,1989/1990
"Brickowski,Frank",211,387,.545,0,2,.000,211,385,.548,95,141,.674,89,238,327,105,66,93,37,226,517,1989/1990
"Brooks,Scott",119,276,.431,31,79,.392,88,197,.447,50,57,.877,15,49,64,207,47,38,0,105,319,1989/1990
"Brown,Chucky",210,447,.470,0,7,.000,210,440,.477,125,164,.762,83,148,231,50,33,69,26,148,545,1989/1990
"Brown,Mike",177,344,.515,1,2,.500,176,342,.515,157,199,.789,111,262,373,47,32,88,28,187,512,1989/1990
"Brown,Raymond",8,28,.286,0,0,,8,28,.286,0,2,.000,10,5,15,4,0,6,0,11,16,1989/1990
"Brown,Tony",88,206,.427,5,20,.250,83,186,.446,38,56,.679,39,33,72,41,32,51,4,79,219,1989/1990
"Brundy,Stanley",15,30,.500,0,0,,15,30,.500,7,18,.389,15,11,26,3,6,6,5,24,37,1989/1990
"Bryant,Mark",70,153,.458,0,0,,70,153,.458,28,50,.560,54,92,146,13,18,25,9,93,168,1989/1990
"Bryn,Torgeir",0,2,.000,0,0,,0,2,.000,4,6,.667,0,2,2,0,2,1,1,5,4,1989/1990
"Bucknall,Steve",9,33,.273,0,1,.000,9,32,.281,5,6,.833,5,2,7,10,2,11,1,10,23,1989/1990
"Butler,Greg",3,12,.250,0,0,,3,12,.250,0,2,.000,3,6,9,1,0,3,0,8,6,1989/1990
"Cage,Michael",325,645,.504,0,0,,325,645,.504,148,212,.698,306,515,821,70,79,94,45,232,798,1989/1990
"Caldwell,Adrian",42,76,.553,0,0,,42,76,.553,13,28,.464,36,73,109,7,11,32,18,69,97,1989/1990
"Campbell,Tony",723,1581,.457,9,54,.167,714,1527,.468,448,569,.787,209,242,451,213,111,251,31,260,1903,1989/1990
"Carlisle,Rick",1,7,.143,0,3,.000,1,4,.250,0,0,,0,0,0,5,1,4,1,7,2,1989/1990
"Carr,Antoine",356,721,.494,0,7,.000,356,714,.499,237,298,.795,115,207,322,119,30,125,68,247,949,1989/1990
"Carr,Antoine",128,248,.516,0,4,.000,128,244,.525,79,102,.775,50,99,149,53,15,54,34,128,335,1989/1990
"Carr,Antoine",228,473,.482,0,3,.000,228,470,.485,158,196,.806,65,108,173,66,15,71,34,119,614,1989/1990
"Carroll,Joe Barry",312,759,.411,0,2,.000,312,757,.412,137,177,.774,133,310,443,97,47,142,115,192,761,1989/1990
"Carroll,Joe Barry",159,405,.393,0,2,.000,159,403,.395,85,107,.794,82,168,250,43,19,64,56,122,403,1989/1990
"Carroll,Joe Barry",153,354,.432,0,0,,153,354,.432,52,70,.743,51,142,193,54,28,78,59,70,358,1989/1990
"Cartwright,Bill",292,598,.488,0,0,,292,598,.488,227,280,.811,137,328,465,145,38,123,34,243,811,1989/1990
"Catledge,Terry",546,1152,.474,2,8,.250,544,1144,.476,341,486,.702,271,292,563,72,36,181,17,201,1435,1989/1990
"Chambers,Tom",810,1617,.501,24,86,.279,786,1531,.513,557,647,.861,121,450,571,190,88,218,47,260,2201,1989/1990
"Chapman,Rex",377,924,.408,47,142,.331,330,782,.422,144,192,.750,52,127,179,132,46,100,6,113,945,1989/1990
"Cheeks,Maurice",307,609,.504,4,16,.250,303,593,.511,171,202,.847,50,190,240,453,124,121,10,78,789,1989/1990
"Cheeks,Maurice",215,450,.478,1,9,.111,214,441,.485,114,137,.832,39,128,167,302,82,85,5,46,545,1989/1990
"Cheeks,Maurice",92,159,.579,3,7,.429,89,152,.586,57,65,.877,11,62,73,151,42,36,5,32,244,1989/1990
"Chievous,Derrick",105,220,.477,3,9,.333,102,211,.483,80,111,.721,35,55,90,31,26,45,5,70,293,1989/1990
"Chievous,Derrick",90,178,.506,3,8,.375,87,170,.512,61,87,.701,28,47,75,27,23,40,4,59,244,1989/1990
"Chievous,Derrick",15,42,.357,0,1,.000,15,41,.366,19,24,.792,7,8,15,4,3,5,1,11,49,1989/1990
"Coleman,Ben",46,97,.474,0,1,.000,46,96,.479,34,41,.829,31,56,87,12,7,26,7,54,126,1989/1990
"Colter,Steve",142,297,.478,0,5,.000,142,292,.486,77,95,.811,55,121,176,148,47,38,10,98,361,1989/1990
"Conner,Lester",237,573,.414,2,13,.154,235,560,.420,172,214,.804,90,175,265,385,172,138,8,182,648,1989/1990
"Cooper,Michael",191,493,.387,50,157,.318,141,336,.420,83,94,.883,59,168,227,215,67,91,36,206,515,1989/1990
"Cooper,Wayne",138,304,.454,0,3,.000,138,301,.458,25,39,.641,118,221,339,44,18,39,95,211,301,1989/1990
"Copeland,Lanard",31,68,.456,1,5,.200,30,63,.476,11,14,.786,4,6,10,9,1,19,1,12,74,1989/1990
"Corbin,Tyrone",521,1083,.481,0,11,.000,521,1072,.486,161,209,.770,219,385,604,216,175,143,41,288,1203,1989/1990
"Corzine,Dave",11,29,.379,0,0,,11,29,.379,0,2,.000,7,11,18,2,2,8,0,7,22,1989/1990
"Cummings,Pat",77,159,.484,0,0,,77,159,.484,21,37,.568,28,65,93,13,12,32,4,60,175,1989/1990
"Cummings,Terry",728,1532,.475,19,59,.322,709,1473,.481,343,440,.780,226,451,677,219,110,202,52,286,1818,1989/1990
"Curry,Dell",461,990,.466,52,147,.354,409,843,.485,96,104,.923,31,137,168,159,98,100,26,148,1070,1989/1990
"Dailey,Quintin",97,240,.404,1,5,.200,96,235,.409,52,66,.788,18,33,51,34,12,34,0,63,247,1989/1990
"Dantley,Adrian",231,484,.477,0,2,.000,231,482,.479,200,254,.787,78,94,172,80,20,75,7,99,662,1989/1990
"Daugherty,Brad",244,509,.479,0,2,.000,244,507,.481,202,287,.704,77,296,373,130,29,110,22,108,690,1989/1990
"Davis,Brad",179,365,.490,35,104,.337,144,261,.552,77,100,.770,12,81,93,242,47,86,9,151,470,1989/1990
"Davis,Charles",58,158,.367,7,25,.280,51,133,.383,7,8,.875,25,56,81,18,10,20,8,52,130,1989/1990
"Davis,Terry",122,262,.466,0,1,.000,122,261,.467,54,87,.621,93,136,229,25,25,68,28,171,298,1989/1990
"Davis,Walter",497,1033,.481,6,46,.130,491,987,.497,207,227,.912,46,133,179,155,59,102,9,160,1207,1989/1990
"Dawkins,Johnny",465,950,.489,22,66,.333,443,884,.501,210,244,.861,48,199,247,601,121,214,9,159,1162,1989/1990
"Del Negro,Vinny",297,643,.462,10,32,.313,287,611,.470,135,155,.871,39,159,198,250,64,111,10,182,739,1989/1990
"Dinkins,Byron",44,109,.404,1,9,.111,43,100,.430,26,30,.867,13,27,40,75,19,37,2,30,115,1989/1990
"Divac,Vlade",274,549,.499,0,5,.000,274,544,.504,153,216,.708,167,345,512,75,79,110,114,240,701,1989/1990
"Donaldson,James",258,479,.539,0,0,,258,479,.539,149,213,.700,155,475,630,57,22,119,47,129,665,1989/1990
"Douglas,Sherman",463,938,.494,5,31,.161,458,907,.505,224,326,.687,70,136,206,619,145,246,10,187,1155,1989/1990
"Dozier,Terry",9,27,.333,0,1,.000,9,26,.346,4,8,.500,7,8,15,3,6,7,2,10,22,1989/1990
"Dreiling,Greg",20,53,.377,0,0,,20,53,.377,25,34,.735,21,66,87,8,4,19,14,69,65,1989/1990
"Drew,Larry",170,383,.444,32,81,.395,138,302,.457,46,60,.767,12,86,98,217,47,95,4,92,418,1989/1990
"Drexler,Clyde",670,1357,.494,30,106,.283,640,1251,.512,333,430,.774,208,299,507,432,145,191,51,222,1703,1989/1990
"Duckworth,Kevin",548,1146,.478,0,0,,548,1146,.478,231,312,.740,184,325,509,91,36,171,34,271,1327,1989/1990
"Dudley,Chris",146,355,.411,0,0,,146,355,.411,58,182,.319,174,249,423,39,41,84,72,164,350,1989/1990
"Dudley,Chris",79,203,.389,0,0,,79,203,.389,26,77,.338,88,115,203,20,19,48,41,83,184,1989/1990
"Dudley,Chris",67,152,.441,0,0,,67,152,.441,32,105,.305,86,134,220,19,22,36,31,81,166,1989/1990
"Dumars,Joe",508,1058,.480,22,55,.400,486,1003,.485,297,330,.900,60,152,212,368,63,145,2,129,1335,1989/1990
"Dunleavy,Mike",4,14,.286,2,9,.222,2,5,.400,7,8,.875,0,2,2,10,1,8,0,7,17,1989/1990
"Dunn,T.R.",44,97,.454,0,2,.000,44,95,.463,26,39,.667,56,82,138,43,41,19,4,67,114,1989/1990
"Eackles,Ledell",413,940,.439,19,59,.322,394,881,.447,210,280,.750,74,101,175,182,50,143,4,157,1055,1989/1990
"Eaton,Mark",158,300,.527,0,0,,158,300,.527,79,118,.669,171,430,601,39,33,75,201,238,395,1989/1990
"Edwards,Blue",286,564,.507,9,30,.300,277,534,.519,146,203,.719,69,182,251,145,76,152,36,280,727,1989/1990
"Edwards,James",462,928,.498,0,3,.000,462,925,.499,265,354,.749,112,233,345,63,23,133,37,295,1189,1989/1990
"Edwards,Jay",3,7,.429,0,2,.000,3,5,.600,1,3,.333,1,1,2,4,1,1,0,4,7,1989/1990
"Edwards,Kevin",395,959,.412,9,30,.300,386,929,.416,139,183,.760,77,205,282,252,125,180,33,149,938,1989/1990
"Ehlo,Craig",436,940,.464,104,248,.419,332,692,.480,126,185,.681,147,292,439,371,126,161,23,226,1102,1989/1990
"Elliott,Sean",311,647,.481,1,9,.111,310,638,.486,187,216,.866,127,170,297,154,45,112,14,172,810,1989/1990
"Ellis,Dale",502,1011,.497,96,256,.375,406,755,.538,193,236,.818,90,148,238,110,59,119,7,124,1293,1989/1990
"Ellison,Pervis",111,251,.442,0,2,.000,111,249,.446,49,78,.628,64,132,196,65,16,62,57,132,271,1989/1990
"English,Alex",635,1293,.491,2,5,.400,633,1288,.491,161,183,.880,119,167,286,225,51,93,23,130,1433,1989/1990
"Ewing,Patrick",922,1673,.551,1,4,.250,921,1669,.552,502,648,.775,235,658,893,182,78,278,327,325,2347,1989/1990
"Farmer,Jim",89,203,.438,8,27,.296,81,176,.460,57,80,.713,17,26,43,25,17,27,1,44,243,1989/1990
"Ferrell,Duane",5,14,.357,0,1,.000,5,13,.385,2,6,.333,3,4,7,2,1,2,0,3,12,1989/1990
"Fleming,Vern",467,919,.508,12,34,.353,455,885,.514,230,294,.782,118,204,322,610,92,206,10,213,1176,1989/1990
"Floyd,Sleepy",362,803,.451,89,234,.380,273,569,.480,187,232,.806,46,152,198,600,94,204,11,159,1000,1989/1990
"Frank,Tellis",278,607,.458,0,0,,278,607,.458,179,234,.765,151,234,385,85,51,134,27,282,735,1989/1990
"Gaines,Corey",4,12,.333,1,2,.500,3,10,.300,1,4,.250,1,4,5,26,4,10,0,11,10,1989/1990
"Gamble,Kevin",137,301,.455,3,18,.167,134,283,.473,85,107,.794,42,70,112,119,28,44,8,77,362,1989/1990
"Garland,Winston",230,573,.401,12,36,.333,218,537,.406,102,122,.836,51,163,214,303,78,158,10,152,574,1989/1990
"Garland,Winston",108,288,.375,1,10,.100,107,278,.385,53,63,.841,31,80,111,157,48,81,5,77,270,1989/1990
"Garland,Winston",122,285,.428,11,26,.423,111,259,.429,49,59,.831,20,83,103,146,30,77,5,75,304,1989/1990
"Garrick,Tom",208,421,.494,4,21,.190,204,400,.510,88,114,.772,34,128,162,289,90,117,7,151,508,1989/1990
"Gattison,Kenny",148,269,.550,1,1,1.000,147,268,.549,75,110,.682,75,122,197,39,35,67,31,150,372,1989/1990
"Gervin,Derrick",93,197,.472,0,3,.000,93,194,.479,65,89,.730,29,36,65,8,20,12,7,47,251,1989/1990
"Gilliam,Armen",484,940,.515,0,2,.000,484,938,.516,303,419,.723,211,388,599,99,69,183,51,212,1271,1989/1990
"Gilliam,Armen",52,121,.430,0,0,,52,121,.430,39,56,.696,26,44,70,8,6,17,5,28,143,1989/1990
"Gilliam,Armen",432,819,.527,0,2,.000,432,817,.529,264,363,.727,185,344,529,91,63,166,46,184,1128,1989/1990
"Gminski,Mike",458,1002,.457,3,17,.176,455,985,.462,193,235,.821,196,491,687,128,43,98,102,136,1112,1989/1990
"Grant,Gary",241,517,.466,5,21,.238,236,496,.476,88,113,.779,59,136,195,442,108,206,5,120,575,1989/1990
"Grant,Greg",83,216,.384,3,16,.188,80,200,.400,39,59,.661,16,43,59,168,36,77,1,58,208,1989/1990
"Grant,Harvey",284,601,.473,0,8,.000,284,593,.479,96,137,.701,138,204,342,131,52,85,43,194,664,1989/1990
"Grant,Horace",446,853,.523,0,0,,446,853,.523,179,256,.699,236,393,629,227,92,110,84,230,1071,1989/1990
"Gray,Stuart",42,99,.424,0,5,.000,42,94,.447,32,47,.681,40,105,145,19,15,24,26,90,116,1989/1990
"Gray,Stuart",38,82,.463,0,2,.000,38,80,.475,25,39,.641,38,93,131,17,12,19,24,64,101,1989/1990
"Gray,Stuart",4,17,.235,0,3,.000,4,14,.286,7,8,.875,2,12,14,2,3,5,2,26,15,1989/1990
"Grayer,Jeff",224,487,.460,1,8,.125,223,479,.466,99,152,.651,94,123,217,107,48,82,10,125,548,1989/1990
"Green,A.C.",385,806,.478,13,46,.283,372,760,.489,278,370,.751,262,450,712,90,66,116,50,207,1061,1989/1990
"Green,Rickey",100,231,.433,1,11,.091,99,220,.450,43,51,.843,9,45,54,182,51,62,1,60,244,1989/1990
"Green,Sidney",312,667,.468,1,3,.333,311,664,.468,136,209,.651,166,422,588,99,50,119,26,231,761,1989/1990
"Greenwood,Dave",22,52,.423,0,0,,22,52,.423,16,29,.552,24,54,78,12,4,16,9,40,60,1989/1990
"Griffith,Darrell",301,649,.464,80,215,.372,221,434,.509,51,78,.654,43,123,166,63,68,75,19,149,733,1989/1990
"Haffner,Scott",88,217,.406,3,21,.143,85,196,.434,17,25,.680,7,44,51,80,13,33,2,53,196,1989/1990
"Haley,Jack",138,347,.398,0,1,.000,138,346,.399,85,125,.680,115,185,300,26,18,72,12,170,361,1989/1990
"Haley,Jack",9,20,.450,0,0,,9,20,.450,7,7,1.000,7,11,18,4,0,7,1,7,25,1989/1990
"Haley,Jack",129,327,.394,0,1,.000,129,326,.396,78,118,.661,108,174,282,22,18,65,11,163,336,1989/1990
"Hammonds,Tom",129,295,.437,0,1,.000,129,294,.439,63,98,.643,61,107,168,51,11,46,14,98,321,1989/1990
"Hansen,Bob",265,568,.467,54,154,.351,211,414,.510,33,64,.516,66,163,229,149,52,79,11,194,617,1989/1990
"Hanzlik,Bill",179,396,.452,6,31,.194,173,365,.474,136,183,.743,67,140,207,186,78,87,29,249,500,1989/1990
"Hardaway,Tim",464,985,.471,23,84,.274,441,901,.489,211,276,.764,57,253,310,689,165,260,12,232,1162,1989/1990
"Harper,Derek",567,1161,.488,89,240,.371,478,921,.519,250,315,.794,54,190,244,609,187,207,26,224,1473,1989/1990
"Harper,Ron",301,637,.473,14,51,.275,287,586,.490,182,231,.788,74,132,206,182,81,100,41,105,798,1989/1990
"Harper,Ron",61,138,.442,1,5,.200,60,133,.451,31,41,.756,19,29,48,49,14,18,9,25,154,1989/1990
"Harper,Ron",240,499,.481,13,46,.283,227,453,.501,151,190,.795,55,103,158,133,67,82,32,80,644,1989/1990
"Harris,Steve",14,40,.350,0,0,,14,40,.350,3,4,.750,5,5,10,1,7,5,1,9,31,1989/1990
"Hastings,Scott",10,33,.303,3,12,.250,7,21,.333,19,22,.864,7,25,32,8,3,7,3,31,42,1989/1990
"Hawkins,Hersey",522,1136,.460,84,200,.420,438,936,.468,387,436,.888,85,219,304,261,130,185,28,217,1515,1989/1990
"Henderson,Gerald",53,109,.486,17,38,.447,36,71,.507,12,15,.800,11,32,43,74,16,24,2,50,135,1989/1990
"Henderson,Gerald",11,26,.423,3,7,.429,8,19,.421,2,2,1.000,3,9,12,13,8,8,0,14,27,1989/1990
"Henderson,Gerald",42,83,.506,14,31,.452,28,52,.538,10,13,.769,8,23,31,61,8,16,2,36,108,1989/1990
"Higgins,Mike",3,8,.375,0,0,,3,8,.375,8,10,.800,2,2,4,3,2,1,2,5,14,1989/1990
"Higgins,Mike",0,0,,0,0,,0,0,,1,2,.500,1,0,1,1,1,0,2,4,1,1989/1990
"Higgins,Mike",3,8,.375,0,0,,3,8,.375,7,8,.875,1,2,3,2,1,1,0,1,13,1989/1990
"Higgins,Rod",304,632,.481,67,193,.347,237,439,.540,234,285,.821,120,302,422,129,47,93,53,184,909,1989/1990
"Hinson,Roy",145,286,.507,0,0,,145,286,.507,86,99,.869,61,111,172,22,14,52,27,87,376,1989/1990
"Hodges,Craig",145,331,.438,87,181,.481,58,150,.387,30,33,.909,11,42,53,110,30,30,2,87,407,1989/1990
"Holton,Mike",14,26,.538,0,0,,14,26,.538,1,2,.500,1,1,2,16,1,13,0,19,29,1989/1990
"Hoppen,Dave",16,41,.390,0,0,,16,41,.390,8,10,.800,19,17,36,6,2,8,1,26,40,1989/1990
"Hopson,Dennis",474,1093,.434,32,101,.317,442,992,.446,271,342,.792,113,166,279,151,100,168,51,183,1251,1989/1990
"Horford,Tito",18,62,.290,0,0,,18,62,.290,15,24,.625,19,40,59,2,5,14,16,33,51,1989/1990
"Hornacek,Jeff",483,901,.536,40,98,.408,443,803,.552,173,202,.856,86,227,313,337,117,125,14,144,1179,1989/1990
"Horton,Ed",80,162,.494,0,4,.000,80,158,.506,42,69,.609,59,49,108,19,9,39,5,63,202,1989/1990
"Hughes,Eddie",83,202,.411,20,49,.408,63,153,.412,23,34,.676,15,55,70,116,48,39,1,87,209,1989/1990
"Humphries,Jay",496,1005,.494,21,70,.300,475,935,.508,224,285,.786,80,189,269,472,156,151,11,253,1237,1989/1990
"Irvin,Byron",96,203,.473,5,14,.357,91,189,.481,61,91,.670,30,44,74,47,28,39,1,40,258,1989/1990
"Jackson,Jaren",25,69,.362,0,3,.000,25,66,.379,17,21,.810,16,8,24,13,13,18,1,16,67,1989/1990
"Jackson,Mark",327,749,.437,35,131,.267,292,618,.472,120,165,.727,106,212,318,604,109,211,4,121,809,1989/1990
"Jackson,Michael",3,11,.273,1,2,.500,2,9,.222,3,6,.500,2,5,7,8,5,4,0,3,10,1989/1990
"Johnson,Avery",55,142,.387,1,4,.250,54,138,.391,29,40,.725,21,22,43,162,26,48,1,55,140,1989/1990
"Johnson,Buck",504,1019,.495,2,17,.118,502,1002,.501,205,270,.759,113,268,381,252,104,167,62,321,1215,1989/1990
"Johnson,Dennis",206,475,.434,1,24,.042,205,451,.455,118,140,.843,48,153,201,485,81,117,14,179,531,1989/1990
"Johnson,Eddie",411,907,.453,70,184,.380,341,723,.472,188,205,.917,69,177,246,107,32,108,10,174,1080,1989/1990
"Johnson,Eric",20,84,.238,1,6,.167,19,78,.244,13,17,.765,8,20,28,64,17,26,2,49,54,1989/1990
"Johnson,Kevin",578,1159,.499,8,41,.195,570,1118,.510,501,598,.838,42,228,270,846,95,263,14,143,1665,1989/1990
"Johnson,Magic",546,1138,.480,106,276,.384,440,862,.510,567,637,.890,128,394,522,907,132,289,34,167,1765,1989/1990
"Johnson,Marques",12,32,.375,2,3,.667,10,29,.345,14,17,.824,8,9,17,9,0,10,1,12,40,1989/1990
"Johnson,Steve",48,92,.522,0,0,,48,92,.522,21,35,.600,19,34,53,17,3,31,5,56,117,1989/1990
"Johnson,Steve",0,2,.000,0,0,,0,2,.000,0,0,,0,3,3,1,0,6,0,4,0,1989/1990
"Johnson,Steve",48,90,.533,0,0,,48,90,.533,21,35,.600,19,31,50,16,3,25,5,52,117,1989/1990
"Johnson,Vinnie",334,775,.431,5,34,.147,329,741,.444,131,196,.668,108,148,256,255,71,123,13,143,804,1989/1990
"Johnston,Nate",18,48,.375,1,4,.250,17,44,.386,9,13,.692,13,10,23,1,3,6,8,11,46,1989/1990
"Johnston,Nate",4,11,.364,1,1,1.000,3,10,.300,2,2,1.000,2,0,2,0,0,1,1,0,11,1989/1990
"Johnston,Nate",14,37,.378,0,3,.000,14,34,.412,7,11,.636,11,10,21,1,3,5,7,11,35,1989/1990
"Jones,Anthony",72,194,.371,4,13,.308,68,181,.376,47,69,.681,33,49,82,29,32,42,16,77,195,1989/1990
"Jones,Caldwell",67,144,.465,1,5,.200,66,139,.475,38,54,.704,76,154,230,20,20,48,27,146,173,1989/1990
"Jones,Charles",94,185,.508,0,0,,94,185,.508,68,105,.648,145,359,504,139,50,76,197,296,256,1989/1990
"Jordan,Michael",1034,1964,.526,92,245,.376,942,1719,.548,593,699,.848,143,422,565,519,227,247,54,241,2753,1989/1990
"Kemp,Shawn",203,424,.479,2,12,.167,201,412,.488,117,159,.736,146,200,346,26,47,107,70,204,525,1989/1990
"Kempton,Tim",153,312,.490,0,1,.000,153,311,.492,77,114,.675,51,167,218,118,30,80,9,144,383,1989/1990
"Kerr,Steve",192,432,.444,73,144,.507,119,288,.413,63,73,.863,12,86,98,248,45,74,7,59,520,1989/1990
"Kersey,Jerome",519,1085,.478,3,20,.150,516,1065,.485,269,390,.690,251,439,690,188,121,144,63,304,1310,1989/1990
"Keys,Randolph",293,678,.432,14,43,.326,279,635,.439,101,140,.721,100,153,253,88,68,84,8,224,701,1989/1990
"Keys,Randolph",151,359,.421,2,10,.200,149,349,.427,61,82,.744,52,85,137,39,38,47,2,117,365,1989/1990
"Keys,Randolph",142,319,.445,12,33,.364,130,286,.455,40,58,.690,48,68,116,49,30,37,6,107,336,1989/1990
"Kimbrough,Stan",7,16,.438,0,0,,7,16,.438,2,2,1.000,4,3,7,5,4,4,0,4,16,1989/1990
"King,Bernard",711,1459,.487,3,23,.130,708,1436,.493,412,513,.803,129,275,404,376,51,248,7,230,1837,1989/1990
"King,Stacey",267,530,.504,0,1,.000,267,529,.505,194,267,.727,169,215,384,87,38,119,58,215,728,1989/1990
"Kite,Greg",101,234,.432,1,1,1.000,100,233,.429,27,54,.500,131,246,377,76,31,76,51,201,230,1989/1990
"Kleine,Joe",176,367,.480,0,4,.000,176,363,.485,83,100,.830,117,238,355,46,15,64,27,170,435,1989/1990
"Koncak,Jon",78,127,.614,0,1,.000,78,126,.619,42,79,.532,58,168,226,23,38,47,34,182,198,1989/1990
"Kornet,Frank",42,114,.368,5,20,.250,37,94,.394,24,39,.615,25,46,71,21,14,23,3,54,113,1989/1990
"Krystkowiak,Larry",43,118,.364,0,2,.000,43,116,.371,26,33,.788,16,60,76,25,10,19,2,41,112,1989/1990
"Laimbeer,Bill",380,785,.484,57,158,.361,323,627,.515,164,192,.854,166,614,780,171,57,98,84,278,981,1989/1990
"Lane,Jerome",145,309,.469,0,5,.000,145,304,.477,44,120,.367,144,217,361,105,53,85,17,189,334,1989/1990
"Lang,Andrew",97,174,.557,0,0,,97,174,.557,64,98,.653,83,188,271,21,22,41,133,171,258,1989/1990
"Lebo,Jeff",2,7,.286,0,0,,2,7,.286,2,2,1.000,2,2,4,3,2,1,0,7,6,1989/1990
"Leckner,Eric",125,222,.563,0,0,,125,222,.563,81,109,.743,48,144,192,19,15,63,23,157,331,1989/1990
"Legler,Tim",11,29,.379,0,1,.000,11,28,.393,6,6,1.000,4,4,8,6,2,4,0,12,28,1989/1990
"Leonard,Gary",13,31,.419,0,1,.000,13,30,.433,6,14,.429,10,17,27,1,3,8,9,26,32,1989/1990
"Les,Jim",5,14,.357,0,1,.000,5,13,.385,13,17,.765,3,4,7,21,3,10,0,9,23,1989/1990
"Les,Jim",0,0,,0,0,,0,0,,2,4,.500,0,0,0,1,0,3,0,3,2,1989/1990
"Les,Jim",5,14,.357,0,1,.000,5,13,.385,11,13,.846,3,4,7,20,3,7,0,6,21,1989/1990
"Lett,Clifford",2,8,.250,0,0,,2,8,.250,0,0,,0,0,0,1,0,2,0,8,4,1989/1990
"Lever,Fat",568,1283,.443,36,87,.414,532,1196,.445,271,337,.804,230,504,734,517,168,156,13,172,1443,1989/1990
"Levingston,Cliff",216,424,.509,1,5,.200,215,419,.513,83,122,.680,113,206,319,80,55,49,41,216,516,1989/1990
"Lewis,Ralph",4,7,.571,0,0,,4,7,.571,2,2,1.000,4,2,6,0,1,2,0,3,10,1989/1990
"Lewis,Ralph",0,1,.000,0,0,,0,1,.000,0,0,,0,0,0,0,0,1,0,1,0,1989/1990
"Lewis,Ralph",4,6,.667,0,0,,4,6,.667,2,2,1.000,4,2,6,0,1,1,0,2,10,1989/1990
"Lewis,Reggie",540,1089,.496,4,15,.267,536,1074,.499,256,317,.808,109,238,347,225,88,120,63,216,1340,1989/1990
"Lichti,Todd",250,514,.486,0,14,.000,250,500,.500,130,174,.747,49,102,151,116,55,95,13,145,630,1989/1990
"Lister,Alton",4,8,.500,0,1,.000,4,7,.571,4,7,.571,5,3,8,2,1,0,0,8,12,1989/1990
"Lloyd,Lewis",30,53,.566,0,0,,30,53,.566,9,16,.563,8,10,18,11,3,20,0,12,69,1989/1990
"Lloyd,Lewis",1,2,.500,0,0,,1,2,.500,0,0,,0,0,0,0,0,4,0,3,2,1989/1990
"Lloyd,Lewis",29,51,.569,0,0,,29,51,.569,9,16,.563,8,10,18,11,3,16,0,9,67,1989/1990
"Lohaus,Brad",305,663,.460,47,137,.343,258,526,.490,75,103,.728,98,300,398,168,58,109,88,211,732,1989/1990
"Lohaus,Brad",94,202,.465,1,16,.063,93,186,.500,21,26,.808,21,89,110,62,14,45,22,66,210,1989/1990
"Lohaus,Brad",211,461,.458,46,121,.380,165,340,.485,54,77,.701,77,211,288,106,44,64,66,145,522,1989/1990
"Long,Grant",257,532,.483,0,3,.000,257,529,.486,172,241,.714,156,246,402,96,91,139,38,300,686,1989/1990
"Long,John",174,384,.453,10,29,.345,164,355,.462,46,55,.836,26,57,83,85,45,75,5,66,404,1989/1990
"Lowe,Sidney",73,229,.319,2,9,.222,71,220,.323,39,54,.722,41,122,163,337,73,63,4,114,187,1989/1990
"Lucas,John",109,291,.375,26,87,.299,83,204,.407,42,55,.764,19,71,90,238,45,85,2,59,286,1989/1990
"Mahorn,Rick",313,630,.497,2,9,.222,311,621,.501,183,256,.715,167,401,568,98,44,104,103,251,811,1989/1990
"Majerle,Dan",296,698,.424,19,80,.238,277,618,.448,198,260,.762,144,286,430,188,100,82,32,177,809,1989/1990
"Malone,Jeff",781,1592,.491,1,6,.167,780,1586,.492,257,293,.877,54,152,206,243,48,125,6,116,1820,1989/1990
"Malone,Karl",914,1627,.562,16,43,.372,898,1584,.567,696,913,.762,232,679,911,226,121,304,50,259,2540,1989/1990
"Malone,Moses",517,1077,.480,1,9,.111,516,1068,.483,493,631,.781,364,448,812,130,47,232,84,158,1528,1989/1990
"Manning,Danny",440,826,.533,0,5,.000,440,821,.536,274,370,.741,142,280,422,187,91,188,39,261,1154,1989/1990
"Marble,Roy",16,58,.276,0,2,.000,16,56,.286,19,29,.655,15,9,24,11,7,14,1,16,51,1989/1990
"Marčiulionis,Šarūnas",289,557,.519,10,39,.256,279,518,.539,317,403,.787,84,137,221,121,94,137,7,230,905,1989/1990
"Martin,Jeff",170,414,.411,2,15,.133,168,399,.421,91,129,.705,78,81,159,44,41,47,16,97,433,1989/1990
"Mason,Anthony",14,40,.350,0,0,,14,40,.350,9,15,.600,11,23,34,7,2,11,2,20,37,1989/1990
"Matthews,Wes",1,3,.333,0,1,.000,1,2,.500,2,2,1.000,0,0,0,5,0,0,0,0,4,1989/1990
"Maxwell,Vernon",275,627,.439,28,105,.267,247,522,.473,136,211,.645,50,178,228,296,84,143,10,148,714,1989/1990
"Maxwell,Vernon",133,306,.435,15,52,.288,118,254,.465,59,95,.621,35,106,141,146,42,71,5,79,340,1989/1990
"Maxwell,Vernon",142,321,.442,13,53,.245,129,268,.481,77,116,.664,15,72,87,150,42,72,5,69,374,1989/1990
"McCann,Bob",7,21,.333,0,0,,7,21,.333,12,14,.857,4,8,12,6,2,6,2,7,26,1989/1990
"McCants,Mel",8,26,.308,0,0,,8,26,.308,6,8,.750,1,5,6,2,3,1,1,11,22,1989/1990
"McCloud,George",45,144,.313,13,40,.325,32,104,.308,15,19,.789,12,30,42,45,19,36,3,56,118,1989/1990
"McCormick,Tim",10,29,.345,0,0,,10,29,.345,10,19,.526,8,19,27,3,3,10,1,24,30,1989/1990
"McCray,Rodney",537,1043,.515,11,42,.262,526,1001,.525,273,348,.784,192,477,669,377,60,174,70,176,1358,1989/1990
"McDaniel,Xavier",611,1233,.496,5,17,.294,606,1216,.498,244,333,.733,165,282,447,171,73,187,36,231,1471,1989/1990
"McGee,Mike",42,87,.483,8,23,.348,34,64,.531,10,21,.476,11,25,36,16,8,14,1,28,102,1989/1990
"McHale,Kevin",648,1181,.549,23,69,.333,625,1112,.562,393,440,.893,201,476,677,172,30,183,157,250,1712,1989/1990
"McKey,Derrick",468,949,.493,3,23,.130,465,926,.502,315,403,.782,170,319,489,187,87,192,81,247,1254,1989/1990
"McKinney,Carlton",8,32,.250,0,1,.000,8,31,.258,2,4,.500,4,8,12,7,6,7,1,15,18,1989/1990
"McMillan,Nate",207,438,.473,11,31,.355,196,407,.482,98,153,.641,127,276,403,598,140,187,37,289,523,1989/1990
"McNamara,Mark",38,86,.442,0,0,,38,86,.442,26,40,.650,22,41,63,3,2,21,1,31,102,1989/1990
"Meents,Scott",19,44,.432,0,0,,19,44,.432,17,23,.739,7,23,30,7,4,9,3,12,55,1989/1990
"Miller,Reggie",661,1287,.514,150,362,.414,511,925,.552,544,627,.868,95,200,295,311,110,222,18,175,2016,1989/1990
"Mitchell,Sam",372,834,.446,0,9,.000,372,825,.451,268,349,.768,180,282,462,89,66,96,54,301,1012,1989/1990
"Mokeski,Paul",63,150,.420,0,1,.000,63,149,.423,25,36,.694,27,72,99,17,8,26,10,76,151,1989/1990
"Moore,Johnny",47,126,.373,8,34,.235,39,92,.424,16,27,.593,16,36,52,82,32,39,3,55,118,1989/1990
"Morris,Chris",449,1065,.422,61,193,.316,388,872,.445,228,316,.722,194,228,422,143,130,185,79,219,1187,1989/1990
"Morrison,Mike",23,68,.338,2,7,.286,21,61,.344,24,30,.800,7,13,20,11,2,23,0,20,72,1989/1990
"Morton,John",48,161,.298,7,30,.233,41,131,.313,43,62,.694,7,25,32,67,18,51,4,30,146,1989/1990
"Mullin,Chris",682,1272,.536,87,234,.372,595,1038,.573,505,568,.889,130,333,463,319,123,239,45,142,1956,1989/1990
"Murphy,Tod",260,552,.471,16,43,.372,244,509,.479,144,203,.709,207,357,564,106,76,61,60,229,680,1989/1990
"Myers,Pete",89,225,.396,0,7,.000,89,218,.408,66,100,.660,33,63,96,135,35,76,11,109,244,1989/1990
"Myers,Pete",15,45,.333,0,1,.000,15,44,.341,16,31,.516,10,18,28,35,15,18,2,39,46,1989/1990
"Myers,Pete",74,180,.411,0,6,.000,74,174,.425,50,69,.725,23,45,68,100,20,58,9,70,198,1989/1990
"Nance,Larry",412,807,.511,1,1,1.000,411,806,.510,186,239,.778,162,354,516,161,54,110,122,185,1011,1989/1990
"Natt,Calvin",20,31,.645,0,0,,20,31,.645,17,22,.773,10,25,35,9,1,5,0,14,57,1989/1990
"Nealy,Ed",37,70,.529,0,2,.000,37,68,.544,30,41,.732,46,92,138,28,16,17,4,67,104,1989/1990
"Nevitt,Chuck",2,2,1.000,0,0,,2,2,1.000,0,0,,0,3,3,1,0,2,1,3,4,1989/1990
"Newman,Johnny",374,786,.476,45,142,.317,329,644,.511,239,299,.799,60,131,191,180,95,143,22,254,1032,1989/1990
"Nimphius,Kurt",38,91,.418,0,1,.000,38,90,.422,14,30,.467,22,39,61,6,4,12,18,45,90,1989/1990
"Nix,Dyron",14,39,.359,0,0,,14,39,.359,11,16,.688,8,18,26,5,3,7,1,15,39,1989/1990
"Norman,Ken",484,949,.510,7,16,.438,477,933,.511,153,242,.632,143,327,470,160,78,190,59,196,1128,1989/1990
"Oakley,Charles",336,641,.524,0,3,.000,336,638,.527,217,285,.761,258,469,727,146,64,165,16,220,889,1989/1990
"Olajuwon,Hakeem",806,1609,.501,1,6,.167,805,1603,.502,382,536,.713,299,850,1149,234,174,316,376,314,1995,1989/1990
"Oldham,Jawann",3,6,.500,0,0,,3,6,.500,3,7,.429,4,12,16,1,2,4,3,9,9,1989/1990
"Oldham,Jawann",1,3,.333,0,0,,1,3,.333,2,5,.400,4,11,15,0,2,3,3,6,4,1989/1990
"Oldham,Jawann",2,3,.667,0,0,,2,3,.667,1,2,.500,0,1,1,1,0,1,0,3,5,1989/1990
"Ortiz,José",19,42,.452,1,2,.500,18,40,.450,3,5,.600,8,7,15,7,2,5,1,15,42,1989/1990
"Parish,Robert",505,871,.580,0,0,,505,871,.580,233,312,.747,259,537,796,103,38,169,69,189,1243,1989/1990
"Paspalj,Žarko",27,79,.342,0,1,.000,27,78,.346,18,22,.818,15,15,30,10,3,21,7,37,72,1989/1990
"Paxson,Jim",191,422,.453,5,20,.250,186,402,.463,73,90,.811,24,53,77,137,33,54,5,115,460,1989/1990
"Paxson,John",365,708,.516,33,92,.359,332,616,.539,56,68,.824,27,92,119,335,83,85,6,176,819,1989/1990
"Payne,Kenny",47,108,.435,4,10,.400,43,98,.439,16,18,.889,11,15,26,10,7,20,6,37,114,1989/1990
"Perdue,Will",111,268,.414,0,5,.000,111,263,.422,72,104,.692,88,126,214,46,19,65,26,150,294,1989/1990
"Perkins,Sam",435,883,.493,6,28,.214,429,855,.502,330,424,.778,209,363,572,175,88,148,64,225,1206,1989/1990
"Perry,Tim",100,195,.513,1,1,1.000,99,194,.510,53,90,.589,79,73,152,17,21,47,22,76,254,1989/1990
"Person,Chuck",605,1242,.487,94,253,.372,511,989,.517,211,270,.781,126,319,445,230,53,170,20,217,1515,1989/1990
"Petersen,Jim",60,141,.426,0,1,.000,60,140,.429,52,73,.712,49,111,160,23,17,36,20,103,172,1989/1990
"Petrović,Dražen",207,427,.485,34,74,.459,173,353,.490,135,160,.844,50,61,111,116,23,96,2,134,583,1989/1990
"Pierce,Ricky",503,987,.510,46,133,.346,457,854,.535,307,366,.839,64,103,167,133,50,129,7,158,1359,1989/1990
"Pinckney,Ed",135,249,.542,0,1,.000,135,248,.544,92,119,.773,93,132,225,68,34,56,42,126,362,1989/1990
"Pippen,Scottie",562,1150,.489,28,112,.250,534,1038,.514,199,295,.675,150,397,547,444,211,278,101,298,1351,1989/1990
"Polynice,Olden",156,289,.540,1,2,.500,155,287,.540,47,99,.475,128,172,300,15,25,35,21,187,360,1989/1990
"Porter,Terry",448,969,.462,89,238,.374,359,731,.491,421,472,.892,59,213,272,726,151,245,4,150,1406,1989/1990
"Pressey,Paul",239,506,.472,6,43,.140,233,463,.503,144,190,.758,59,113,172,244,71,109,23,149,628,1989/1990
"Pressley,Harold",240,566,.424,46,148,.311,194,418,.464,110,141,.780,94,215,309,149,58,88,36,148,636,1989/1990
"Price,Mark",489,1066,.459,152,374,.406,337,692,.487,300,338,.888,66,185,251,666,114,214,5,89,1430,1989/1990
"Quinnett,Brian",19,58,.328,0,2,.000,19,56,.339,2,3,.667,9,19,28,11,3,4,4,27,40,1989/1990
"Rambis,Kurt",190,373,.509,0,3,.000,190,370,.514,82,127,.646,156,369,525,135,100,104,37,208,462,1989/1990
"Rambis,Kurt",58,116,.500,0,1,.000,58,115,.504,30,55,.545,48,72,120,28,32,29,10,45,146,1989/1990
"Rambis,Kurt",132,257,.514,0,2,.000,132,255,.518,52,72,.722,108,297,405,107,68,75,27,163,316,1989/1990
"Rasmussen,Blair",445,895,.497,0,1,.000,445,894,.498,111,134,.828,174,420,594,82,40,75,104,300,1001,1989/1990
"Reid,J.R.",358,814,.440,0,5,.000,358,809,.443,192,289,.664,199,492,691,101,92,172,54,292,908,1989/1990
"Reid,Robert",175,447,.391,10,32,.313,165,415,.398,54,86,.628,34,117,151,90,38,45,16,153,414,1989/1990
"Reid,Robert",13,33,.394,1,3,.333,12,30,.400,4,8,.500,1,7,8,8,2,1,2,17,31,1989/1990
"Reid,Robert",162,414,.391,9,29,.310,153,385,.397,50,78,.641,33,110,143,82,36,44,14,136,383,1989/1990
"Reynolds,Jerry",309,741,.417,1,14,.071,308,727,.424,239,322,.742,91,232,323,180,93,139,64,162,858,1989/1990
"Rice,Glen",470,1071,.439,17,69,.246,453,1002,.452,91,124,.734,100,252,352,138,67,113,27,198,1048,1989/1990
"Richardson,Pooh",426,925,.461,23,83,.277,403,842,.479,63,107,.589,55,162,217,554,133,141,25,143,938,1989/1990
"Richmond,Mitch",640,1287,.497,34,95,.358,606,1192,.508,406,469,.866,98,262,360,223,98,201,24,210,1720,1989/1990
"Rivers,David",80,197,.406,0,5,.000,80,192,.417,59,78,.756,30,55,85,155,31,88,0,53,219,1989/1990
"Rivers,Doc",218,480,.454,24,66,.364,194,414,.469,138,170,.812,47,153,200,264,116,98,22,151,598,1989/1990
"Roberts,Fred",330,666,.495,2,11,.182,328,655,.501,195,249,.783,107,204,311,147,56,130,25,210,857,1989/1990
"Robertson,Alvin",476,946,.503,4,26,.154,472,920,.513,197,266,.741,230,329,559,445,207,217,17,280,1153,1989/1990
"Robinson,Clifford",298,751,.397,12,44,.273,286,707,.405,138,251,.550,110,198,308,72,53,129,53,226,746,1989/1990
"Robinson,David",690,1300,.531,0,2,.000,690,1298,.532,613,837,.732,303,680,983,164,138,257,319,259,1993,1989/1990
"Rodman,Dennis",288,496,.581,1,9,.111,287,487,.589,142,217,.654,336,456,792,72,52,90,60,276,719,1989/1990
"Rollins,Tree",57,125,.456,0,1,.000,57,124,.460,11,16,.688,58,95,153,24,13,35,53,83,125,1989/1990
"Roth,Doug",37,86,.430,0,1,.000,37,85,.435,7,14,.500,44,76,120,20,8,16,13,70,81,1989/1990
"Roth,Scott",159,420,.379,18,52,.346,141,368,.383,150,201,.746,34,78,112,115,51,85,6,144,486,1989/1990
"Rowinski,Jim",14,32,.438,0,0,,14,32,.438,22,26,.846,17,12,29,5,1,10,2,19,50,1989/1990
"Rowsom,Brian",78,179,.436,1,2,.500,77,177,.435,68,83,.819,44,87,131,22,18,25,11,58,225,1989/1990
"Royal,Donald",117,255,.459,0,1,.000,117,254,.461,153,197,.777,69,68,137,43,32,81,8,107,387,1989/1990
"Rudd,Delaney",111,259,.429,16,56,.286,95,203,.468,35,53,.660,12,43,55,177,22,88,1,81,273,1989/1990
"Salley,John",209,408,.512,1,4,.250,208,404,.515,174,244,.713,154,285,439,67,51,97,153,282,593,1989/1990
"Sampson,Ralph",48,129,.372,1,4,.250,47,125,.376,12,23,.522,11,73,84,28,14,34,22,66,109,1989/1990
"Sanders,Jeff",13,40,.325,0,0,,13,40,.325,2,4,.500,17,22,39,9,4,15,4,27,28,1989/1990
"Sanders,Mike",225,479,.470,5,14,.357,220,465,.473,55,75,.733,78,152,230,89,43,79,23,220,510,1989/1990
"Schayes,Danny",163,330,.494,0,4,.000,163,326,.500,225,264,.852,117,225,342,61,41,72,45,200,551,1989/1990
"Schrempf,Detlef",424,822,.516,17,48,.354,407,774,.526,402,490,.820,149,471,620,247,59,180,16,271,1267,1989/1990
"Scott,Byron",472,1005,.470,93,220,.423,379,785,.483,160,209,.766,51,191,242,274,77,122,31,180,1197,1989/1990
"Seikaly,Rony",486,968,.502,0,1,.000,486,967,.503,256,431,.594,253,513,766,78,78,236,124,258,1228,1989/1990
"Sellers,Brad",103,254,.406,0,5,.000,103,249,.414,58,73,.795,39,50,89,33,17,46,22,74,264,1989/1990
"Sellers,Brad",84,198,.424,0,3,.000,84,195,.431,49,61,.803,31,39,70,32,11,34,19,63,217,1989/1990
"Sellers,Brad",19,56,.339,0,2,.000,19,54,.352,9,12,.750,8,11,19,1,6,12,3,11,47,1989/1990
"Shackleford,Charles",247,535,.462,0,1,.000,247,534,.463,79,115,.687,180,299,479,56,40,116,35,183,573,1989/1990
"Shasky,John",4,14,.286,0,0,,4,14,.286,2,6,.333,4,9,13,1,1,2,2,10,10,1989/1990
"Short,Purvis",432,950,.455,10,35,.286,422,915,.461,198,237,.835,101,147,248,145,66,119,20,202,1072,1989/1990
"Shouse,Dexter",0,4,.000,0,1,.000,0,3,.000,0,0,,0,0,0,2,1,2,1,2,0,1989/1990
"Sichting,Jerry",50,125,.400,3,12,.250,47,113,.416,18,22,.818,3,16,19,94,16,22,2,40,121,1989/1990
"Sichting,Jerry",50,119,.420,3,12,.250,47,107,.439,15,18,.833,3,16,19,92,16,22,2,39,118,1989/1990
"Sichting,Jerry",0,6,.000,0,0,,0,6,.000,3,4,.750,0,0,0,2,0,0,0,1,3,1989/1990
"Sikma,Jack",344,827,.416,68,199,.342,276,628,.439,230,260,.885,109,383,492,229,76,139,48,244,986,1989/1990
"Skiles,Scott",190,464,.409,52,132,.394,138,332,.416,104,119,.874,23,136,159,334,36,90,4,126,536,1989/1990
"Smith,Charles",595,1145,.520,1,12,.083,594,1133,.524,454,572,.794,177,347,524,114,86,162,119,294,1645,1989/1990
"Smith,Charles",59,133,.444,0,7,.000,59,126,.468,53,76,.697,14,55,69,103,35,36,3,75,171,1989/1990
"Smith,Derek",261,514,.508,16,36,.444,245,478,.513,130,186,.699,62,110,172,109,35,85,20,198,668,1989/1990
"Smith,Kenny",378,811,.466,26,83,.313,352,728,.484,161,196,.821,18,139,157,445,79,169,8,143,943,1989/1990
"Smith,Kenny",280,607,.461,22,59,.373,258,548,.471,106,131,.809,11,109,120,303,57,122,7,98,688,1989/1990
"Smith,Kenny",98,204,.480,4,24,.167,94,180,.522,55,65,.846,7,30,37,142,22,47,1,45,255,1989/1990
"Smith,Larry",101,213,.474,0,2,.000,101,211,.479,20,55,.364,180,272,452,69,56,70,28,203,222,1989/1990
"Smith,Michael",136,286,.476,2,28,.071,134,258,.519,53,64,.828,40,60,100,79,9,54,1,51,327,1989/1990
"Smith,Otis",348,708,.492,10,40,.250,338,668,.506,169,222,.761,117,183,300,147,76,102,57,174,875,1989/1990
"Smits,Rik",515,967,.533,0,1,.000,515,966,.533,241,297,.811,135,377,512,142,45,143,169,328,1271,1989/1990
"Smrek,Mike",10,24,.417,0,0,,10,24,.417,1,6,.167,11,23,34,1,4,9,11,18,21,1989/1990
"Sparrow,Rory",210,510,.412,8,40,.200,202,470,.430,59,77,.766,37,101,138,298,49,99,4,140,487,1989/1990
"Stockton,John",472,918,.514,47,113,.416,425,805,.528,354,432,.819,57,149,206,1134,207,272,18,233,1345,1989/1990
"Stokes,Greg",1,9,.111,0,0,,1,9,.111,2,2,1.000,2,3,5,0,0,3,0,8,4,1989/1990
"Strickland,Rod",343,756,.454,8,30,.267,335,726,.461,174,278,.626,90,169,259,468,127,170,14,160,868,1989/1990
"Strickland,Rod",170,386,.440,6,21,.286,164,365,.449,83,130,.638,43,83,126,219,70,85,8,71,429,1989/1990
"Strickland,Rod",173,370,.468,2,9,.222,171,361,.474,91,148,.615,47,86,133,249,57,85,6,89,439,1989/1990
"Sundvold,Jon",148,363,.408,44,100,.440,104,263,.395,44,52,.846,15,56,71,102,25,52,0,69,384,1989/1990
"Tarpley,Roy",314,696,.451,0,6,.000,314,690,.455,130,172,.756,189,400,589,67,79,117,70,160,758,1989/1990
"Taylor,Jay",21,52,.404,3,13,.231,18,39,.462,6,9,.667,5,6,11,5,5,10,3,9,51,1989/1990
"Taylor,Leonard",0,6,.000,0,1,.000,0,5,.000,11,16,.688,4,8,12,1,0,5,0,4,11,1989/1990
"Teagle,Terry",538,1122,.480,3,14,.214,535,1108,.483,244,294,.830,114,253,367,155,91,144,15,231,1323,1989/1990
"Theus,Reggie",517,1178,.439,26,105,.248,491,1073,.458,378,443,.853,75,146,221,407,60,226,12,194,1438,1989/1990
"Thomas,Isiah",579,1322,.438,42,136,.309,537,1186,.453,292,377,.775,74,234,308,765,139,322,19,206,1492,1989/1990
"Thompson,Billy",375,727,.516,2,4,.500,373,723,.516,115,185,.622,238,313,551,166,54,156,89,237,867,1989/1990
"Thompson,LaSalle",223,471,.473,1,5,.200,222,466,.476,107,134,.799,175,455,630,106,65,150,71,313,554,1989/1990
"Thompson,Mychal",281,562,.500,0,0,,281,562,.500,144,204,.706,173,304,477,43,33,79,73,207,706,1989/1990
"Thornton,Bob",48,112,.429,1,3,.333,47,109,.431,26,51,.510,45,88,133,17,20,35,12,105,123,1989/1990
"Thorpe,Otis",547,998,.548,0,10,.000,547,988,.554,307,446,.688,258,476,734,261,66,229,24,270,1401,1989/1990
"Threatt,Sedale",303,599,.506,8,32,.250,295,567,.520,130,157,.828,43,72,115,216,65,77,8,164,744,1989/1990
"Tisdale,Wayman",726,1383,.525,0,6,.000,726,1377,.527,306,391,.783,185,410,595,108,54,153,54,251,1758,1989/1990
"Tolbert,Tom",218,442,.493,5,18,.278,213,424,.502,175,241,.726,122,241,363,58,23,79,25,191,616,1989/1990
"Toney,Sedric",87,250,.348,23,63,.365,64,187,.342,67,83,.807,14,46,60,174,33,73,0,106,264,1989/1990
"Toney,Sedric",30,72,.417,7,13,.538,23,59,.390,21,25,.840,3,11,14,52,10,21,0,35,88,1989/1990
"Toney,Sedric",57,178,.320,16,50,.320,41,128,.320,46,58,.793,11,35,46,122,23,52,0,71,176,1989/1990
"Tripucka,Kelly",442,1029,.430,38,104,.365,404,925,.437,310,351,.883,82,240,322,224,75,176,16,220,1232,1989/1990
"Tucker,Trent",253,606,.417,95,245,.388,158,361,.438,66,86,.767,57,117,174,173,74,73,8,159,667,1989/1990
"Turner,Andre",11,38,.289,0,2,.000,11,36,.306,4,4,1.000,4,4,8,23,8,12,0,6,26,1989/1990
"Turner,Andre",2,13,.154,0,1,.000,2,12,.167,0,0,,3,2,5,3,1,4,0,1,4,1989/1990
"Turner,Andre",9,25,.360,0,1,.000,9,24,.375,4,4,1.000,1,2,3,20,7,8,0,5,22,1989/1990
"Turner,Henry",58,122,.475,0,3,.000,58,119,.487,40,65,.615,22,28,50,22,17,26,7,40,156,1989/1990
"Turner,Jeff",132,308,.429,2,10,.200,130,298,.436,42,54,.778,52,175,227,53,23,61,12,161,308,1989/1990
"Turpin,Melvin",110,209,.526,0,2,.000,110,207,.531,56,71,.789,88,133,221,27,15,45,47,135,276,1989/1990
"Upshaw,Kelvin",64,146,.438,4,15,.267,60,131,.458,28,37,.757,9,32,41,54,27,27,1,53,160,1989/1990
"Upshaw,Kelvin",12,39,.308,2,5,.400,10,34,.294,4,6,.667,3,10,13,28,2,12,1,19,30,1989/1990
"Upshaw,Kelvin",1,3,.333,0,1,.000,1,2,.500,0,0,,0,0,0,0,0,0,0,0,2,1989/1990
"Upshaw,Kelvin",51,104,.490,2,9,.222,49,95,.516,24,31,.774,6,22,28,26,25,15,0,34,128,1989/1990
"Vandeweghe,Kiki",102,231,.442,10,19,.526,92,212,.434,44,48,.917,15,38,53,41,15,26,3,28,258,1989/1990
"Vincent,Jay",86,183,.470,1,2,.500,85,181,.470,41,49,.837,20,42,62,18,18,33,5,52,214,1989/1990
"Vincent,Jay",45,105,.429,1,1,1.000,44,104,.423,33,37,.892,13,23,36,8,10,14,2,23,124,1989/1990
"Vincent,Jay",41,78,.526,0,1,.000,41,77,.532,8,12,.667,7,19,26,10,8,19,3,29,90,1989/1990
"Vincent,Sam",258,564,.457,1,14,.071,257,550,.467,188,214,.879,37,157,194,354,65,132,20,108,705,1989/1990
"Voce,Gary",1,3,.333,0,0,,1,3,.333,0,0,,2,0,2,0,0,0,0,0,2,1989/1990
"Volkov,Alexander",137,284,.482,13,34,.382,124,250,.496,70,120,.583,52,67,119,83,36,52,22,166,357,1989/1990
"Wade,Mark",0,0,,0,0,,0,0,,0,0,,0,0,0,2,0,0,0,0,0,1989/1990
"Walker,Darrell",316,696,.454,2,21,.095,314,675,.465,138,201,.687,173,541,714,652,139,173,30,220,772,1989/1990
"Walker,Kenny",204,384,.531,2,5,.400,202,379,.533,125,173,.723,131,212,343,49,33,60,52,178,535,1989/1990
"Webb,Spud",294,616,.477,1,19,.053,293,597,.491,162,186,.871,38,163,201,477,105,141,12,185,751,1989/1990
"Welp,Chris",23,61,.377,0,0,,23,61,.377,19,25,.760,18,30,48,9,6,15,8,58,65,1989/1990
"Welp,Chris",7,23,.304,0,0,,7,23,.304,1,2,.500,7,5,12,5,1,6,0,21,15,1989/1990
"Welp,Chris",16,38,.421,0,0,,16,38,.421,18,23,.783,11,25,36,4,5,9,8,37,50,1989/1990
"Wennington,Bill",105,234,.449,0,4,.000,105,230,.457,60,75,.800,64,134,198,41,20,50,21,144,270,1989/1990
"West,Doug",53,135,.393,3,11,.273,50,124,.403,26,32,.813,24,46,70,18,10,31,6,61,135,1989/1990
"West,Mark",331,530,.625,0,0,,331,530,.625,199,288,.691,212,516,728,45,36,126,184,277,861,1989/1990
"White,Randy",93,252,.369,1,14,.071,92,238,.387,50,89,.562,78,95,173,21,24,47,6,124,237,1989/1990
"Wiggins,Mitchell",416,853,.488,0,3,.000,416,850,.489,192,237,.810,133,153,286,104,85,87,1,165,1024,1989/1990
"Wiley,Morlon",92,208,.442,17,46,.370,75,162,.463,28,38,.737,13,39,52,114,45,63,3,65,229,1989/1990
"Wilkins,Dominique",810,1672,.484,59,183,.322,751,1489,.504,459,569,.807,217,304,521,200,126,174,47,141,2138,1989/1990
"Wilkins,Eddie Lee",141,310,.455,0,2,.000,141,308,.458,89,147,.605,114,151,265,16,18,73,18,152,371,1989/1990
"Wilkins,Gerald",472,1032,.457,39,125,.312,433,907,.477,208,259,.803,133,238,371,330,95,194,21,188,1191,1989/1990
"Williams,Buck",413,754,.548,0,1,.000,413,753,.548,288,408,.706,250,550,800,116,69,168,39,285,1114,1989/1990
"Williams,Herb",295,665,.444,2,9,.222,293,656,.447,108,159,.679,76,315,391,119,51,106,106,243,700,1989/1990
"Williams,Hot Rod",528,1070,.493,0,0,,528,1070,.493,325,440,.739,220,443,663,168,86,143,167,214,1381,1989/1990
"Williams,John",130,274,.474,2,18,.111,128,256,.500,65,84,.774,27,109,136,84,21,43,9,33,327,1989/1990
"Williams,Micheal",60,119,.504,0,3,.000,60,116,.517,36,46,.783,12,20,32,81,22,33,1,39,156,1989/1990
"Williams,Micheal",2,10,.200,0,0,,2,10,.200,1,2,.500,1,0,1,4,0,5,0,0,5,1989/1990
"Williams,Micheal",58,109,.532,0,3,.000,58,106,.547,35,44,.795,11,20,31,77,22,28,1,39,151,1989/1990
"Williams,Mike",6,18,.333,0,1,.000,6,17,.353,3,6,.500,5,18,23,2,3,3,7,30,15,1989/1990
"Williams,Mike",6,14,.429,0,1,.000,6,13,.462,3,6,.500,5,17,22,2,3,3,7,28,15,1989/1990
"Williams,Mike",0,4,.000,0,0,,0,4,.000,0,0,,0,1,1,0,0,0,0,2,0,1989/1990
"Williams,Reggie",131,338,.388,6,37,.162,125,301,.415,52,68,.765,28,55,83,53,32,45,14,102,320,1989/1990
"Williams,Reggie",21,57,.368,0,5,.000,21,52,.404,18,21,.857,8,7,15,10,9,9,1,7,60,1989/1990
"Williams,Reggie",91,239,.381,6,27,.222,85,212,.401,30,41,.732,17,43,60,38,22,32,10,79,218,1989/1990
"Williams,Reggie",19,42,.452,0,5,.000,19,37,.514,4,6,.667,3,5,8,5,1,4,3,16,42,1989/1990
"Willis,Kevin",418,805,.519,2,7,.286,416,798,.521,168,246,.683,253,392,645,57,63,144,47,259,1006,1989/1990
"Wingate,David",220,491,.448,0,13,.000,220,478,.460,87,112,.777,62,133,195,208,89,127,18,154,527,1989/1990
"Wittman,Randy",62,122,.508,1,2,.500,61,120,.508,5,6,.833,4,26,30,39,7,23,4,21,130,1989/1990
"Wolf,Joe",155,392,.395,5,25,.200,150,367,.409,55,71,.775,63,169,232,62,30,77,24,129,370,1989/1990
"Wood,Leon",16,49,.327,4,21,.190,12,28,.429,14,16,.875,1,11,12,47,6,8,0,16,50,1989/1990
"Woodson,Mike",160,405,.395,12,41,.293,148,364,.407,62,86,.721,25,63,88,66,42,49,11,100,394,1989/1990
"Woolridge,Orlando",306,550,.556,0,5,.000,306,545,.561,176,240,.733,49,136,185,96,39,73,46,160,788,1989/1990
"Workman,Haywoode",2,3,.667,0,0,,2,3,.667,2,2,1.000,0,3,3,2,3,0,0,3,6,1989/1990
"Worthy,James",711,1298,.548,15,49,.306,696,1249,.557,248,317,.782,160,318,478,288,99,160,49,190,1685,1989/1990
"Young,Danny",138,328,.421,16,59,.271,122,269,.454,91,112,.813,29,93,122,231,82,80,4,84,383,1989/1990
"Young,Michael",92,194,.474,8,26,.308,84,168,.500,27,38,.711,36,50,86,24,25,15,3,47,219,1989/1990
"Abdelnaby,Alaa",55,116,.474,0,0,,55,116,.474,25,44,.568,27,62,89,12,4,22,12,39,135,1990/1991
"Abdul-Rauf,Mahmoud",417,1009,.413,24,100,.240,393,909,.432,84,98,.857,34,87,121,206,55,110,4,149,942,1990/1991
"Acres,Mark",109,214,.509,1,3,.333,108,211,.512,66,101,.653,140,219,359,25,25,42,25,218,285,1990/1991
"Adams,Michael",560,1421,.394,167,564,.296,393,857,.459,465,529,.879,58,198,256,693,147,240,6,162,1752,1990/1991
"Aguirre,Mark",420,909,.462,24,78,.308,396,831,.477,240,317,.757,134,240,374,139,47,128,20,209,1104,1990/1991
"Ainge,Danny",337,714,.472,102,251,.406,235,463,.508,114,138,.826,45,160,205,285,63,100,13,195,890,1990/1991
"Alarie,Mark",99,225,.440,5,21,.238,94,204,.461,41,48,.854,41,76,117,45,15,40,8,88,244,1990/1991
"Alford,Steve",59,117,.504,7,23,.304,52,94,.553,26,31,.839,10,14,24,22,8,16,1,11,151,1990/1991
"Anderson,Greg",116,270,.430,0,1,.000,116,269,.431,60,115,.522,97,221,318,16,35,84,45,140,292,1990/1991
"Anderson,Greg",27,73,.370,0,1,.000,27,72,.375,16,28,.571,26,49,75,3,8,22,9,29,70,1990/1991
"Anderson,Greg",4,4,1.000,0,0,,4,4,1.000,0,0,,4,2,6,1,2,1,0,4,8,1990/1991
"Anderson,Greg",85,193,.440,0,0,,85,193,.440,44,87,.506,67,170,237,12,25,61,36,107,214,1990/1991
"Anderson,Nick",400,857,.467,17,58,.293,383,799,.479,173,259,.668,92,294,386,106,74,113,44,145,990,1990/1991
"Anderson,Ron",512,1055,.485,9,43,.209,503,1012,.497,165,198,.833,103,264,367,115,65,100,13,163,1198,1990/1991
"Anderson,Willie",453,991,.457,7,35,.200,446,956,.467,170,213,.798,68,283,351,358,79,167,46,226,1083,1990/1991
"Ansley,Michael",144,263,.548,0,0,,144,263,.548,91,127,.717,122,131,253,25,27,32,7,125,379,1990/1991
"Armstrong,B.J.",304,632,.481,15,30,.500,289,602,.480,97,111,.874,25,124,149,301,70,107,4,118,720,1990/1991
"Askew,Vincent",12,25,.480,0,0,,12,25,.480,9,11,.818,7,4,11,13,2,6,0,21,33,1990/1991
"Askins,Keith",34,81,.420,6,25,.240,28,56,.500,12,25,.480,30,38,68,19,16,11,13,46,86,1990/1991
"Babić,Miloš",6,19,.316,0,0,,6,19,.316,7,12,.583,6,3,9,4,1,5,1,7,19,1990/1991
"Bailey,Thurl",399,872,.458,0,3,.000,399,869,.459,219,271,.808,101,306,407,124,53,130,91,160,1017,1990/1991
"Ball,Cedric",3,8,.375,0,0,,3,8,.375,2,2,1.000,5,6,11,0,0,2,2,5,8,1990/1991
"Bannister,Ken",43,81,.531,0,1,.000,43,80,.538,25,65,.385,34,62,96,9,5,25,7,73,111,1990/1991
"Barkley,Charles",665,1167,.570,44,155,.284,621,1012,.614,475,658,.722,258,422,680,284,110,210,33,173,1849,1990/1991
"Barros,Dana",154,311,.495,32,81,.395,122,230,.530,78,85,.918,17,54,71,111,23,54,1,40,418,1990/1991
"Battle,John",397,862,.461,14,49,.286,383,813,.471,270,316,.854,34,125,159,217,45,113,6,145,1078,1990/1991
"Battle,Kenny",133,282,.472,3,24,.125,130,258,.504,70,93,.753,83,93,176,62,60,53,18,108,339,1990/1991
"Battle,Kenny",38,86,.442,0,2,.000,38,84,.452,20,29,.690,21,32,53,15,19,17,6,25,96,1990/1991
"Battle,Kenny",95,196,.485,3,22,.136,92,174,.529,50,64,.781,62,61,123,47,41,36,12,83,243,1990/1991
"Bedford,William",106,242,.438,5,13,.385,101,229,.441,55,78,.705,55,76,131,32,2,32,36,76,272,1990/1991
"Benjamin,Benoit",386,778,.496,0,0,,386,778,.496,210,295,.712,157,566,723,119,54,235,145,184,982,1990/1991
"Benjamin,Benoit",229,465,.492,0,0,,229,465,.492,123,169,.728,95,374,469,74,26,138,91,110,581,1990/1991
"Benjamin,Benoit",157,313,.502,0,0,,157,313,.502,87,126,.690,62,192,254,45,28,97,54,74,401,1990/1991
"Bennett,Winston",40,107,.374,0,0,,40,107,.374,35,47,.745,30,34,64,28,8,20,2,50,115,1990/1991
"Bird,Larry",462,1017,.454,77,198,.389,385,819,.470,163,183,.891,53,456,509,431,108,187,58,118,1164,1990/1991
"Blackman,Rolando",634,1316,.482,40,114,.351,594,1202,.494,282,326,.865,63,193,256,301,69,159,19,153,1590,1990/1991
"Blanks,Lance",26,61,.426,2,16,.125,24,45,.533,10,14,.714,4,16,20,26,9,18,2,35,64,1990/1991
"Blaylock,Mookie",432,1039,.416,14,91,.154,418,948,.441,139,176,.790,67,182,249,441,169,207,40,180,1017,1990/1991
"Bogues,Muggsy",241,524,.460,0,12,.000,241,512,.471,86,108,.796,58,158,216,669,137,120,3,160,568,1990/1991
"Bol,Manute",65,164,.396,1,14,.071,64,150,.427,24,41,.585,66,284,350,20,16,63,247,184,155,1990/1991
"Bonner,Anthony",103,230,.448,0,0,,103,230,.448,44,76,.579,59,102,161,49,39,41,5,62,250,1990/1991
"Bowie,Sam",314,723,.434,4,22,.182,310,701,.442,169,231,.732,176,304,480,147,43,141,90,175,801,1990/1991
"Breuer,Randy",197,435,.453,0,0,,197,435,.453,35,79,.443,114,231,345,73,35,69,80,132,429,1990/1991
"Brickowski,Frank",372,706,.527,0,2,.000,372,704,.528,198,248,.798,129,297,426,131,86,160,43,255,942,1990/1991
"Brooks,Scott",159,370,.430,45,135,.333,114,235,.485,61,72,.847,28,44,72,204,53,51,5,122,424,1990/1991
"Brown,Chucky",263,502,.524,0,4,.000,263,498,.528,101,144,.701,78,135,213,80,26,94,24,130,627,1990/1991
"Brown,Dee",284,612,.464,7,34,.206,277,578,.479,137,157,.873,41,141,182,344,83,137,14,161,712,1990/1991
"Brown,Mike",129,284,.454,0,0,,129,284,.454,132,178,.742,109,228,337,49,29,82,24,166,390,1990/1991
"Brown,Tony",30,80,.375,3,12,.250,27,68,.397,20,23,.870,24,19,43,16,4,16,0,47,83,1990/1991
"Brown,Tony",2,3,.667,1,1,1.000,1,2,.500,0,0,,0,4,4,3,0,4,0,8,5,1990/1991
"Brown,Tony",28,77,.364,2,11,.182,26,66,.394,20,23,.870,24,15,39,13,4,12,0,39,78,1990/1991
"Bryant,Mark",99,203,.488,0,1,.000,99,202,.490,74,101,.733,65,125,190,27,15,33,12,120,272,1990/1991
"Buechler,Jud",94,226,.416,1,4,.250,93,222,.419,43,66,.652,61,80,141,51,33,26,15,79,232,1990/1991
"Bullard,Matt",14,31,.452,0,3,.000,14,28,.500,11,17,.647,6,8,14,2,3,3,0,10,39,1990/1991
"Burton,Willie",341,773,.441,4,30,.133,337,743,.454,229,293,.782,111,151,262,107,72,144,24,275,915,1990/1991
"Butler,Greg",5,19,.263,0,0,,5,19,.263,4,6,.667,8,8,16,1,0,4,0,9,14,1990/1991
"Cage,Michael",226,445,.508,0,3,.000,226,442,.511,70,112,.625,177,381,558,89,85,83,58,194,522,1990/1991
"Caldwell,Adrian",35,83,.422,0,1,.000,35,82,.427,7,17,.412,43,57,100,8,19,30,10,35,77,1990/1991
"Calloway,Rick",75,192,.391,0,2,.000,75,190,.395,55,79,.696,25,53,78,61,22,51,7,98,205,1990/1991
"Campbell,Elden",56,123,.455,0,0,,56,123,.455,32,49,.653,40,56,96,10,11,16,38,71,144,1990/1991
"Campbell,Tony",652,1502,.434,16,61,.262,636,1441,.441,358,446,.803,161,185,346,214,121,190,48,204,1678,1990/1991
"Carr,Antoine",628,1228,.511,0,3,.000,628,1225,.513,295,389,.758,163,257,420,191,45,171,101,315,1551,1990/1991
"Carroll,Joe Barry",13,36,.361,0,0,,13,36,.361,11,12,.917,3,21,24,11,1,12,8,18,37,1990/1991
"Cartwright,Bill",318,649,.490,0,0,,318,649,.490,124,178,.697,167,319,486,126,32,113,15,167,760,1990/1991
"Catledge,Terry",292,632,.462,0,5,.000,292,627,.466,161,258,.624,168,187,355,58,34,107,9,113,745,1990/1991
"Causwell,Duane",210,413,.508,0,0,,210,413,.508,105,165,.636,141,250,391,69,49,96,148,225,525,1990/1991
"Ceballos,Cedric",204,419,.487,1,6,.167,203,413,.492,110,166,.663,77,73,150,35,22,69,5,70,519,1990/1991
"Chambers,Tom",556,1271,.437,20,73,.274,536,1198,.447,379,459,.826,104,386,490,194,65,177,52,235,1511,1990/1991
"Chapman,Rex",410,922,.445,48,148,.324,362,774,.468,234,282,.830,45,146,191,250,73,131,16,167,1102,1990/1991
"Cheeks,Maurice",241,483,.499,5,20,.250,236,463,.510,105,129,.814,22,151,173,435,128,108,10,138,592,1990/1991
"Chievous,Derrick",17,46,.370,0,0,,17,46,.370,9,16,.563,11,7,18,2,3,6,1,16,43,1990/1991
"Coffey,Richard",28,75,.373,0,1,.000,28,74,.378,12,22,.545,42,37,79,3,6,5,4,45,68,1990/1991
"Coleman,Derrick",514,1100,.467,13,38,.342,501,1062,.472,323,442,.731,269,490,759,163,71,217,99,217,1364,1990/1991
"Coles,Bimbo",162,393,.412,6,34,.176,156,359,.435,71,95,.747,56,97,153,232,65,98,12,149,401,1990/1991
"Colter,Steve",23,56,.411,5,14,.357,18,42,.429,7,10,.700,5,21,26,37,11,11,1,27,58,1990/1991
"Conner,Lester",96,207,.464,0,5,.000,96,202,.475,68,94,.723,21,91,112,165,85,58,2,75,260,1990/1991
"Conner,Lester",58,111,.523,0,2,.000,58,109,.532,29,42,.690,11,46,57,58,37,27,1,38,145,1990/1991
"Conner,Lester",38,96,.396,0,3,.000,38,93,.409,39,52,.750,10,45,55,107,48,31,1,37,115,1990/1991
"Cook,Anthony",118,283,.417,0,3,.000,118,280,.421,71,129,.550,134,192,326,26,35,50,72,100,307,1990/1991
"Cooper,Wayne",57,145,.393,0,1,.000,57,144,.396,33,42,.786,54,134,188,22,7,22,61,120,147,1990/1991
"Corbin,Tyrone",587,1311,.448,2,10,.200,585,1301,.450,296,371,.798,185,404,589,347,162,209,53,257,1472,1990/1991
"Corzine,Dave",17,38,.447,0,0,,17,38,.447,13,22,.591,10,23,33,4,5,2,5,18,47,1990/1991
"Cummings,Pat",4,6,.667,0,0,,4,6,.667,7,10,.700,3,2,5,0,0,2,0,8,15,1990/1991
"Cummings,Terry",503,1039,.484,7,33,.212,496,1006,.493,164,240,.683,194,327,521,157,61,131,30,225,1177,1990/1991
"Cureton,Earl",8,24,.333,0,1,.000,8,23,.348,1,3,.333,6,30,36,3,0,6,3,16,17,1990/1991
"Curry,Dell",337,715,.471,32,86,.372,305,629,.485,96,114,.842,47,152,199,166,75,80,25,125,802,1990/1991
"Dailey,Quintin",73,155,.471,0,1,.000,73,154,.474,38,62,.613,11,21,32,16,7,19,1,25,184,1990/1991
"Dantley,Adrian",19,50,.380,1,3,.333,18,47,.383,18,26,.692,8,5,13,9,5,6,0,8,57,1990/1991
"Daugherty,Brad",605,1155,.524,0,3,.000,605,1152,.525,435,579,.751,177,653,830,253,74,211,46,191,1645,1990/1991
"Davis,Brad",159,373,.426,22,85,.259,137,288,.476,91,118,.771,13,105,118,230,45,77,17,212,431,1990/1991
"Davis,Terry",115,236,.487,1,2,.500,114,234,.487,69,124,.556,107,159,266,39,18,36,28,129,300,1990/1991
"Davis,Walter",403,862,.468,11,36,.306,392,826,.475,107,117,.915,71,110,181,125,80,88,3,150,924,1990/1991
"Davis,Walter",316,667,.474,10,33,.303,306,634,.483,86,94,.915,52,71,123,84,62,63,3,108,728,1990/1991
"Davis,Walter",87,195,.446,1,3,.333,86,192,.448,21,23,.913,19,39,58,41,18,25,0,42,196,1990/1991
"Dawkins,Johnny",26,41,.634,1,4,.250,25,37,.676,10,11,.909,0,16,16,28,3,8,0,4,63,1990/1991
"Dawson,Tony",4,7,.571,1,1,1.000,3,6,.500,0,0,,2,0,2,0,0,1,0,0,9,1990/1991
"Dinkins,Byron",14,34,.412,0,0,,14,34,.412,8,9,.889,0,12,12,19,2,13,0,15,36,1990/1991
"Dinkins,Byron",13,33,.394,0,0,,13,33,.394,8,9,.889,0,11,11,19,2,13,0,12,34,1990/1991
"Dinkins,Byron",1,1,1.000,0,0,,1,1,1.000,0,0,,0,1,1,0,0,0,0,3,2,1990/1991
"Divac,Vlade",360,637,.565,5,14,.357,355,623,.570,196,279,.703,205,461,666,92,106,146,127,247,921,1990/1991
"Donaldson,James",327,615,.532,0,0,,327,615,.532,165,229,.721,201,526,727,69,34,146,93,181,819,1990/1991
"Douglas,Sherman",532,1055,.504,4,31,.129,528,1024,.516,284,414,.686,78,131,209,624,121,270,5,178,1352,1990/1991
"Dreiling,Greg",98,194,.505,0,2,.000,98,192,.510,63,105,.600,66,189,255,51,24,57,29,178,259,1990/1991
"Drew,Larry",54,125,.432,14,33,.424,40,92,.435,17,22,.773,5,29,34,118,15,49,1,40,139,1990/1991
"Drexler,Clyde",645,1338,.482,61,191,.319,584,1147,.509,416,524,.794,212,334,546,493,144,232,60,226,1767,1990/1991
"Duckworth,Kevin",521,1084,.481,0,2,.000,521,1082,.482,240,311,.772,177,354,531,89,33,186,34,251,1282,1990/1991
"Dudley,Chris",170,417,.408,0,0,,170,417,.408,94,176,.534,229,282,511,37,39,80,153,217,434,1990/1991
"Dumars,Joe",622,1292,.481,14,45,.311,608,1247,.488,371,417,.890,62,125,187,443,89,189,7,135,1629,1990/1991
"Dunn,T.R.",21,47,.447,1,4,.250,20,43,.465,9,10,.900,20,22,42,24,12,7,1,30,52,1990/1991
"Eackles,Ledell",345,762,.453,14,59,.237,331,703,.471,164,222,.739,47,81,128,136,47,115,10,121,868,1990/1991
"Eaton,Mark",169,292,.579,0,0,,169,292,.579,71,112,.634,182,485,667,51,39,99,188,298,409,1990/1991
"Edwards,Blue",244,464,.526,6,24,.250,238,440,.541,82,117,.701,51,150,201,108,57,105,29,203,576,1990/1991
"Edwards,James",383,792,.484,1,2,.500,382,790,.484,215,295,.729,91,186,277,65,12,126,30,249,982,1990/1991
"Edwards,Kevin",380,927,.410,24,84,.286,356,843,.422,171,213,.803,80,125,205,240,129,163,46,151,955,1990/1991
"Ehlo,Craig",344,773,.445,49,149,.329,295,624,.473,95,140,.679,142,246,388,376,121,160,34,209,832,1990/1991
"Elie,Mario",79,159,.497,4,10,.400,75,149,.503,75,89,.843,46,64,110,45,19,30,10,85,237,1990/1991
"Elie,Mario",2,7,.286,1,2,.500,1,5,.200,1,2,.500,0,1,1,1,0,3,0,2,6,1990/1991
"Elie,Mario",77,152,.507,3,8,.375,74,144,.514,74,87,.851,46,63,109,44,19,27,10,83,231,1990/1991
"Elliott,Sean",478,976,.490,20,64,.313,458,912,.502,325,402,.808,142,314,456,238,69,147,33,190,1301,1990/1991
"Ellis,Dale",340,718,.474,57,157,.363,283,561,.504,120,166,.723,66,107,173,95,49,81,8,112,857,1990/1991
"Ellis,Dale",181,391,.463,27,89,.303,154,302,.510,62,84,.738,28,64,92,64,33,49,3,59,451,1990/1991
"Ellis,Dale",159,327,.486,30,68,.441,129,259,.498,58,82,.707,38,43,81,31,16,32,5,53,406,1990/1991
"Ellison,Pervis",326,636,.513,0,6,.000,326,630,.517,139,214,.650,224,361,585,102,49,146,157,268,791,1990/1991
"English,A.J.",251,572,.439,3,31,.097,248,541,.458,111,157,.707,66,81,147,177,25,114,15,127,616,1990/1991
"English,Alex",322,734,.439,0,1,.000,322,733,.439,119,140,.850,108,146,254,105,40,101,25,141,763,1990/1991
"Ewing,Patrick",845,1645,.514,0,6,.000,845,1639,.516,464,623,.745,194,711,905,244,80,291,258,287,2154,1990/1991
"Farmer,Jim",101,223,.453,5,23,.217,96,200,.480,48,65,.738,29,39,68,38,13,38,2,58,255,1990/1991
"Farmer,Jim",2,7,.286,0,1,.000,2,6,.333,2,2,1.000,2,3,5,0,0,1,0,0,6,1990/1991
"Farmer,Jim",99,216,.458,5,22,.227,94,194,.485,46,63,.730,27,36,63,38,13,37,2,58,249,1990/1991
"Feitl,Dave",52,140,.371,0,3,.000,52,137,.380,33,44,.750,29,71,100,8,3,25,12,52,137,1990/1991
"Ferrell,Duane",174,356,.489,2,3,.667,172,353,.487,125,156,.801,97,82,179,55,33,78,27,151,475,1990/1991
"Ferry,Danny",275,643,.428,23,77,.299,252,566,.445,124,152,.816,99,187,286,142,43,120,25,230,697,1990/1991
"Fleming,Vern",356,671,.531,4,18,.222,352,653,.539,161,221,.729,83,131,214,369,76,137,13,116,877,1990/1991
"Floyd,Sleepy",386,939,.411,48,176,.273,338,763,.443,185,246,.752,52,107,159,317,95,140,17,122,1005,1990/1991
"Foster,Greg",97,211,.460,0,5,.000,97,206,.471,42,61,.689,52,99,151,37,12,45,22,112,236,1990/1991
"Frederick,Anthony",67,168,.399,0,0,,67,168,.399,43,60,.717,36,48,84,44,22,40,13,50,177,1990/1991
"Gaines,Corey",28,70,.400,5,21,.238,23,49,.469,22,26,.846,4,10,14,91,10,23,2,25,83,1990/1991
"Gamble,Kevin",548,933,.587,0,7,.000,548,926,.592,185,227,.815,85,182,267,256,100,148,34,237,1281,1990/1991
"Garland,Winston",221,519,.426,4,26,.154,217,493,.440,118,157,.752,46,152,198,317,97,116,10,189,564,1990/1991
"Garrick,Tom",100,236,.424,0,22,.000,100,214,.467,60,79,.759,40,87,127,223,62,66,2,101,260,1990/1991
"Gattison,Kenny",243,457,.532,0,2,.000,243,455,.534,164,248,.661,136,243,379,44,48,102,67,211,650,1990/1991
"George,Tate",80,193,.415,0,2,.000,80,191,.419,32,40,.800,19,28,47,104,25,42,5,58,192,1990/1991
"Gervin,Derrick",164,394,.416,7,28,.250,157,366,.429,90,114,.789,40,70,110,30,19,45,19,88,425,1990/1991
"Gill,Kendall",376,836,.450,2,14,.143,374,822,.455,152,182,.835,105,158,263,303,104,163,39,186,906,1990/1991
"Gilliam,Armen",487,1001,.487,0,2,.000,487,999,.487,268,329,.815,220,378,598,105,69,174,53,185,1242,1990/1991
"Gilliam,Armen",195,380,.513,0,0,,195,380,.513,104,128,.813,86,148,234,27,34,64,21,65,494,1990/1991
"Gilliam,Armen",292,621,.470,0,2,.000,292,619,.472,164,201,.816,134,230,364,78,35,110,32,120,748,1990/1991
"Glass,Gerald",149,340,.438,2,17,.118,147,323,.455,52,76,.684,54,48,102,42,28,41,9,76,352,1990/1991
"Gminski,Mike",357,808,.442,2,14,.143,355,794,.447,128,158,.810,186,396,582,93,40,85,56,99,844,1990/1991
"Gminski,Mike",109,284,.384,1,8,.125,108,276,.391,53,63,.841,71,130,201,33,16,31,34,41,272,1990/1991
"Gminski,Mike",248,524,.473,1,6,.167,247,518,.477,75,95,.789,115,266,381,60,24,54,22,58,572,1990/1991
"Godfread,Dan",5,12,.417,0,1,.000,5,11,.455,3,4,.750,0,2,2,0,1,0,4,5,13,1990/1991
"Grandholm,Jim",30,58,.517,9,17,.529,21,41,.512,10,21,.476,20,30,50,8,2,11,8,33,79,1990/1991
"Grant,Gary",265,587,.451,9,39,.231,256,548,.467,51,74,.689,69,140,209,587,103,210,12,192,590,1990/1991
"Grant,Greg",10,27,.370,1,3,.333,9,24,.375,5,6,.833,1,9,10,20,9,10,0,12,26,1990/1991
"Grant,Harvey",609,1224,.498,2,15,.133,607,1209,.502,185,249,.743,179,378,557,204,91,125,61,232,1405,1990/1991
"Grant,Horace",401,733,.547,1,6,.167,400,727,.550,197,277,.711,266,393,659,178,95,92,69,203,1000,1990/1991
"Gray,Stuart",4,12,.333,0,0,,4,12,.333,3,3,1.000,2,8,10,0,0,2,1,6,11,1990/1991
"Grayer,Jeff",210,485,.433,0,3,.000,210,482,.436,101,147,.687,111,135,246,123,48,86,9,98,521,1990/1991
"Green,A.C.",258,542,.476,11,55,.200,247,487,.507,223,302,.738,201,315,516,71,59,99,23,117,750,1990/1991
"Green,Rickey",334,722,.463,8,36,.222,326,686,.475,117,141,.830,33,104,137,413,57,108,6,130,793,1990/1991
"Green,Sidney",177,384,.461,0,3,.000,177,381,.465,89,105,.848,98,215,313,52,32,89,13,172,443,1990/1991
"Greenwood,Dave",85,169,.503,0,2,.000,85,167,.509,69,94,.734,61,160,221,52,29,71,25,172,239,1990/1991
"Griffith,Darrell",174,445,.391,48,138,.348,126,307,.410,34,45,.756,17,73,90,37,42,48,7,100,430,1990/1991
"Haffner,Scott",8,21,.381,0,2,.000,8,19,.421,1,2,.500,2,2,4,9,3,4,1,4,17,1990/1991
"Haley,Jack",161,343,.469,0,0,,161,343,.469,112,181,.619,140,216,356,31,20,63,21,199,434,1990/1991
"Hammonds,Tom",155,336,.461,0,4,.000,155,332,.467,57,79,.722,58,148,206,43,15,54,7,108,367,1990/1991
"Hansen,Bob",96,256,.375,19,69,.275,77,187,.412,18,36,.500,33,63,96,90,20,34,5,72,229,1990/1991
"Hardaway,Tim",739,1551,.476,97,252,.385,642,1299,.494,306,381,.803,87,245,332,793,214,270,12,228,1881,1990/1991
"Harper,Derek",572,1226,.467,89,246,.362,483,980,.493,286,391,.731,59,174,233,548,147,177,14,222,1519,1990/1991
"Harper,Ron",285,729,.391,48,148,.324,237,581,.408,145,217,.668,58,130,188,209,66,129,35,111,763,1990/1991
"Harris,Tony",4,16,.250,0,2,.000,4,14,.286,2,4,.500,0,1,1,0,1,3,0,5,10,1990/1991
"Hastings,Scott",16,28,.571,3,4,.750,13,24,.542,13,13,1.000,14,14,28,7,0,7,0,23,48,1990/1991
"Hawkins,Hersey",590,1251,.472,108,270,.400,482,981,.491,479,550,.871,48,262,310,299,178,213,39,182,1767,1990/1991
"Henderson,Gerald",50,117,.427,7,21,.333,43,96,.448,16,21,.762,8,29,37,62,12,28,2,43,123,1990/1991
"Henson,Steve",79,189,.418,18,54,.333,61,135,.452,38,42,.905,14,37,51,131,32,43,0,83,214,1990/1991
"Higgins,Mike",6,10,.600,0,0,,6,10,.600,4,7,.571,4,1,5,2,0,4,2,16,16,1990/1991
"Higgins,Rod",259,559,.463,73,220,.332,186,339,.549,185,226,.819,109,245,354,113,52,65,37,198,776,1990/1991
"Higgins,Sean",97,212,.458,3,19,.158,94,193,.487,28,33,.848,18,45,63,35,8,49,1,53,225,1990/1991
"Hill,Tyrone",147,299,.492,0,0,,147,299,.492,96,152,.632,157,226,383,19,33,72,30,264,390,1990/1991
"Hinson,Roy",20,39,.513,0,0,,20,39,.513,1,3,.333,6,13,19,4,0,6,3,14,41,1990/1991
"Hodges,Craig",146,344,.424,44,115,.383,102,229,.445,26,27,.963,10,32,42,97,34,35,2,74,362,1990/1991
"Hoppen,Dave",24,44,.545,0,2,.000,24,42,.571,16,22,.727,18,21,39,3,3,13,1,29,64,1990/1991
"Hoppen,Dave",18,32,.563,0,1,.000,18,31,.581,8,10,.800,14,16,30,3,2,12,1,18,44,1990/1991
"Hoppen,Dave",6,12,.500,0,1,.000,6,11,.545,8,12,.667,4,5,9,0,1,1,0,11,20,1990/1991
"Hopson,Dennis",104,244,.426,1,5,.200,103,239,.431,55,83,.663,49,60,109,65,25,59,14,79,264,1990/1991
"Hornacek,Jeff",544,1051,.518,61,146,.418,483,905,.534,201,224,.897,74,247,321,409,111,130,16,185,1350,1990/1991
"Humphries,Jay",482,960,.502,60,161,.373,422,799,.528,191,239,.799,57,163,220,538,129,151,7,237,1215,1990/1991
"Irvin,Byron",60,129,.465,1,5,.200,59,124,.476,50,61,.820,24,21,45,24,15,16,2,32,171,1990/1991
"Jackson,Mark",250,508,.492,13,51,.255,237,457,.519,117,160,.731,62,135,197,452,60,135,9,81,630,1990/1991
"Jamerson,Dave",43,113,.381,5,19,.263,38,94,.404,22,27,.815,9,21,30,27,6,20,1,24,113,1990/1991
"James,Henry",112,254,.441,24,60,.400,88,194,.454,52,72,.722,26,53,79,32,15,37,5,59,300,1990/1991
"Jepsen,Les",11,36,.306,0,1,.000,11,35,.314,6,9,.667,17,20,37,1,1,3,3,16,28,1990/1991
"Johnson,Avery",130,277,.469,1,9,.111,129,268,.481,59,87,.678,22,55,77,230,47,74,4,62,320,1990/1991
"Johnson,Avery",29,68,.426,0,4,.000,29,64,.453,21,32,.656,9,12,21,77,14,27,2,22,79,1990/1991
"Johnson,Avery",101,209,.483,1,5,.200,100,204,.490,38,55,.691,13,43,56,153,33,47,2,40,241,1990/1991
"Johnson,Buck",416,873,.477,2,15,.133,414,858,.483,157,216,.727,108,222,330,142,81,122,47,240,991,1990/1991
"Johnson,Eddie",543,1122,.484,39,120,.325,504,1002,.503,229,257,.891,107,164,271,111,58,122,9,181,1354,1990/1991
"Johnson,Eddie",88,186,.473,6,21,.286,82,165,.497,21,29,.724,16,30,46,17,9,24,2,37,203,1990/1991
"Johnson,Eddie",455,936,.486,33,99,.333,422,837,.504,208,228,.912,91,134,225,94,49,98,7,144,1151,1990/1991
"Johnson,Kevin",591,1145,.516,9,44,.205,582,1101,.529,519,616,.843,54,217,271,781,163,269,11,174,1710,1990/1991
"Johnson,Magic",466,976,.477,80,250,.320,386,726,.532,519,573,.906,105,446,551,989,102,314,17,150,1531,1990/1991
"Johnson,Steve",34,63,.540,0,0,,34,63,.540,22,37,.595,18,39,57,17,4,25,4,50,90,1990/1991
"Johnson,Vinnie",406,936,.434,11,34,.324,395,902,.438,135,209,.646,110,170,280,271,75,118,15,166,958,1990/1991
"Jones,Charles",67,124,.540,0,0,,67,124,.540,29,50,.580,119,240,359,48,51,46,124,199,163,1990/1991
"Jordan,Michael",990,1837,.539,29,93,.312,961,1744,.551,571,671,.851,118,374,492,453,223,202,83,229,2580,1990/1991
"Kemp,Shawn",462,909,.508,2,12,.167,460,897,.513,288,436,.661,267,412,679,144,77,202,123,319,1214,1990/1991
"Kerr,Steve",99,223,.444,28,62,.452,71,161,.441,45,53,.849,5,32,37,131,29,40,4,52,271,1990/1991
"Kersey,Jerome",424,887,.478,4,13,.308,420,874,.481,232,327,.709,169,312,481,227,101,149,76,251,1084,1990/1991
"Kessler,Alec",199,468,.425,0,4,.000,199,464,.429,88,131,.672,115,221,336,31,17,108,26,189,486,1990/1991
"Keys,Randolph",59,145,.407,3,14,.214,56,131,.427,19,33,.576,40,60,100,18,22,35,15,93,140,1990/1991
"Kimble,Bo",159,418,.380,19,65,.292,140,353,.397,92,119,.773,42,77,119,76,30,77,8,158,429,1990/1991
"King,Bernard",713,1511,.472,8,37,.216,705,1474,.478,383,485,.790,114,205,319,292,56,255,16,187,1817,1990/1991
"King,Stacey",156,334,.467,0,2,.000,156,332,.470,107,152,.704,72,136,208,65,24,91,42,134,419,1990/1991
"Kite,Greg",166,338,.491,0,0,,166,338,.491,63,123,.512,189,399,588,59,25,102,81,298,395,1990/1991
"Kleine,Joe",102,218,.468,0,2,.000,102,216,.472,54,69,.783,71,173,244,21,15,53,14,108,258,1990/1991
"Knight,Negele",131,308,.425,6,25,.240,125,283,.442,71,118,.602,20,51,71,191,20,76,7,83,339,1990/1991
"Kofoed,Bart",0,3,.000,0,0,,0,3,.000,3,6,.500,2,1,3,4,0,2,0,4,3,1990/1991
"Koncak,Jon",140,321,.436,1,8,.125,139,313,.444,32,54,.593,101,274,375,124,74,50,76,265,313,1990/1991
"Kornet,Frank",23,62,.371,5,18,.278,18,44,.409,7,13,.538,10,14,24,9,5,11,1,28,58,1990/1991
"Laimbeer,Bill",372,778,.478,37,125,.296,335,653,.513,123,147,.837,173,564,737,157,38,98,56,242,904,1990/1991
"Lane,Jerome",202,461,.438,1,4,.250,201,457,.440,58,141,.411,280,298,578,123,51,105,14,192,463,1990/1991
"Lang,Andrew",109,189,.577,0,1,.000,109,188,.580,93,130,.715,113,190,303,27,17,45,127,168,311,1990/1991
"Leckner,Eric",131,294,.446,0,0,,131,294,.446,62,111,.559,82,213,295,39,14,69,22,192,324,1990/1991
"Leckner,Eric",39,96,.406,0,0,,39,96,.406,16,27,.593,27,60,87,18,4,25,11,69,94,1990/1991
"Leckner,Eric",92,198,.465,0,0,,92,198,.465,46,84,.548,55,153,208,21,10,44,11,123,230,1990/1991
"Lee,Kurk",19,71,.268,3,15,.200,16,56,.286,25,28,.893,7,23,30,34,11,20,2,39,66,1990/1991
"Legler,Tim",25,72,.347,3,12,.250,22,60,.367,5,6,.833,8,10,18,12,2,4,0,20,58,1990/1991
"Leonard,Gary",0,0,,0,0,,0,0,,2,4,.500,0,2,2,0,0,0,1,2,2,1990/1991
"Les,Jim",119,268,.444,71,154,.461,48,114,.421,86,103,.835,18,93,111,299,57,75,4,141,395,1990/1991
"Lett,Clifford",14,29,.483,0,1,.000,14,28,.500,6,9,.667,1,6,7,7,2,8,1,9,34,1990/1991
"Lever,Fat",9,23,.391,0,3,.000,9,20,.450,11,14,.786,3,12,15,12,6,10,3,5,29,1990/1991
"Levingston,Cliff",127,282,.450,1,4,.250,126,278,.453,59,91,.648,99,126,225,56,29,50,43,143,314,1990/1991
"Lewis,Reggie",598,1219,.491,1,13,.077,597,1206,.495,281,340,.826,119,291,410,201,98,147,85,234,1478,1990/1991
"Liberty,Marcus",216,513,.421,17,57,.298,199,456,.436,58,92,.630,117,104,221,64,48,71,19,153,507,1990/1991
"Lichti,Todd",166,378,.439,14,47,.298,152,331,.459,59,69,.855,49,63,112,72,46,33,8,65,405,1990/1991
"Lister,Alton",188,393,.478,0,1,.000,188,392,.480,115,202,.569,121,362,483,93,20,106,90,282,491,1990/1991
"Lockhart,Ian",1,1,1.000,0,0,,1,1,1.000,2,2,1.000,0,0,0,0,0,0,0,0,4,1990/1991
"Lohaus,Brad",179,415,.431,33,119,.277,146,296,.493,37,54,.685,59,158,217,75,50,60,74,170,428,1990/1991
"Long,Grant",276,561,.492,1,6,.167,275,555,.495,181,230,.787,225,343,568,176,119,156,43,295,734,1990/1991
"Long,John",35,85,.412,2,6,.333,33,79,.418,24,25,.960,9,23,32,18,9,14,2,17,96,1990/1991
"Mahorn,Rick",261,559,.467,0,9,.000,261,550,.475,189,240,.788,151,470,621,118,79,127,56,276,711,1990/1991
"Majerle,Dan",397,821,.484,30,86,.349,367,735,.499,227,298,.762,168,250,418,216,106,114,40,162,1051,1990/1991
"Malone,Jeff",525,1034,.508,1,6,.167,524,1028,.510,231,252,.917,36,170,206,143,50,108,6,128,1282,1990/1991
"Malone,Karl",847,1608,.527,4,14,.286,843,1594,.529,684,888,.770,236,731,967,270,89,244,79,268,2382,1990/1991
"Malone,Moses",280,598,.468,0,7,.000,280,591,.474,309,372,.831,271,396,667,68,30,137,74,134,869,1990/1991
"Manning,Danny",470,905,.519,0,3,.000,470,902,.521,219,306,.716,169,257,426,196,117,188,62,281,1159,1990/1991
"Marčiulionis,Šarūnas",183,365,.501,1,6,.167,182,359,.507,178,246,.724,51,67,118,85,62,75,4,136,545,1990/1991
"Martin,Jeff",214,507,.422,27,88,.307,187,419,.446,68,100,.680,53,78,131,65,37,49,31,104,523,1990/1991
"Mason,Anthony",2,4,.500,0,0,,2,4,.500,6,8,.750,3,2,5,0,1,0,0,6,10,1990/1991
"Massenburg,Tony",27,60,.450,0,0,,27,60,.450,28,45,.622,23,35,58,4,4,13,9,26,82,1990/1991
"Maxwell,Vernon",504,1247,.404,172,510,.337,332,737,.450,217,296,.733,41,197,238,303,127,171,15,179,1397,1990/1991
"Mays,Travis",294,724,.406,72,197,.365,222,527,.421,255,331,.770,54,124,178,253,81,159,11,169,915,1990/1991
"McCloud,George",131,351,.373,43,124,.347,88,227,.388,38,49,.776,35,83,118,150,40,91,11,141,343,1990/1991
"McCormick,Tim",93,187,.497,0,3,.000,93,184,.505,66,90,.733,56,109,165,32,11,45,14,91,252,1990/1991
"McCray,Rodney",336,679,.495,13,39,.333,323,640,.505,159,198,.803,153,407,560,259,70,129,51,203,844,1990/1991
"McDaniel,Xavier",590,1186,.497,0,8,.000,590,1178,.501,193,267,.723,173,384,557,187,76,184,46,264,1373,1990/1991
"McDaniel,Xavier",139,290,.479,0,3,.000,139,287,.484,49,69,.710,36,45,81,38,26,40,4,50,327,1990/1991
"McDaniel,Xavier",451,896,.503,0,5,.000,451,891,.506,144,198,.727,137,339,476,149,50,144,42,214,1046,1990/1991
"McHale,Kevin",504,912,.553,15,37,.405,489,875,.559,228,275,.829,145,335,480,126,25,140,146,194,1251,1990/1991
"McKey,Derrick",438,847,.517,4,19,.211,434,828,.524,235,278,.845,172,251,423,169,91,158,56,220,1115,1990/1991
"McMillan,Nate",132,305,.433,17,48,.354,115,257,.447,57,93,.613,71,180,251,371,104,122,20,211,338,1990/1991
"McNamara,Mark",0,1,.000,0,0,,0,1,.000,0,0,,0,4,4,0,0,0,0,1,0,1990/1991
"Meents,Scott",7,28,.250,1,1,1.000,6,27,.222,2,4,.500,3,7,10,8,7,6,4,5,17,1990/1991
"Miller,Reggie",596,1164,.512,112,322,.348,484,842,.575,551,600,.918,81,200,281,331,109,163,13,165,1855,1990/1991
"Mills,Terry",134,288,.465,0,4,.000,134,284,.472,47,66,.712,82,147,229,33,35,43,29,100,315,1990/1991
"Mills,Terry",56,120,.467,0,2,.000,56,118,.475,16,22,.727,31,57,88,16,16,18,9,44,128,1990/1991
"Mills,Terry",78,168,.464,0,2,.000,78,166,.470,31,44,.705,51,90,141,17,19,25,20,56,187,1990/1991
"Mitchell,Sam",445,1010,.441,0,9,.000,445,1001,.445,307,396,.775,188,332,520,133,66,104,57,338,1197,1990/1991
"Mokeski,Paul",21,59,.356,3,9,.333,18,50,.360,12,15,.800,20,47,67,9,8,7,3,58,57,1990/1991
"Moncrief,Sidney",117,240,.488,21,64,.328,96,176,.545,82,105,.781,31,97,128,104,50,66,9,112,337,1990/1991
"Morris,Chris",409,962,.425,45,179,.251,364,783,.465,179,244,.734,210,311,521,220,138,167,96,248,1042,1990/1991
"Morton,John",120,274,.438,4,12,.333,116,262,.443,113,139,.813,41,62,103,243,61,107,18,112,357,1990/1991
"Mullin,Chris",777,1449,.536,40,133,.301,737,1316,.560,513,580,.884,141,302,443,329,173,245,63,176,2107,1990/1991
"Munk,Chris",3,7,.429,0,0,,3,7,.429,7,12,.583,5,9,14,1,1,5,2,5,13,1990/1991
"Murphy,Tod",90,227,.396,1,17,.059,89,210,.424,70,105,.667,92,163,255,60,25,32,20,101,251,1990/1991
"Mustaf,Jerrod",106,228,.465,0,1,.000,106,227,.467,56,87,.644,51,118,169,36,15,61,14,109,268,1990/1991
"Myers,Pete",10,23,.435,0,1,.000,10,22,.455,9,11,.818,2,16,18,14,3,14,3,14,29,1990/1991
"Nance,Larry",635,1211,.524,2,8,.250,633,1203,.526,265,330,.803,201,485,686,237,66,131,200,219,1537,1990/1991
"Neal,Craig",14,35,.400,3,9,.333,11,26,.423,13,22,.591,2,14,16,37,4,19,0,26,44,1990/1991
"Nealy,Ed",45,97,.464,5,16,.313,40,81,.494,28,38,.737,44,107,151,36,24,19,4,46,123,1990/1991
"Newman,Johnny",478,1017,.470,30,84,.357,448,933,.480,385,476,.809,94,160,254,188,100,189,17,278,1371,1990/1991
"Norman,Ken",520,1037,.501,6,32,.188,514,1005,.511,173,275,.629,177,320,497,159,63,139,63,192,1219,1990/1991
"O'Sullivan,Dan",7,16,.438,0,0,,7,16,.438,7,11,.636,5,12,17,4,1,4,1,18,21,1990/1991
"Oakley,Charles",307,595,.516,0,2,.000,307,593,.518,239,305,.784,305,615,920,204,62,215,17,288,853,1990/1991
"Ogg,Alan",24,55,.436,0,2,.000,24,53,.453,6,10,.600,15,34,49,2,6,8,27,53,54,1990/1991
"Olajuwon,Hakeem",487,959,.508,0,4,.000,487,955,.510,213,277,.769,219,551,770,131,121,174,221,221,1187,1990/1991
"Oldham,Jawann",3,6,.500,0,0,,3,6,.500,0,0,,0,3,3,0,0,0,0,1,6,1990/1991
"Oliver,Brian",111,272,.408,5,18,.278,106,254,.417,52,71,.732,18,62,80,88,34,50,4,76,279,1990/1991
"Paddio,Gerald",212,506,.419,6,24,.250,206,482,.427,74,93,.796,38,80,118,90,20,71,6,71,504,1990/1991
"Palmer,Walter",15,45,.333,0,1,.000,15,44,.341,10,15,.667,6,15,21,6,3,6,4,20,40,1990/1991
"Parish,Robert",485,811,.598,0,1,.000,485,810,.599,237,309,.767,271,585,856,66,66,153,103,197,1207,1990/1991
"Paxson,John",317,578,.548,42,96,.438,275,482,.571,34,41,.829,15,76,91,297,62,69,3,136,710,1990/1991
"Payne,Kenny",68,189,.360,4,18,.222,64,171,.374,26,29,.897,17,49,66,16,10,21,6,43,166,1990/1991
"Payton,Gary",259,575,.450,1,13,.077,258,562,.459,69,97,.711,108,135,243,528,165,180,15,249,588,1990/1991
"Perdue,Will",116,235,.494,0,3,.000,116,232,.500,75,112,.670,122,214,336,47,23,75,57,147,307,1990/1991
"Perkins,Sam",368,744,.495,18,64,.281,350,680,.515,229,279,.821,167,371,538,108,64,103,78,247,983,1990/1991
"Perry,Tim",75,144,.521,0,5,.000,75,139,.540,43,70,.614,53,73,126,27,23,32,43,60,193,1990/1991
"Person,Chuck",620,1231,.504,69,203,.340,551,1028,.536,165,229,.721,121,296,417,238,56,184,17,221,1474,1990/1991
"Petersen,Jim",114,236,.483,1,4,.250,113,232,.487,50,76,.658,69,131,200,27,13,48,41,153,279,1990/1991
"Petrović,Dražen",243,493,.493,23,65,.354,220,428,.514,114,137,.832,51,59,110,86,43,81,1,132,623,1990/1991
"Petrović,Dražen",32,71,.451,1,6,.167,31,65,.477,15,22,.682,10,8,18,20,6,12,0,21,80,1990/1991
"Petrović,Dražen",211,422,.500,22,59,.373,189,363,.521,99,115,.861,41,51,92,66,37,69,1,111,543,1990/1991
"Pierce,Ricky",561,1156,.485,46,116,.397,515,1040,.495,430,471,.913,67,124,191,168,60,147,13,170,1598,1990/1991
"Pierce,Ricky",359,720,.499,37,93,.398,322,627,.514,282,311,.907,37,80,117,96,38,93,11,90,1037,1990/1991
"Pierce,Ricky",202,436,.463,9,23,.391,193,413,.467,148,160,.925,30,44,74,72,22,54,2,80,561,1990/1991
"Pinckney,Ed",131,243,.539,0,1,.000,131,242,.541,104,116,.897,155,186,341,45,61,45,43,147,366,1990/1991
"Pippen,Scottie",600,1153,.520,21,68,.309,579,1085,.534,240,340,.706,163,432,595,511,193,232,93,270,1461,1990/1991
"Polynice,Olden",316,564,.560,0,1,.000,316,563,.561,146,252,.579,220,333,553,42,43,88,32,192,778,1990/1991
"Polynice,Olden",165,303,.545,0,0,,165,303,.545,67,114,.588,114,156,270,16,26,53,19,94,397,1990/1991
"Polynice,Olden",151,261,.579,0,1,.000,151,260,.581,79,138,.572,106,177,283,26,17,35,13,98,381,1990/1991
"Popson,Dave",13,32,.406,0,0,,13,32,.406,9,10,.900,7,7,14,2,1,6,2,12,35,1990/1991
"Porter,Terry",486,944,.515,130,313,.415,356,631,.564,279,339,.823,52,230,282,649,158,189,12,151,1381,1990/1991
"Pressey,Paul",201,426,.472,16,57,.281,185,369,.501,110,133,.827,50,126,176,271,63,130,32,174,528,1990/1991
"Price,Mark",97,195,.497,18,53,.340,79,142,.556,59,62,.952,8,37,45,166,42,56,2,23,271,1990/1991
"Pritchard,Kevin",88,229,.384,5,31,.161,83,198,.419,62,77,.805,16,49,65,81,30,59,8,104,243,1990/1991
"Quinnett,Brian",139,303,.459,15,43,.349,124,260,.477,26,36,.722,65,80,145,53,22,52,13,100,319,1990/1991
"Rambis,Kurt",83,167,.497,0,2,.000,83,165,.503,60,85,.706,77,189,266,64,25,45,11,107,226,1990/1991
"Rasmussen,Blair",405,885,.458,2,5,.400,403,880,.458,63,93,.677,170,508,678,70,52,81,132,307,875,1990/1991
"Reid,J.R.",360,773,.466,0,2,.000,360,771,.467,182,259,.703,154,348,502,89,87,153,47,286,902,1990/1991
"Reid,Robert",2,14,.143,0,0,,2,14,.143,0,0,,2,7,9,4,1,3,3,3,4,1990/1991
"Reynolds,Jerry",344,793,.434,10,34,.294,334,759,.440,336,419,.802,88,211,299,203,95,172,56,123,1034,1990/1991
"Rice,Glen",550,1193,.461,71,184,.386,479,1009,.475,171,209,.818,85,296,381,189,101,166,26,216,1342,1990/1991
"Richardson,Pooh",635,1350,.470,42,128,.328,593,1222,.485,89,165,.539,82,204,286,734,131,174,13,114,1401,1990/1991
"Richmond,Mitch",703,1424,.494,40,115,.348,663,1309,.506,394,465,.847,147,305,452,238,126,230,34,207,1840,1990/1991
"Rivers,Doc",444,1020,.435,88,262,.336,356,758,.470,221,262,.844,47,206,253,340,148,125,47,216,1197,1990/1991
"Roberts,Fred",357,670,.533,4,25,.160,353,645,.547,170,209,.813,107,174,281,135,63,135,29,190,888,1990/1991
"Robertson,Alvin",438,904,.485,23,63,.365,415,841,.493,199,263,.757,191,268,459,444,246,212,16,273,1098,1990/1991
"Robinson,Clifford",373,806,.463,6,19,.316,367,787,.466,205,314,.653,123,226,349,151,78,133,76,263,957,1990/1991
"Robinson,David",754,1366,.552,1,7,.143,753,1359,.554,592,777,.762,335,728,1063,208,127,270,320,264,2101,1990/1991
"Robinson,Larry",62,150,.413,0,1,.000,62,149,.416,15,27,.556,29,22,51,35,16,27,1,49,139,1990/1991
"Robinson,Larry",24,59,.407,0,0,,24,59,.407,8,15,.533,15,8,23,11,9,16,1,23,56,1990/1991
"Robinson,Larry",38,91,.418,0,1,.000,38,90,.422,7,12,.583,14,14,28,24,7,11,0,26,83,1990/1991
"Robinson,Rumeal",108,242,.446,2,11,.182,106,231,.459,47,80,.588,20,51,71,132,32,76,8,65,265,1990/1991
"Rodman,Dennis",276,560,.493,6,30,.200,270,530,.509,111,176,.631,361,665,1026,85,65,94,55,281,669,1990/1991
"Rollins,Tree",14,33,.424,0,0,,14,33,.424,8,14,.571,13,29,42,4,2,15,20,35,36,1990/1991
"Rudd,Delaney",124,285,.435,17,61,.279,107,224,.478,59,71,.831,14,52,66,216,36,102,2,92,324,1990/1991
"Salley,John",179,377,.475,0,1,.000,179,376,.476,186,256,.727,137,190,327,70,52,91,112,240,544,1990/1991
"Sampson,Ralph",34,93,.366,1,5,.200,33,88,.375,5,19,.263,41,70,111,17,11,27,17,54,74,1990/1991
"Sanders,Jeff",6,14,.429,0,0,,6,14,.429,1,2,.500,3,6,9,1,1,1,1,6,13,1990/1991
"Sanders,Mike",206,494,.417,4,20,.200,202,474,.426,47,57,.825,73,112,185,106,37,65,26,198,463,1990/1991
"Schayes,Danny",298,597,.499,0,5,.000,298,592,.503,274,328,.835,174,361,535,98,55,106,61,264,870,1990/1991
"Scheffler,Steve",20,39,.513,0,0,,20,39,.513,19,21,.905,21,24,45,9,6,4,2,20,59,1990/1991
"Schintzius,Dwayne",68,155,.439,0,2,.000,68,153,.444,22,40,.550,28,93,121,17,2,34,29,64,158,1990/1991
"Schrempf,Detlef",432,831,.520,15,40,.375,417,791,.527,441,539,.818,178,482,660,301,58,175,22,262,1320,1990/1991
"Scott,Byron",501,1051,.477,71,219,.324,430,832,.517,118,148,.797,54,192,246,177,95,85,21,146,1191,1990/1991
"Scott,Dennis",503,1183,.425,125,334,.374,378,849,.445,153,204,.750,62,173,235,134,62,127,25,203,1284,1990/1991
"Seikaly,Rony",395,822,.481,2,6,.333,393,816,.482,258,417,.619,207,502,709,95,51,205,86,213,1050,1990/1991
"Shasky,John",51,116,.440,0,0,,51,116,.440,48,79,.608,58,76,134,11,14,27,20,75,150,1990/1991
"Shaw,Brian",442,942,.469,3,27,.111,439,915,.480,204,249,.819,104,266,370,602,105,223,34,206,1091,1990/1991
"Sikma,Jack",295,691,.427,46,135,.341,249,556,.448,166,197,.843,108,333,441,143,65,130,64,218,802,1990/1991
"Simmons,Lionel",549,1301,.422,3,11,.273,546,1290,.423,320,435,.736,193,504,697,315,113,230,85,249,1421,1990/1991
"Skiles,Scott",462,1039,.445,93,228,.408,369,811,.455,340,377,.902,57,213,270,660,89,252,4,192,1357,1990/1991
"Smith,Charles",548,1168,.469,0,7,.000,548,1161,.472,384,484,.793,216,392,608,134,81,165,145,267,1480,1990/1991
"Smith,Charles",3,7,.429,0,0,,3,7,.429,3,5,.600,0,2,2,6,1,3,0,7,9,1990/1991
"Smith,Clinton",2,4,.500,0,0,,2,4,.500,3,6,.500,2,2,4,4,1,1,0,3,7,1990/1991
"Smith,Derek",1,4,.250,0,1,.000,1,3,.333,3,4,.750,0,0,0,5,1,1,1,3,5,1990/1991
"Smith,Kenny",522,1003,.520,49,135,.363,473,868,.545,287,340,.844,36,127,163,554,106,237,11,131,1380,1990/1991
"Smith,Larry",128,263,.487,0,0,,128,263,.487,12,50,.240,302,407,709,88,83,93,22,265,268,1990/1991
"Smith,Michael",95,200,.475,6,24,.250,89,176,.506,22,27,.815,21,35,56,43,6,37,2,27,218,1990/1991
"Smith,Otis",407,902,.451,9,46,.196,398,856,.465,221,301,.734,176,213,389,169,85,140,35,190,1044,1990/1991
"Smith,Tony",97,220,.441,0,7,.000,97,213,.455,40,57,.702,24,47,71,135,28,69,12,80,234,1990/1991
"Smits,Rik",342,705,.485,0,0,,342,705,.485,144,189,.762,116,241,357,84,24,86,111,246,828,1990/1991
"Smrek,Mike",9,27,.333,0,0,,9,27,.333,6,12,.500,7,19,26,4,3,3,3,27,24,1990/1991
"Smrek,Mike",6,11,.545,0,0,,6,11,.545,2,4,.500,3,4,7,1,2,2,0,9,14,1990/1991
"Smrek,Mike",3,16,.188,0,0,,3,16,.188,4,8,.500,4,15,19,3,1,1,3,18,10,1990/1991
"Sparrow,Rory",371,756,.491,31,78,.397,340,678,.501,58,83,.699,45,141,186,362,83,126,16,189,831,1990/1991
"Spencer,Felton",195,381,.512,0,1,.000,195,380,.513,182,252,.722,272,369,641,25,48,77,121,337,572,1990/1991
"Starks,John",180,410,.439,27,93,.290,153,317,.483,79,105,.752,30,101,131,204,59,74,17,137,466,1990/1991
"Stephens,Everette",2,3,.667,0,0,,2,3,.667,2,2,1.000,0,0,0,2,0,0,0,0,6,1990/1991
"Stockton,John",496,978,.507,58,168,.345,438,810,.541,363,434,.836,46,191,237,1164,234,298,16,233,1413,1990/1991
"Strickland,Rod",314,651,.482,11,33,.333,303,618,.490,161,211,.763,57,162,219,463,117,156,11,125,800,1990/1991
"Sundvold,Jon",43,107,.402,15,35,.429,28,72,.389,11,11,1.000,3,6,9,24,7,16,0,11,112,1990/1991
"Tarpley,Roy",43,79,.544,0,1,.000,43,78,.551,16,18,.889,16,39,55,12,6,13,9,20,102,1990/1991
"Teagle,Terry",335,757,.443,0,9,.000,335,748,.448,145,177,.819,82,99,181,82,31,83,8,165,815,1990/1991
"Theus,Reggie",583,1247,.468,52,144,.361,531,1103,.481,292,343,.851,69,160,229,378,85,252,35,231,1510,1990/1991
"Thomas,Irving",17,50,.340,0,0,,17,50,.340,12,21,.571,14,17,31,10,4,13,1,24,46,1990/1991
"Thomas,Isiah",289,665,.435,19,65,.292,270,600,.450,179,229,.782,35,125,160,446,75,185,10,118,776,1990/1991
"Thomas,Jim",1,4,.250,0,0,,1,4,.250,0,0,,0,0,0,1,1,1,0,0,2,1990/1991
"Thompson,Billy",205,411,.499,0,4,.000,205,407,.504,89,124,.718,120,192,312,111,32,117,48,161,499,1990/1991
"Thompson,LaSalle",276,565,.488,1,5,.200,275,560,.491,72,104,.692,154,409,563,147,63,168,63,265,625,1990/1991
"Thompson,Mychal",113,228,.496,0,2,.000,113,226,.500,62,88,.705,74,154,228,21,23,47,23,112,288,1990/1991
"Thornton,Bob",4,13,.308,0,0,,4,13,.308,8,10,.800,1,14,15,1,0,9,3,18,16,1990/1991
"Thorpe,Otis",549,988,.556,3,7,.429,546,981,.557,334,480,.696,287,559,846,197,73,217,20,278,1435,1990/1991
"Threatt,Sedale",433,835,.519,10,35,.286,423,800,.529,137,173,.792,25,74,99,273,113,138,8,191,1013,1990/1991
"Tisdale,Wayman",262,542,.483,0,1,.000,262,541,.484,136,170,.800,75,178,253,66,23,82,28,99,660,1990/1991
"Tolbert,Tom",183,433,.423,7,21,.333,176,412,.427,127,172,.738,87,188,275,76,35,80,38,195,500,1990/1991
"Toolson,Andy",50,124,.403,12,32,.375,38,92,.413,25,33,.758,32,35,67,31,14,24,2,58,137,1990/1991
"Tripucka,Kelly",187,412,.454,15,45,.333,172,367,.469,152,167,.910,46,130,176,159,33,92,13,130,541,1990/1991
"Tucker,Trent",191,434,.440,64,153,.418,127,281,.452,17,27,.630,33,72,105,111,44,46,9,120,463,1990/1991
"Turner,Andre",168,383,.439,12,33,.364,156,350,.446,64,87,.736,36,116,152,311,63,95,0,124,412,1990/1991
"Turner,Jeff",259,532,.487,6,15,.400,253,517,.489,85,112,.759,108,255,363,97,29,126,10,234,609,1990/1991
"Upshaw,Kelvin",104,231,.450,7,29,.241,97,202,.480,55,64,.859,20,35,55,86,28,39,5,77,270,1990/1991
"Valentine,Darnell",230,496,.464,6,25,.240,224,471,.476,143,172,.831,37,135,172,351,98,126,12,170,609,1990/1991
"Vandeweghe,Kiki",458,927,.494,51,141,.362,407,786,.518,259,288,.899,78,102,180,110,42,108,10,122,1226,1990/1991
"Vaught,Loy",175,359,.487,0,2,.000,175,357,.490,49,74,.662,124,225,349,40,20,49,23,135,399,1990/1991
"Vincent,Sam",152,353,.431,3,19,.158,149,334,.446,99,120,.825,17,90,107,197,30,91,5,74,406,1990/1991
"Vranković,Stojko",24,52,.462,0,0,,24,52,.462,10,18,.556,15,36,51,4,1,24,29,43,58,1990/1991
"Wagner,Milt",24,57,.421,6,17,.353,18,40,.450,9,11,.818,0,7,7,15,2,12,3,14,63,1990/1991
"Walker,Darrell",230,535,.430,0,9,.000,230,526,.437,93,154,.604,140,358,498,459,78,154,33,199,553,1990/1991
"Walker,Kenny",83,191,.435,0,1,.000,83,190,.437,64,82,.780,63,94,157,13,18,30,30,92,230,1990/1991
"Webb,Spud",359,803,.447,54,168,.321,305,635,.480,231,266,.868,41,133,174,417,118,146,6,180,1003,1990/1991
"Wennington,Bill",181,415,.436,1,5,.200,180,410,.439,74,94,.787,101,239,340,69,46,51,59,230,437,1990/1991
"West,Doug",118,246,.480,0,1,.000,118,245,.482,58,84,.690,56,80,136,48,35,41,23,115,294,1990/1991
"West,Mark",247,382,.647,0,0,,247,382,.647,135,206,.655,171,393,564,37,32,86,161,266,629,1990/1991
"White,Randy",265,665,.398,6,37,.162,259,628,.412,159,225,.707,173,331,504,63,81,131,44,308,695,1990/1991
"Wiley,Morlon",45,108,.417,6,12,.500,39,96,.406,17,25,.680,4,13,17,73,24,34,0,37,113,1990/1991
"Wilkins,Dominique",770,1640,.470,85,249,.341,685,1391,.492,476,574,.829,261,471,732,265,123,201,65,156,2101,1990/1991
"Wilkins,Eddie Lee",114,255,.447,0,1,.000,114,254,.449,51,90,.567,69,111,180,15,17,50,7,91,279,1990/1991
"Wilkins,Gerald",380,804,.473,9,43,.209,371,761,.488,169,206,.820,78,129,207,275,82,161,23,181,938,1990/1991
"Williams,Buck",358,595,.602,0,0,,358,595,.602,217,308,.705,227,524,751,97,47,137,47,247,933,1990/1991
"Williams,Herb",332,655,.507,0,4,.000,332,651,.510,83,130,.638,86,271,357,95,30,113,88,197,747,1990/1991
"Williams,Hot Rod",199,430,.463,0,1,.000,199,429,.464,107,164,.652,111,179,290,100,36,63,69,126,505,1990/1991
"Williams,Jayson",72,161,.447,1,2,.500,71,159,.447,37,56,.661,41,70,111,16,9,40,6,92,182,1990/1991
"Williams,John",164,393,.417,10,41,.244,154,352,.438,73,97,.753,42,135,177,133,39,68,6,63,411,1990/1991
"Williams,Kenny",93,179,.520,0,3,.000,93,176,.528,34,50,.680,56,75,131,31,11,41,31,81,220,1990/1991
"Williams,Micheal",261,523,.499,1,7,.143,260,516,.504,290,330,.879,49,127,176,348,150,150,17,202,813,1990/1991
"Williams,Reggie",384,855,.449,57,157,.363,327,698,.468,166,197,.843,133,173,306,133,113,112,41,253,991,1990/1991
"Williams,Reggie",61,127,.480,14,26,.538,47,101,.465,35,41,.854,17,42,59,46,20,36,11,64,171,1990/1991
"Williams,Reggie",323,728,.444,43,131,.328,280,597,.469,131,156,.840,116,131,247,87,93,76,30,189,820,1990/1991
"Williams,Scott",53,104,.510,1,2,.500,52,102,.510,20,28,.714,42,56,98,16,12,23,13,51,127,1990/1991
"Willis,Kevin",444,881,.504,4,10,.400,440,871,.505,159,238,.668,259,445,704,99,60,153,40,235,1051,1990/1991
"Wilson,Trevor",21,70,.300,0,2,.000,21,68,.309,13,26,.500,16,24,40,11,5,17,1,13,55,1990/1991
"Winchester,Kennard",98,245,.400,8,20,.400,90,225,.400,35,45,.778,34,33,67,25,16,30,13,70,239,1990/1991
"Wingate,David",53,138,.384,1,9,.111,52,129,.403,29,41,.707,24,51,75,46,19,42,5,66,136,1990/1991
"Wittman,Randy",35,79,.443,0,5,.000,35,74,.473,4,6,.667,6,27,33,25,10,10,4,9,74,1990/1991
"Wolf,Joe",234,519,.451,2,15,.133,232,504,.460,69,83,.831,136,264,400,107,60,95,31,244,539,1990/1991
"Wood,David",148,349,.424,28,90,.311,120,259,.463,108,133,.812,107,139,246,94,58,89,16,236,432,1990/1991
"Wood,Leon",25,63,.397,12,38,.316,13,25,.520,19,21,.905,5,14,19,49,5,12,0,10,81,1990/1991
"Woodson,Mike",26,77,.338,1,7,.143,25,70,.357,11,13,.846,3,10,13,15,5,12,5,18,64,1990/1991
"Woodson,Mike",21,54,.389,1,6,.167,20,48,.417,10,12,.833,2,9,11,10,5,7,4,11,53,1990/1991
"Woodson,Mike",5,23,.217,0,1,.000,5,22,.227,1,1,1.000,1,1,2,5,0,5,1,7,11,1990/1991
"Woolridge,Orlando",490,983,.498,0,4,.000,490,979,.501,350,439,.797,141,220,361,119,69,152,23,145,1330,1990/1991
"Workman,Haywoode",234,515,.454,12,50,.240,222,465,.477,101,133,.759,51,191,242,353,87,135,7,162,581,1990/1991
"Worthy,James",716,1455,.492,26,90,.289,690,1365,.505,212,266,.797,107,249,356,275,104,127,35,117,1670,1990/1991
"Wright,Howard",19,47,.404,0,1,.000,19,46,.413,16,24,.667,12,33,45,3,4,11,5,28,54,1990/1991
"Wright,Howard",2,3,.667,0,0,,2,3,.667,1,1,1.000,1,5,6,0,0,2,0,3,5,1990/1991
"Wright,Howard",15,41,.366,0,0,,15,41,.366,13,21,.619,10,27,37,3,3,9,5,23,43,1990/1991
"Wright,Howard",2,3,.667,0,1,.000,2,2,1.000,2,2,1.000,1,1,2,0,1,0,0,2,6,1990/1991
"Wynder,A.J.",3,12,.250,0,1,.000,3,11,.273,6,8,.750,1,2,3,8,1,4,0,1,12,1990/1991
"Young,Danny",103,271,.380,36,104,.346,67,167,.401,41,45,.911,22,53,75,141,50,50,7,49,283,1990/1991
"Abdelnaby,Alaa",178,361,.493,0,0,,178,361,.493,76,101,.752,81,179,260,30,25,66,16,132,432,1991/1992
"Abdul-Rauf,Mahmoud",356,845,.421,31,94,.330,325,751,.433,94,108,.870,22,92,114,192,44,117,4,130,837,1991/1992
"Acres,Mark",78,151,.517,1,3,.333,77,148,.520,51,67,.761,97,155,252,22,25,33,15,140,208,1991/1992
"Adams,Michael",485,1233,.393,125,386,.324,360,847,.425,313,360,.869,58,252,310,594,145,212,9,162,1408,1991/1992
"Addison,Rafael",187,432,.433,14,49,.286,173,383,.452,56,76,.737,65,100,165,68,28,46,28,109,444,1991/1992
"Aguirre,Mark",339,787,.431,15,71,.211,324,716,.453,158,230,.687,67,169,236,126,51,105,11,171,851,1991/1992
"Ainge,Danny",299,676,.442,78,230,.339,221,446,.496,108,131,.824,40,108,148,202,73,70,13,148,784,1991/1992
"Alexander,Victor",243,459,.529,0,1,.000,243,458,.531,103,149,.691,106,230,336,32,45,91,62,176,589,1991/1992
"Anderson,Greg",389,854,.456,0,4,.000,389,850,.458,167,268,.623,337,604,941,78,88,201,65,263,945,1991/1992
"Anderson,Kenny",187,480,.390,3,13,.231,184,467,.394,73,98,.745,38,89,127,203,67,97,9,68,450,1991/1992
"Anderson,Nick",482,1042,.463,30,85,.353,452,957,.472,202,303,.667,98,286,384,163,97,126,33,132,1196,1991/1992
"Anderson,Ron",469,1008,.465,42,127,.331,427,881,.485,143,163,.877,96,182,278,135,86,109,11,128,1123,1991/1992
"Anderson,Willie",312,685,.455,13,56,.232,299,629,.475,107,138,.775,62,238,300,302,54,140,51,151,744,1991/1992
"Ansley,Michael",8,18,.444,0,0,,8,18,.444,5,6,.833,2,4,6,2,0,3,0,7,21,1991/1992
"Ansley,Michael",5,11,.455,0,0,,5,11,.455,5,6,.833,2,2,4,2,0,3,0,6,15,1991/1992
"Ansley,Michael",3,7,.429,0,0,,3,7,.429,0,0,,0,2,2,0,0,0,0,1,6,1991/1992
"Anthony,Greg",161,435,.370,8,55,.145,153,380,.403,117,158,.741,33,103,136,314,59,98,9,170,447,1991/1992
"Armstrong,B.J.",335,697,.481,35,87,.402,300,610,.492,104,129,.806,19,126,145,266,46,94,5,88,809,1991/1992
"Askew,Vincent",193,379,.509,1,10,.100,192,369,.520,111,160,.694,89,144,233,188,47,84,23,128,498,1991/1992
"Askins,Keith",84,205,.410,25,73,.342,59,132,.447,26,37,.703,65,77,142,38,40,47,15,109,219,1991/1992
"Augmon,Stacey",440,899,.489,1,6,.167,439,893,.492,213,320,.666,191,229,420,201,124,181,27,161,1094,1991/1992
"Austin,Isaac",21,46,.457,0,0,,21,46,.457,19,30,.633,11,24,35,5,2,8,2,20,61,1991/1992
"Babić,Miloš",6,13,.462,0,0,,6,13,.462,6,8,.750,2,9,11,6,1,5,0,0,18,1991/1992
"Bagley,John",223,506,.441,10,42,.238,213,464,.459,68,95,.716,38,123,161,480,57,148,4,123,524,1991/1992
"Bailey,Thurl",368,836,.440,0,2,.000,368,834,.441,215,270,.796,122,363,485,78,35,108,117,160,951,1991/1992
"Bailey,Thurl",39,101,.386,0,1,.000,39,100,.390,44,55,.800,23,55,78,19,5,21,15,31,122,1991/1992
"Bailey,Thurl",329,735,.448,0,1,.000,329,734,.448,171,215,.795,99,308,407,59,30,87,102,129,829,1991/1992
"Bardo,Steve",0,0,,0,0,,0,0,,0,0,,1,0,1,0,0,0,0,0,0,1991/1992
"Barkley,Charles",622,1126,.552,32,137,.234,590,989,.597,454,653,.695,271,559,830,308,136,235,44,196,1730,1991/1992
"Barros,Dana",238,493,.483,83,186,.446,155,307,.505,60,79,.759,17,64,81,125,51,56,4,84,619,1991/1992
"Battle,John",316,659,.480,2,17,.118,314,642,.489,145,171,.848,19,93,112,159,36,91,5,116,779,1991/1992
"Battle,Kenny",11,17,.647,0,1,.000,11,16,.688,10,12,.833,4,12,16,4,2,4,2,10,32,1991/1992
"Battle,Kenny",3,4,.750,0,0,,3,4,.750,8,8,1.000,3,6,9,0,1,2,0,4,14,1991/1992
"Battle,Kenny",8,13,.615,0,1,.000,8,12,.667,2,4,.500,1,6,7,4,1,2,2,6,18,1991/1992
"Bedford,William",50,121,.413,0,1,.000,50,120,.417,14,22,.636,24,39,63,12,6,15,18,56,114,1991/1992
"Benjamin,Benoit",354,740,.478,0,2,.000,354,738,.480,171,249,.687,130,383,513,76,39,175,118,185,879,1991/1992
"Bennett,Winston",80,211,.379,0,1,.000,80,210,.381,35,50,.700,63,99,162,38,19,33,9,122,195,1991/1992
"Bennett,Winston",79,209,.378,0,1,.000,79,208,.380,35,50,.700,62,99,161,38,19,33,9,121,193,1991/1992
"Bennett,Winston",1,2,.500,0,0,,1,2,.500,0,0,,1,0,1,0,0,0,0,1,2,1991/1992
"Benoit,David",175,375,.467,3,14,.214,172,361,.476,81,100,.810,105,191,296,34,19,71,44,124,434,1991/1992
"Bird,Larry",353,758,.466,52,128,.406,301,630,.478,150,162,.926,46,388,434,306,42,125,33,82,908,1991/1992
"Blackman,Rolando",535,1161,.461,65,169,.385,470,992,.474,239,266,.898,78,161,239,204,50,153,22,134,1374,1991/1992
"Blanks,Lance",25,55,.455,6,16,.375,19,39,.487,8,11,.727,9,13,22,19,14,14,1,26,64,1991/1992
"Blaylock,Mookie",429,993,.432,12,54,.222,417,939,.444,126,177,.712,101,168,269,492,170,152,40,182,996,1991/1992
"Bogues,Muggsy",317,671,.472,2,27,.074,315,644,.489,94,120,.783,58,177,235,743,170,156,6,156,730,1991/1992
"Bol,Manute",49,128,.383,0,9,.000,49,119,.412,12,26,.462,54,168,222,22,11,41,205,139,110,1991/1992
"Bonner,Anthony",294,658,.447,1,4,.250,293,654,.448,151,241,.627,192,293,485,125,94,133,26,194,740,1991/1992
"Bowie,Anthony",312,633,.493,17,44,.386,295,589,.501,117,136,.860,70,175,245,163,55,107,38,101,758,1991/1992
"Bowie,Sam",421,947,.445,8,25,.320,413,922,.448,212,280,.757,203,375,578,186,41,150,120,212,1062,1991/1992
"Brandon,Terrell",252,601,.419,1,23,.043,251,578,.434,100,124,.806,49,113,162,316,81,136,22,107,605,1991/1992
"Breuer,Randy",161,344,.468,0,1,.000,161,343,.469,41,77,.532,98,183,281,89,27,41,99,117,363,1991/1992
"Brickowski,Frank",306,584,.524,3,6,.500,303,578,.524,125,163,.767,97,247,344,122,60,112,23,223,740,1991/1992
"Brooks,Kevin",43,97,.443,2,11,.182,41,86,.477,17,21,.810,13,26,39,11,8,18,2,19,105,1991/1992
"Brooks,Scott",167,374,.447,32,90,.356,135,284,.475,51,63,.810,27,72,99,205,66,51,7,82,417,1991/1992
"Brown,Chucky",60,128,.469,0,3,.000,60,125,.480,30,49,.612,31,51,82,26,12,29,7,48,150,1991/1992
"Brown,Chucky",5,10,.500,0,0,,5,10,.500,5,8,.625,2,4,6,3,3,2,0,7,15,1991/1992
"Brown,Chucky",55,118,.466,0,3,.000,55,115,.478,25,41,.610,29,47,76,23,9,27,7,41,135,1991/1992
"Brown,Dee",149,350,.426,5,22,.227,144,328,.439,60,78,.769,15,64,79,164,33,59,7,74,363,1991/1992
"Brown,Mike",221,488,.453,0,1,.000,221,487,.454,190,285,.667,187,289,476,81,42,105,34,196,632,1991/1992
"Brown,Myron",4,6,.667,1,3,.333,3,3,1.000,0,0,,0,3,3,6,1,4,0,2,9,1991/1992
"Brown,Randy",77,169,.456,0,6,.000,77,163,.472,38,58,.655,26,43,69,59,35,42,12,68,192,1991/1992
"Brown,Tony",102,249,.410,19,63,.302,83,186,.446,48,66,.727,32,52,84,48,30,35,5,82,271,1991/1992
"Brown,Tony",39,89,.438,7,22,.318,32,67,.478,18,29,.621,9,19,28,16,12,14,1,31,103,1991/1992
"Brown,Tony",63,160,.394,12,41,.293,51,119,.429,30,37,.811,23,33,56,32,18,21,4,51,168,1991/1992
"Bryant,Mark",95,198,.480,0,3,.000,95,195,.487,40,60,.667,87,114,201,41,26,30,8,105,230,1991/1992
"Buechler,Jud",29,71,.408,0,1,.000,29,70,.414,12,21,.571,18,34,52,23,19,13,7,31,70,1991/1992
"Buechler,Jud",4,8,.500,0,0,,4,8,.500,0,0,,2,0,2,2,2,1,1,2,8,1991/1992
"Buechler,Jud",15,30,.500,0,0,,15,30,.500,3,9,.333,6,16,22,11,8,5,3,18,33,1991/1992
"Buechler,Jud",10,33,.303,0,1,.000,10,32,.313,9,12,.750,10,18,28,10,9,7,3,11,29,1991/1992
"Bullard,Matt",205,447,.459,64,166,.386,141,281,.502,38,50,.760,73,150,223,75,26,56,21,129,512,1991/1992
"Burton,Willie",280,622,.450,6,15,.400,274,607,.451,196,245,.800,76,168,244,123,46,119,37,186,762,1991/1992
"Burtt,Steve",74,160,.463,1,6,.167,73,154,.474,38,54,.704,10,24,34,59,16,33,4,58,187,1991/1992
"Cage,Michael",307,542,.566,0,5,.000,307,537,.572,106,171,.620,266,462,728,92,99,78,55,237,720,1991/1992
"Calip,Demetrius",4,18,.222,1,5,.200,3,13,.231,2,3,.667,1,4,5,12,1,5,0,8,11,1991/1992
"Campbell,Elden",220,491,.448,0,2,.000,220,489,.450,138,223,.619,155,268,423,59,53,73,159,203,578,1991/1992
"Campbell,Tony",527,1137,.464,13,37,.351,514,1100,.467,240,299,.803,141,145,286,229,84,165,31,206,1307,1991/1992
"Carr,Antoine",359,732,.490,1,5,.200,358,727,.492,162,212,.764,128,218,346,63,32,114,96,264,881,1991/1992
"Cartwright,Bill",208,445,.467,0,0,,208,445,.467,96,159,.604,93,231,324,87,22,75,14,131,512,1991/1992
"Catledge,Terry",457,922,.496,0,4,.000,457,918,.498,240,346,.694,257,292,549,109,58,138,16,196,1154,1991/1992
"Causwell,Duane",250,455,.549,0,1,.000,250,454,.551,136,222,.613,196,384,580,59,47,124,215,281,636,1991/1992
"Ceballos,Cedric",176,365,.482,1,6,.167,175,359,.487,109,148,.736,60,92,152,50,16,71,11,52,462,1991/1992
"Chambers,Tom",426,989,.431,18,49,.367,408,940,.434,258,311,.830,86,315,401,142,57,103,37,196,1128,1991/1992
"Chapman,Rex",113,252,.448,8,29,.276,105,223,.471,36,53,.679,10,48,58,89,15,45,8,51,270,1991/1992
"Chapman,Rex",108,240,.450,8,27,.296,100,213,.469,36,53,.679,9,45,54,86,14,42,8,47,260,1991/1992
"Chapman,Rex",5,12,.417,0,2,.000,5,10,.500,0,0,,1,3,4,3,1,3,0,4,10,1991/1992
"Cheeks,Maurice",115,249,.462,3,6,.500,112,243,.461,26,43,.605,29,66,95,185,83,36,0,73,259,1991/1992
"Chilcutt,Pete",113,250,.452,2,2,1.000,111,248,.448,23,28,.821,78,109,187,38,32,41,17,70,251,1991/1992
"Coleman,Derrick",483,958,.504,23,76,.303,460,882,.522,300,393,.763,203,415,618,205,54,248,98,168,1289,1991/1992
"Coles,Bimbo",295,649,.455,10,52,.192,285,597,.477,216,262,.824,69,120,189,366,73,167,13,151,816,1991/1992
"Conlon,Marty",48,101,.475,0,0,,48,101,.475,24,32,.750,33,36,69,12,9,27,7,40,120,1991/1992
"Conner,Lester",103,239,.431,0,7,.000,103,232,.444,81,115,.704,63,121,184,294,97,79,10,86,287,1991/1992
"Cook,Anthony",15,25,.600,0,0,,15,25,.600,4,6,.667,13,21,34,2,5,3,4,10,34,1991/1992
"Cooper,Wayne",35,82,.427,0,0,,35,82,.427,7,11,.636,38,63,101,21,4,15,27,57,77,1991/1992
"Copa,Tom",22,40,.550,0,0,,22,40,.550,4,13,.308,14,22,36,3,2,8,6,29,48,1991/1992
"Copeland,Lanard",7,23,.304,0,2,.000,7,21,.333,2,2,1.000,1,6,7,5,2,4,0,5,16,1991/1992
"Corbin,Tyrone",303,630,.481,0,4,.000,303,626,.484,174,201,.866,163,309,472,140,82,97,20,193,780,1991/1992
"Corbin,Tyrone",57,142,.401,0,1,.000,57,141,.404,44,53,.830,24,45,69,33,12,26,6,31,158,1991/1992
"Corbin,Tyrone",246,488,.504,0,3,.000,246,485,.507,130,148,.878,139,264,403,107,70,71,14,162,622,1991/1992
"Corchiani,Chris",77,193,.399,10,37,.270,67,156,.429,91,104,.875,18,60,78,141,45,74,2,94,255,1991/1992
"Crowder,Corey",43,112,.384,13,30,.433,30,82,.366,15,18,.833,16,25,41,17,7,13,2,35,114,1991/1992
"Cummings,Terry",514,1053,.488,5,13,.385,509,1040,.489,177,249,.711,247,384,631,102,58,115,34,210,1210,1991/1992
"Curry,Dell",504,1038,.486,74,183,.404,430,855,.503,127,152,.836,57,202,259,177,93,134,20,156,1209,1991/1992
"Dailey,Quintin",9,37,.243,0,1,.000,9,36,.250,13,16,.813,2,10,12,4,5,10,1,6,31,1991/1992
"Daugherty,Brad",576,1010,.570,0,2,.000,576,1008,.571,414,533,.777,191,569,760,262,65,185,78,190,1566,1991/1992
"Davis,Brad",38,86,.442,5,18,.278,33,68,.485,11,15,.733,4,29,33,66,11,27,3,57,92,1991/1992
"Davis,Dale",154,279,.552,0,1,.000,154,278,.554,87,152,.572,158,252,410,30,27,49,74,191,395,1991/1992
"Davis,Terry",256,531,.482,0,5,.000,256,526,.487,181,285,.635,228,444,672,57,26,117,29,202,693,1991/1992
"Davis,Walter",185,403,.459,5,16,.313,180,387,.465,82,94,.872,20,50,70,68,29,45,1,69,457,1991/1992
"Dawkins,Johnny",394,902,.437,36,101,.356,358,801,.447,164,186,.882,42,185,227,567,89,183,5,158,988,1991/1992
"Dele,Bison",171,324,.528,0,0,,171,324,.528,95,142,.669,115,157,272,33,41,86,53,139,437,1991/1992
"Divac,Vlade",157,317,.495,5,19,.263,152,298,.510,86,112,.768,87,160,247,60,55,88,35,114,405,1991/1992
"Donaldson,James",112,245,.457,0,0,,112,245,.457,61,86,.709,99,190,289,33,8,48,49,103,285,1991/1992
"Donaldson,James",107,227,.471,0,0,,107,227,.471,59,84,.702,97,173,270,31,8,41,44,86,273,1991/1992
"Donaldson,James",5,18,.278,0,0,,5,18,.278,2,2,1.000,2,17,19,2,0,7,5,17,12,1991/1992
"Douglas,Sherman",117,253,.462,1,10,.100,116,243,.477,73,107,.682,13,50,63,172,25,68,9,78,308,1991/1992
"Douglas,Sherman",16,31,.516,0,1,.000,16,30,.533,5,7,.714,1,5,6,19,4,8,0,10,37,1991/1992
"Douglas,Sherman",101,222,.455,1,9,.111,100,213,.469,68,100,.680,12,45,57,153,21,60,9,68,271,1991/1992
"Dreiling,Greg",43,87,.494,1,1,1.000,42,86,.488,30,40,.750,22,74,96,25,10,31,16,123,117,1991/1992
"Drexler,Clyde",694,1476,.470,114,338,.337,580,1138,.510,401,505,.794,166,334,500,512,138,240,70,229,1903,1991/1992
"Duckworth,Kevin",362,786,.461,0,3,.000,362,783,.462,156,226,.690,151,346,497,99,38,143,37,264,880,1991/1992
"Dudley,Chris",190,472,.403,0,0,,190,472,.403,80,171,.468,343,396,739,58,38,79,179,275,460,1991/1992
"Dumars,Joe",587,1311,.448,49,120,.408,538,1191,.452,412,475,.867,82,106,188,375,71,193,12,145,1635,1991/1992
"Eackles,Ledell",355,759,.468,7,35,.200,348,724,.481,139,187,.743,39,139,178,125,47,75,7,145,856,1991/1992
"Eaton,Mark",107,240,.446,0,0,,107,240,.446,52,87,.598,150,341,491,40,36,60,205,239,266,1991/1992
"Eddie,Patrick",2,9,.222,0,0,,2,9,.222,0,0,,0,1,1,0,0,0,0,3,4,1991/1992
"Edwards,Blue",433,830,.522,39,103,.379,394,727,.542,113,146,.774,86,212,298,137,81,122,46,236,1018,1991/1992
"Edwards,James",250,538,.465,0,1,.000,250,537,.466,198,271,.731,55,147,202,53,24,72,33,236,698,1991/1992
"Edwards,Kevin",325,716,.454,7,32,.219,318,684,.465,162,191,.848,56,155,211,170,99,120,20,138,819,1991/1992
"Ehlo,Craig",310,684,.453,69,167,.413,241,517,.466,87,123,.707,94,213,307,238,78,104,22,150,776,1991/1992
"Elie,Mario",221,424,.521,23,70,.329,198,354,.559,155,182,.852,69,158,227,174,68,83,15,159,620,1991/1992
"Elliott,Sean",514,1040,.494,25,82,.305,489,958,.510,285,331,.861,143,296,439,214,84,152,29,149,1338,1991/1992
"Ellis,Dale",485,1034,.469,138,329,.419,347,705,.492,164,212,.774,92,161,253,104,57,119,18,151,1272,1991/1992
"Ellis,LeRon",17,50,.340,0,0,,17,50,.340,9,19,.474,12,12,24,1,6,11,9,11,43,1991/1992
"Ellison,Pervis",547,1014,.539,1,3,.333,546,1011,.540,227,312,.728,217,523,740,190,62,196,177,222,1322,1991/1992
"English,A.J.",366,846,.433,6,34,.176,360,812,.443,148,176,.841,74,94,168,143,32,89,9,160,886,1991/1992
"Ewing,Patrick",796,1525,.522,1,6,.167,795,1519,.523,377,511,.738,228,693,921,156,88,209,245,277,1970,1991/1992
"Feitl,Dave",33,77,.429,0,0,,33,77,.429,16,19,.842,21,40,61,6,2,19,3,22,82,1991/1992
"Ferrell,Duane",331,632,.524,11,33,.333,320,599,.534,166,218,.761,105,105,210,92,49,99,17,134,839,1991/1992
"Ferry,Danny",134,328,.409,17,48,.354,117,280,.418,61,73,.836,53,160,213,75,22,46,15,135,346,1991/1992
"Fleming,Vern",294,610,.482,6,27,.222,288,583,.494,132,179,.737,69,140,209,266,56,140,7,134,726,1991/1992
"Floyd,Sleepy",286,704,.406,37,123,.301,249,581,.429,135,170,.794,34,116,150,239,57,128,21,128,744,1991/1992
"Foster,Greg",89,193,.461,0,1,.000,89,192,.464,35,49,.714,43,102,145,35,6,36,12,83,213,1991/1992
"Fox,Rick",241,525,.459,23,70,.329,218,455,.479,139,184,.755,73,147,220,126,78,123,30,230,644,1991/1992
"Frank,Tellis",18,33,.545,0,0,,18,33,.545,10,15,.667,8,18,26,8,5,5,4,24,46,1991/1992
"Frederick,Anthony",161,370,.435,4,17,.235,157,353,.445,63,92,.685,75,69,144,71,40,58,26,91,389,1991/1992
"Gamble,Kevin",480,908,.529,9,31,.290,471,877,.537,139,157,.885,80,206,286,219,75,97,37,200,1108,1991/1992
"Garland,Winston",333,750,.444,9,28,.321,324,722,.449,171,199,.859,67,123,190,411,98,175,22,206,846,1991/1992
"Garrick,Tom",59,143,.413,1,4,.250,58,139,.417,18,26,.692,12,44,56,98,36,44,4,54,137,1991/1992
"Garrick,Tom",44,93,.473,0,1,.000,44,92,.478,10,16,.625,8,33,41,63,21,30,1,33,98,1991/1992
"Garrick,Tom",11,33,.333,1,2,.500,10,31,.323,6,8,.750,2,7,9,18,7,10,3,14,29,1991/1992
"Garrick,Tom",4,17,.235,0,1,.000,4,16,.250,2,2,1.000,2,4,6,17,8,4,0,7,10,1991/1992
"Gatling,Chris",117,206,.568,0,4,.000,117,202,.579,72,109,.661,75,107,182,16,31,44,36,101,306,1991/1992
"Gattison,Kenny",423,799,.529,0,2,.000,423,797,.531,196,285,.688,177,403,580,131,59,140,69,273,1042,1991/1992
"George,Tate",165,386,.427,1,6,.167,164,380,.432,87,106,.821,36,69,105,162,41,82,3,98,418,1991/1992
"Gill,Kendall",666,1427,.467,6,25,.240,660,1402,.471,284,381,.745,165,237,402,329,154,180,46,237,1622,1991/1992
"Gilliam,Armen",512,1001,.511,0,2,.000,512,999,.513,343,425,.807,234,426,660,118,51,166,85,176,1367,1991/1992
"Glass,Gerald",383,871,.440,16,54,.296,367,817,.449,77,125,.616,107,153,260,175,66,103,30,171,859,1991/1992
"Gminski,Mike",90,199,.452,1,3,.333,89,196,.454,21,28,.750,37,81,118,31,11,20,16,37,202,1991/1992
"Godfread,Dan",0,0,,0,0,,0,0,,0,0,,0,0,0,0,0,0,0,0,0,1991/1992
"Graham,Paul",305,682,.447,55,141,.390,250,541,.462,126,170,.741,72,159,231,175,96,91,21,193,791,1991/1992
"Grandison,Ron",2,4,.500,0,0,,2,4,.500,6,10,.600,3,8,11,1,1,3,1,4,10,1991/1992
"Grant,Gary",275,595,.462,15,51,.294,260,544,.478,44,54,.815,34,150,184,538,138,187,14,181,609,1991/1992
"Grant,Greg",99,225,.440,7,18,.389,92,207,.444,20,24,.833,14,55,69,217,45,46,2,76,225,1991/1992
"Grant,Greg",0,8,.000,0,0,,0,8,.000,1,2,.500,1,3,4,18,8,5,0,3,1,1991/1992
"Grant,Greg",99,217,.456,7,18,.389,92,199,.462,19,22,.864,13,52,65,199,37,41,2,73,224,1991/1992
"Grant,Harvey",489,1022,.478,1,8,.125,488,1014,.481,176,220,.800,157,275,432,170,74,109,27,178,1155,1991/1992
"Grant,Horace",457,790,.578,0,2,.000,457,788,.580,235,317,.741,344,463,807,217,100,98,131,196,1149,1991/1992
"Grayer,Jeff",309,689,.448,19,66,.288,290,623,.465,102,153,.667,129,128,257,150,64,105,13,142,739,1991/1992
"Green,A.C.",382,803,.476,12,56,.214,370,747,.495,340,457,.744,306,456,762,117,91,111,36,141,1116,1991/1992
"Green,Rickey",46,103,.447,1,4,.250,45,99,.455,13,18,.722,3,21,24,68,17,18,1,28,106,1991/1992
"Green,Sean",62,158,.392,2,10,.200,60,148,.405,15,28,.536,22,20,42,22,13,27,6,31,141,1991/1992
"Green,Sidney",147,344,.427,0,0,,147,344,.427,73,89,.820,92,250,342,36,29,62,11,148,367,1991/1992
"Haley,Jack",31,84,.369,0,0,,31,84,.369,14,29,.483,31,64,95,7,7,25,8,75,76,1991/1992
"Hammonds,Tom",195,400,.488,0,1,.000,195,399,.489,50,82,.610,49,136,185,36,22,58,13,118,440,1991/1992
"Hansen,Bob",79,178,.444,7,27,.259,72,151,.477,8,22,.364,17,60,77,69,27,28,3,134,173,1991/1992
"Hansen,Bob",4,9,.444,0,2,.000,4,7,.571,0,0,,2,2,4,1,1,0,0,6,8,1991/1992
"Hansen,Bob",75,169,.444,7,25,.280,68,144,.472,8,22,.364,15,58,73,68,26,28,3,128,165,1991/1992
"Hardaway,Tim",734,1592,.461,127,376,.338,607,1216,.499,298,389,.766,81,229,310,807,164,267,13,208,1893,1991/1992
"Harper,Derek",448,1011,.443,58,186,.312,390,825,.473,198,261,.759,49,121,170,373,101,154,17,150,1152,1991/1992
"Harper,Ron",569,1292,.440,64,211,.303,505,1081,.467,293,398,.736,120,327,447,417,152,252,72,199,1495,1991/1992
"Hastings,Scott",17,50,.340,0,9,.000,17,41,.415,24,28,.857,30,68,98,26,10,22,15,56,58,1991/1992
"Hawkins,Hersey",521,1127,.462,91,229,.397,430,898,.479,403,461,.874,53,218,271,248,157,189,43,174,1536,1991/1992
"Henderson,Gerald",12,32,.375,3,8,.375,9,24,.375,9,11,.818,1,7,8,10,3,8,0,12,36,1991/1992
"Henderson,Gerald",4,11,.364,0,3,.000,4,8,.500,4,6,.667,1,1,2,5,0,4,0,4,12,1991/1992
"Henderson,Gerald",8,21,.381,3,5,.600,5,16,.313,5,5,1.000,0,6,6,5,3,4,0,8,24,1991/1992
"Henson,Steve",52,144,.361,23,48,.479,29,96,.302,23,29,.793,17,24,41,82,15,40,1,50,150,1991/1992
"Herrera,Carl",83,161,.516,0,1,.000,83,160,.519,25,44,.568,33,66,99,27,16,37,25,60,191,1991/1992
"Higgins,Rod",87,211,.412,33,95,.347,54,116,.466,48,59,.814,30,55,85,22,15,15,13,75,255,1991/1992
"Higgins,Sean",127,277,.458,6,25,.240,121,252,.480,31,36,.861,29,73,102,41,16,41,6,58,291,1991/1992
"Higgins,Sean",4,15,.267,0,1,.000,4,14,.286,7,7,1.000,2,6,8,4,2,4,0,6,15,1991/1992
"Higgins,Sean",123,262,.469,6,24,.250,117,238,.492,24,29,.828,27,67,94,37,14,37,6,52,276,1991/1992
"Hill,Tyrone",254,487,.522,0,1,.000,254,486,.523,163,235,.694,182,411,593,47,73,106,43,315,671,1991/1992
"Hodge,Donald",163,328,.497,0,0,,163,328,.497,100,150,.667,118,157,275,39,25,75,23,128,426,1991/1992
"Hodges,Craig",93,242,.384,36,96,.375,57,146,.390,16,17,.941,7,17,24,54,14,22,1,33,238,1991/1992
"Hoppen,Dave",2,7,.286,0,0,,2,7,.286,5,10,.500,1,9,10,2,0,3,0,6,9,1991/1992
"Hopson,Dennis",276,593,.465,12,47,.255,264,546,.484,179,253,.708,105,101,206,102,67,100,39,115,743,1991/1992
"Hopson,Dennis",1,2,.500,0,0,,1,2,.500,0,0,,0,0,0,0,1,0,0,2,2,1991/1992
"Hopson,Dennis",275,591,.465,12,47,.255,263,544,.483,179,253,.708,105,101,206,102,66,100,39,113,741,1991/1992
"Hornacek,Jeff",635,1240,.512,83,189,.439,552,1051,.525,279,315,.886,106,301,407,411,158,170,31,218,1632,1991/1992
"Howard,Brian",54,104,.519,1,2,.500,53,102,.520,22,31,.710,17,34,51,14,11,15,8,55,131,1991/1992
"Humphries,Jay",377,803,.469,42,144,.292,335,659,.508,195,249,.783,44,140,184,466,119,148,13,210,991,1991/1992
"Hunter,Cedric",0,0,,0,0,,0,0,,0,0,,0,0,0,0,0,0,0,0,0,1991/1992
"Iuzzolino,Mike",160,355,.451,59,136,.434,101,219,.461,107,128,.836,27,71,98,194,33,92,1,79,486,1991/1992
"Jackson,Jaren",11,23,.478,0,0,,11,23,.478,4,6,.667,5,5,10,3,2,4,0,7,26,1991/1992
"Jackson,Mark",367,747,.491,11,43,.256,356,704,.506,171,222,.770,95,210,305,694,112,211,13,153,916,1991/1992
"Jamerson,Dave",79,191,.414,8,28,.286,71,163,.436,25,27,.926,22,21,43,33,17,24,0,39,191,1991/1992
"James,Henry",164,403,.407,29,90,.322,135,313,.431,61,76,.803,35,77,112,25,16,43,11,94,418,1991/1992
"Jepsen,Les",9,24,.375,0,1,.000,9,23,.391,7,11,.636,12,18,30,1,1,3,5,17,25,1991/1992
"Johnson,Avery",158,330,.479,4,15,.267,154,315,.489,66,101,.653,13,67,80,266,61,110,9,89,386,1991/1992
"Johnson,Avery",55,108,.509,1,5,.200,54,103,.524,24,32,.750,5,30,35,100,21,45,3,43,135,1991/1992
"Johnson,Avery",103,222,.464,3,10,.300,100,212,.472,42,69,.609,8,37,45,166,40,65,6,46,251,1991/1992
"Johnson,Buck",290,633,.458,1,9,.111,289,624,.463,104,143,.727,95,217,312,158,72,104,49,234,685,1991/1992
"Johnson,Eddie",534,1164,.459,27,107,.252,507,1057,.480,291,338,.861,118,174,292,161,55,130,11,199,1386,1991/1992
"Johnson,Kevin",539,1125,.479,10,46,.217,529,1079,.490,448,555,.807,61,231,292,836,116,272,23,180,1536,1991/1992
"Johnson,Larry",616,1258,.490,5,22,.227,611,1236,.494,339,409,.829,323,576,899,292,81,160,51,225,1576,1991/1992
"Johnson,Vinnie",202,499,.405,19,60,.317,183,439,.417,55,85,.647,67,115,182,145,41,74,14,93,478,1991/1992
"Jones,Charles",33,90,.367,0,0,,33,90,.367,20,40,.500,105,212,317,62,43,39,92,214,86,1991/1992
"Jordan,Michael",943,1818,.519,27,100,.270,916,1718,.533,491,590,.832,91,420,511,489,182,200,75,201,2404,1991/1992
"Kemp,Shawn",362,718,.504,0,3,.000,362,715,.506,270,361,.748,264,401,665,86,70,156,124,261,994,1991/1992
"Kerr,Steve",121,237,.511,32,74,.432,89,163,.546,45,54,.833,14,64,78,110,27,31,10,29,319,1991/1992
"Kersey,Jerome",398,852,.467,1,8,.125,397,844,.470,174,262,.664,241,392,633,243,114,151,71,254,971,1991/1992
"Kessler,Alec",158,383,.413,0,0,,158,383,.413,94,115,.817,114,200,314,34,17,58,32,185,410,1991/1992
"Kimble,Bo",44,111,.396,4,13,.308,40,98,.408,20,31,.645,13,19,32,17,10,15,6,37,112,1991/1992
"King,Albert",11,30,.367,2,7,.286,9,23,.391,7,8,.875,1,10,11,5,3,2,0,7,31,1991/1992
"King,Rich",27,71,.380,0,1,.000,27,70,.386,34,45,.756,20,29,49,12,4,18,5,42,88,1991/1992
"King,Stacey",215,425,.506,2,5,.400,213,420,.507,119,158,.753,87,118,205,77,21,76,25,129,551,1991/1992
"Kite,Greg",94,215,.437,0,1,.000,94,214,.439,40,68,.588,156,246,402,44,30,61,57,212,228,1991/1992
"Kleine,Joe",144,293,.491,4,8,.500,140,285,.491,34,48,.708,94,202,296,32,23,27,14,99,326,1991/1992
"Knight,Negele",103,217,.475,4,13,.308,99,204,.485,33,48,.688,16,30,46,112,24,58,3,58,243,1991/1992
"Kofoed,Bart",25,53,.472,1,7,.143,24,46,.522,15,26,.577,6,20,26,51,2,20,2,26,66,1991/1992
"Koncak,Jon",111,284,.391,0,12,.000,111,272,.408,19,29,.655,62,199,261,132,50,54,67,207,241,1991/1992
"Krystkowiak,Larry",293,660,.444,0,5,.000,293,655,.447,128,169,.757,131,298,429,114,54,115,12,218,714,1991/1992
"Laimbeer,Bill",342,727,.470,32,85,.376,310,642,.483,67,75,.893,104,347,451,160,51,102,54,225,783,1991/1992
"Lane,Jerome",14,46,.304,0,0,,14,46,.304,9,27,.333,32,34,66,17,2,14,1,28,37,1991/1992
"Lane,Jerome",10,40,.250,0,0,,10,40,.250,8,19,.421,22,22,44,13,2,10,1,18,28,1991/1992
"Lane,Jerome",3,5,.600,0,0,,3,5,.600,0,6,.000,9,9,18,4,0,3,0,9,6,1991/1992
"Lane,Jerome",1,1,1.000,0,0,,1,1,1.000,1,2,.500,1,3,4,0,0,1,0,1,3,1991/1992
"Lang,Andrew",248,475,.522,0,1,.000,248,474,.523,126,164,.768,170,376,546,43,48,87,201,306,622,1991/1992
"Leckner,Eric",79,154,.513,0,1,.000,79,153,.516,38,51,.745,49,157,206,31,9,39,18,114,196,1991/1992
"Lee,Doug",50,116,.431,10,37,.270,40,79,.506,10,19,.526,17,18,35,22,11,12,1,39,120,1991/1992
"Leonard,Gary",4,6,.667,0,0,,4,6,.667,2,2,1.000,3,2,5,1,1,1,0,3,10,1991/1992
"Les,Jim",74,192,.385,45,131,.344,29,61,.475,38,47,.809,11,52,63,143,31,42,3,58,231,1991/1992
"Lever,Fat",135,349,.387,17,52,.327,118,297,.397,60,80,.750,56,105,161,107,46,36,12,73,347,1991/1992
"Levingston,Cliff",125,251,.498,1,6,.167,124,245,.506,60,96,.625,109,118,227,66,27,42,45,134,311,1991/1992
"Lewis,Reggie",703,1397,.503,5,21,.238,698,1376,.507,292,343,.851,117,277,394,185,125,136,105,258,1703,1991/1992
"Liberty,Marcus",275,621,.443,17,50,.340,258,571,.452,131,180,.728,144,164,308,58,66,90,29,165,698,1991/1992
"Lichti,Todd",173,376,.460,1,9,.111,172,367,.469,99,118,.839,36,82,118,74,43,72,12,131,446,1991/1992
"Lister,Alton",44,79,.557,0,0,,44,79,.557,14,33,.424,21,71,92,14,5,20,16,61,102,1991/1992
"Lohaus,Brad",162,360,.450,57,144,.396,105,216,.486,27,41,.659,65,184,249,74,40,46,71,144,408,1991/1992
"Long,Grant",440,890,.494,6,22,.273,434,868,.500,326,404,.807,259,432,691,225,139,185,40,248,1212,1991/1992
"Longley,Luc",114,249,.458,0,0,,114,249,.458,53,80,.663,67,190,257,53,35,83,64,157,281,1991/1992
"Lynch,Kevin",93,223,.417,3,8,.375,90,215,.419,35,46,.761,30,55,85,83,37,44,9,107,224,1991/1992
"Macon,Mark",333,889,.375,4,30,.133,329,859,.383,135,185,.730,80,140,220,168,154,155,14,242,805,1991/1992
"Majerle,Dan",551,1153,.478,87,228,.382,464,925,.502,229,303,.756,148,335,483,274,131,102,43,158,1418,1991/1992
"Malone,Jeff",691,1353,.511,1,12,.083,690,1341,.515,256,285,.898,49,184,233,180,56,140,5,126,1639,1991/1992
"Malone,Karl",798,1516,.526,3,17,.176,795,1499,.530,673,865,.778,225,684,909,241,108,248,51,226,2272,1991/1992
"Malone,Moses",440,929,.474,3,8,.375,437,921,.474,396,504,.786,320,424,744,93,74,150,64,136,1279,1991/1992
"Manning,Danny",650,1199,.542,0,5,.000,650,1194,.544,279,385,.725,229,335,564,285,135,210,122,293,1579,1991/1992
"Marčiulionis,Šarūnas",491,912,.538,3,10,.300,488,902,.541,376,477,.788,68,140,208,243,116,193,10,237,1361,1991/1992
"Mason,Anthony",203,399,.509,0,0,,203,399,.509,167,260,.642,216,357,573,106,46,101,20,229,573,1991/1992
"Massenburg,Tony",10,25,.400,0,0,,10,25,.400,9,15,.600,7,18,25,0,1,9,1,21,29,1991/1992
"Massenburg,Tony",1,5,.200,0,0,,1,5,.200,0,0,,0,0,0,0,0,0,0,2,2,1991/1992
"Massenburg,Tony",0,3,.000,0,0,,0,3,.000,1,2,.500,1,3,4,0,1,4,0,2,1,1991/1992
"Massenburg,Tony",4,9,.444,0,0,,4,9,.444,2,4,.500,2,7,9,0,0,2,1,7,10,1991/1992
"Massenburg,Tony",5,8,.625,0,0,,5,8,.625,6,9,.667,4,8,12,0,0,3,0,10,16,1991/1992
"Maxwell,Vernon",502,1216,.413,162,473,.342,340,743,.458,206,267,.772,37,206,243,326,104,178,28,200,1372,1991/1992
"Mayes,Tharon",30,99,.303,15,41,.366,15,58,.259,24,36,.667,3,13,16,35,16,31,2,41,99,1991/1992
"Mayes,Tharon",28,94,.298,14,39,.359,14,55,.255,20,30,.667,3,12,15,32,14,28,1,32,90,1991/1992
"Mayes,Tharon",2,5,.400,1,2,.500,1,3,.333,4,6,.667,0,1,1,3,2,3,1,9,9,1991/1992
"Mays,Travis",6,14,.429,3,6,.500,3,8,.375,2,2,1.000,1,1,2,1,0,3,0,4,17,1991/1992
"McCann,Bob",13,33,.394,0,1,.000,13,32,.406,4,13,.308,12,18,30,6,6,7,4,23,30,1991/1992
"McCloud,George",128,313,.409,32,94,.340,96,219,.438,50,64,.781,45,87,132,116,26,62,11,95,338,1991/1992
"McCormick,Tim",14,33,.424,0,0,,14,33,.424,14,21,.667,14,20,34,9,2,8,0,18,42,1991/1992
"McCray,Rodney",271,622,.436,25,85,.294,246,537,.458,110,153,.719,149,319,468,219,48,115,30,180,677,1991/1992
"McDaniel,Xavier",488,1021,.478,12,39,.308,476,982,.485,137,192,.714,176,284,460,149,57,147,24,241,1125,1991/1992
"McHale,Kevin",323,634,.509,0,13,.000,323,621,.520,134,163,.822,119,211,330,82,11,82,59,112,780,1991/1992
"McKey,Derrick",285,604,.472,19,50,.380,266,554,.480,188,222,.847,95,173,268,120,61,114,47,142,777,1991/1992
"McKinney,Carlton",2,9,.222,0,0,,2,9,.222,0,0,,0,1,1,0,0,0,0,1,4,1991/1992
"McMillan,Nate",177,405,.437,27,98,.276,150,307,.489,54,84,.643,92,160,252,359,129,112,29,218,435,1991/1992
"Miller,Reggie",562,1121,.501,129,341,.378,433,780,.555,442,515,.858,82,236,318,314,105,157,26,210,1695,1991/1992
"Mills,Terry",310,670,.463,8,23,.348,302,647,.467,114,152,.750,187,266,453,84,48,82,41,200,742,1991/1992
"Mitchell,Sam",307,725,.423,2,11,.182,305,714,.427,209,266,.786,158,315,473,94,53,97,39,230,825,1991/1992
"Monroe,Rodney",53,144,.368,6,27,.222,47,117,.402,19,23,.826,12,21,33,27,12,23,2,19,131,1991/1992
"Moore,Tracy",130,325,.400,30,84,.357,100,241,.415,65,78,.833,31,51,82,48,32,44,4,97,355,1991/1992
"Morris,Chris",346,726,.477,22,110,.200,324,616,.526,165,231,.714,199,295,494,197,129,171,81,211,879,1991/1992
"Morton,John",36,93,.387,2,16,.125,34,77,.442,32,38,.842,6,20,26,32,13,28,1,23,106,1991/1992
"Morton,John",3,12,.250,0,1,.000,3,11,.273,8,9,.889,3,4,7,5,1,4,0,3,14,1991/1992
"Morton,John",33,81,.407,2,15,.133,31,66,.470,24,29,.828,3,16,19,27,12,24,1,20,92,1991/1992
"Mullin,Chris",830,1584,.524,64,175,.366,766,1409,.544,350,420,.833,127,323,450,286,173,202,62,171,2074,1991/1992
"Murdock,Eric",76,183,.415,5,26,.192,71,157,.452,46,61,.754,21,33,54,92,30,50,7,52,203,1991/1992
"Murphy,Tod",39,80,.488,1,2,.500,38,78,.487,19,34,.559,36,74,110,11,9,18,8,40,98,1991/1992
"Mustaf,Jerrod",92,193,.477,0,0,,92,193,.477,49,71,.690,45,100,145,45,21,51,16,59,233,1991/1992
"Mutombo,Dikembe",428,869,.493,0,0,,428,869,.493,321,500,.642,316,554,870,156,43,252,210,273,1177,1991/1992
"Nance,Larry",556,1032,.539,0,6,.000,556,1026,.542,263,320,.822,213,457,670,232,80,87,243,200,1375,1991/1992
"Nealy,Ed",62,121,.512,20,50,.400,42,71,.592,16,24,.667,25,86,111,37,16,17,2,45,160,1991/1992
"Nevitt,Chuck",1,3,.333,0,0,,1,3,.333,0,0,,0,1,1,1,0,3,0,2,2,1991/1992
"Newman,Johnny",295,618,.477,13,46,.283,282,572,.493,236,308,.766,71,108,179,146,70,129,14,181,839,1991/1992
"Norman,Ken",402,821,.490,4,28,.143,398,793,.502,121,226,.535,158,290,448,125,53,100,66,145,929,1991/1992
"Oakley,Charles",210,402,.522,0,3,.000,210,399,.526,86,117,.735,256,444,700,133,67,123,15,258,506,1991/1992
"Ogg,Alan",46,84,.548,0,0,,46,84,.548,16,30,.533,30,44,74,7,5,19,28,73,108,1991/1992
"Olajuwon,Hakeem",591,1177,.502,0,1,.000,591,1176,.503,328,428,.766,246,599,845,157,127,187,304,263,1510,1991/1992
"Oliver,Brian",33,100,.330,0,4,.000,33,96,.344,15,22,.682,10,20,30,20,10,24,2,33,81,1991/1992
"Oliver,Jimmy",39,98,.398,1,9,.111,38,89,.427,17,22,.773,9,18,27,20,9,9,2,22,96,1991/1992
"Owens,Billy",468,891,.525,1,9,.111,467,882,.529,204,312,.654,243,396,639,188,90,179,65,276,1141,1991/1992
"Owens,Keith",9,32,.281,0,0,,9,32,.281,8,10,.800,8,7,15,3,5,2,4,11,26,1991/1992
"Pack,Robert",115,272,.423,0,10,.000,115,262,.439,102,127,.803,32,65,97,140,40,92,4,101,332,1991/1992
"Parish,Robert",468,874,.535,0,0,,468,874,.535,179,232,.772,219,486,705,70,68,131,97,172,1115,1991/1992
"Paxson,John",257,487,.528,12,44,.273,245,443,.553,29,37,.784,21,75,96,241,49,44,9,142,555,1991/1992
"Payne,Kenny",65,145,.448,5,12,.417,60,133,.451,9,13,.692,13,41,54,17,16,19,8,34,144,1991/1992
"Payton,Gary",331,734,.451,3,23,.130,328,711,.461,99,148,.669,123,172,295,506,147,174,21,248,764,1991/1992
"Perdue,Will",152,278,.547,1,2,.500,151,276,.547,45,91,.495,108,204,312,80,16,72,43,133,350,1991/1992
"Perkins,Sam",361,803,.450,15,69,.217,346,734,.471,304,372,.817,192,364,556,141,64,83,62,192,1041,1991/1992
"Perry,Elliot",49,129,.380,1,7,.143,48,122,.393,27,41,.659,14,25,39,78,34,50,3,36,126,1991/1992
"Perry,Elliot",6,15,.400,0,2,.000,6,13,.462,1,2,.500,2,5,7,14,9,13,1,10,13,1991/1992
"Perry,Elliot",43,114,.377,1,5,.200,42,109,.385,26,39,.667,12,20,32,64,25,37,2,26,113,1991/1992
"Perry,Tim",413,789,.523,3,8,.375,410,781,.525,153,215,.712,204,347,551,134,44,141,116,237,982,1991/1992
"Person,Chuck",616,1284,.480,132,354,.373,484,930,.520,133,197,.675,114,312,426,382,68,216,18,247,1497,1991/1992
"Petersen,Jim",18,40,.450,0,2,.000,18,38,.474,7,10,.700,12,33,45,9,5,5,6,35,43,1991/1992
"Petrović,Dražen",668,1315,.508,123,277,.444,545,1038,.525,232,287,.808,97,161,258,252,105,215,11,248,1691,1991/1992
"Phills,Bobby",12,28,.429,0,2,.000,12,26,.462,7,11,.636,4,4,8,4,3,8,1,3,31,1991/1992
"Pierce,Ricky",620,1306,.475,33,123,.268,587,1183,.496,417,455,.916,93,140,233,241,86,189,20,213,1690,1991/1992
"Pinckney,Ed",203,378,.537,0,1,.000,203,377,.538,207,255,.812,252,312,564,62,70,73,56,158,613,1991/1992
"Pippen,Scottie",687,1359,.506,16,80,.200,671,1279,.525,330,434,.760,185,445,630,572,155,253,93,242,1720,1991/1992
"Polynice,Olden",244,470,.519,0,1,.000,244,469,.520,125,201,.622,195,341,536,46,45,83,20,165,613,1991/1992
"Popson,Dave",3,7,.429,0,1,.000,3,6,.500,1,2,.500,2,3,5,3,2,4,1,5,7,1991/1992
"Porter,Terry",521,1129,.461,128,324,.395,393,805,.488,315,368,.856,51,204,255,477,127,188,12,155,1485,1991/1992
"Pressey,Paul",60,161,.373,3,21,.143,57,140,.407,28,41,.683,22,73,95,142,29,64,19,86,151,1991/1992
"Price,Mark",438,897,.488,101,261,.387,337,636,.530,270,285,.947,38,135,173,535,94,159,12,113,1247,1991/1992
"Pritchard,Kevin",16,34,.471,0,3,.000,16,31,.516,14,18,.778,1,10,11,30,3,11,4,17,46,1991/1992
"Quinnett,Brian",43,124,.347,13,41,.317,30,83,.361,16,26,.615,16,35,51,12,16,16,8,32,115,1991/1992
"Quinnett,Brian",28,73,.384,10,26,.385,18,47,.383,8,14,.571,9,15,24,7,7,8,6,21,74,1991/1992
"Quinnett,Brian",15,51,.294,3,15,.200,12,36,.333,8,12,.667,7,20,27,5,9,8,2,11,41,1991/1992
"Rambis,Kurt",38,82,.463,0,0,,38,82,.463,14,18,.778,23,83,106,37,12,25,14,46,90,1991/1992
"Randall,Mark",68,149,.456,3,16,.188,65,133,.489,32,43,.744,39,32,71,33,12,25,3,39,171,1991/1992
"Randall,Mark",10,22,.455,0,2,.000,10,20,.500,6,8,.750,4,5,9,7,0,6,0,8,26,1991/1992
"Randall,Mark",58,127,.457,3,14,.214,55,113,.487,26,35,.743,35,27,62,26,12,19,3,31,145,1991/1992
"Rasmussen,Blair",347,726,.478,5,23,.217,342,703,.486,30,40,.750,94,299,393,107,35,51,48,233,729,1991/1992
"Reid,J.R.",213,435,.490,0,3,.000,213,432,.493,134,190,.705,96,221,317,81,49,84,23,159,560,1991/1992
"Reynolds,Jerry",197,518,.380,3,24,.125,194,494,.393,158,189,.836,47,102,149,151,63,96,17,69,555,1991/1992
"Rice,Glen",672,1432,.469,155,396,.391,517,1036,.499,266,318,.836,84,310,394,184,90,145,35,170,1765,1991/1992
"Richardson,Pooh",587,1261,.466,53,155,.342,534,1106,.483,123,178,.691,91,210,301,685,119,204,25,152,1350,1991/1992
"Richmond,Mitch",685,1465,.468,103,268,.384,582,1197,.486,330,406,.813,62,257,319,411,92,247,34,231,1803,1991/1992
"Rivers,David",10,30,.333,0,1,.000,10,29,.345,10,11,.909,10,9,19,21,7,17,1,14,30,1991/1992
"Rivers,Doc",226,533,.424,26,92,.283,200,441,.454,163,196,.832,23,124,147,233,111,92,19,166,641,1991/1992
"Roberts,Fred",311,645,.482,19,37,.514,292,608,.480,128,171,.749,103,154,257,122,52,122,40,177,769,1991/1992
"Roberts,Stanley",236,446,.529,0,1,.000,236,445,.530,101,196,.515,113,223,336,39,22,78,83,221,573,1991/1992
"Robertson,Alvin",396,922,.430,67,210,.319,329,712,.462,151,198,.763,175,175,350,360,210,223,32,263,1010,1991/1992
"Robinson,Cliff",11,27,.407,0,1,.000,11,26,.423,7,8,.875,7,12,19,9,5,7,0,4,29,1991/1992
"Robinson,Clifford",398,854,.466,1,11,.091,397,843,.471,219,330,.664,140,276,416,137,85,154,107,274,1016,1991/1992
"Robinson,David",592,1074,.551,1,8,.125,591,1066,.554,393,561,.701,261,568,829,181,158,182,305,219,1578,1991/1992
"Robinson,Larry",1,5,.200,0,0,,1,5,.200,0,0,,2,0,2,1,0,1,0,3,2,1991/1992
"Robinson,Rumeal",423,928,.456,34,104,.327,389,824,.472,175,275,.636,64,155,219,446,105,206,24,178,1055,1991/1992
"Rodman,Dennis",342,635,.539,32,101,.317,310,534,.581,84,140,.600,523,1007,1530,191,68,140,70,248,800,1991/1992
"Rollins,Tree",46,86,.535,0,0,,46,86,.535,26,30,.867,61,110,171,15,14,18,62,85,118,1991/1992
"Royal,Donald",80,178,.449,0,0,,80,178,.449,92,133,.692,65,59,124,34,25,39,7,73,252,1991/1992
"Rudd,Delaney",75,188,.399,11,47,.234,64,141,.454,32,42,.762,15,39,54,109,15,49,1,64,193,1991/1992
"Ruland,Jeff",20,38,.526,0,0,,20,38,.526,11,16,.688,16,31,47,5,7,20,4,45,51,1991/1992
"Salley,John",249,486,.512,0,3,.000,249,483,.516,186,260,.715,106,190,296,116,49,102,110,222,684,1991/1992
"Sampson,Ralph",9,29,.310,0,2,.000,9,27,.333,4,6,.667,11,19,30,4,3,10,8,14,22,1991/1992
"Sanders,Jeff",20,45,.444,0,0,,20,45,.444,7,9,.778,9,17,26,9,5,5,3,15,47,1991/1992
"Sanders,Mike",92,161,.571,1,3,.333,91,158,.576,36,47,.766,27,69,96,53,24,22,10,83,221,1991/1992
"Sanders,Mike",11,22,.500,0,0,,11,22,.500,5,6,.833,0,8,8,11,2,6,1,8,27,1991/1992
"Sanders,Mike",81,139,.583,1,3,.333,80,136,.588,31,41,.756,27,61,88,42,22,16,9,75,194,1991/1992
"Schayes,Danny",83,199,.417,0,0,,83,199,.417,74,96,.771,58,110,168,34,19,41,19,98,240,1991/1992
"Scheffler,Steve",6,9,.667,0,0,,6,9,.667,9,12,.750,10,4,14,0,3,1,1,10,21,1991/1992
"Scheffler,Steve",2,2,1.000,0,0,,2,2,1.000,5,6,.833,2,1,3,0,0,0,1,2,9,1991/1992
"Scheffler,Steve",4,7,.571,0,0,,4,7,.571,4,6,.667,8,3,11,0,3,1,0,8,12,1991/1992
"Schintzius,Dwayne",50,117,.427,0,4,.000,50,113,.442,10,12,.833,43,75,118,20,6,19,28,67,110,1991/1992
"Schrempf,Detlef",496,925,.536,23,71,.324,473,854,.554,365,441,.828,202,568,770,312,62,191,37,286,1380,1991/1992
"Scott,Byron",460,1005,.458,54,157,.344,406,848,.479,244,291,.838,74,236,310,226,105,119,28,140,1218,1991/1992
"Scott,Dennis",133,331,.402,29,89,.326,104,242,.430,64,71,.901,14,52,66,35,20,31,9,49,359,1991/1992
"Seikaly,Rony",463,947,.489,0,3,.000,463,944,.490,370,505,.733,307,627,934,109,40,216,121,278,1296,1991/1992
"Sellers,Brad",41,88,.466,0,1,.000,41,87,.471,20,26,.769,15,27,42,14,1,15,10,20,102,1991/1992
"Shackleford,Charles",205,422,.486,0,1,.000,205,421,.487,63,95,.663,145,270,415,46,38,62,51,205,473,1991/1992
"Shaw,Brian",209,513,.407,5,23,.217,204,490,.416,72,91,.791,50,154,204,250,57,99,22,115,495,1991/1992
"Shaw,Brian",70,164,.427,0,7,.000,70,157,.446,35,40,.875,11,58,69,89,12,32,10,29,175,1991/1992
"Shaw,Brian",139,349,.398,5,16,.313,134,333,.402,37,51,.725,39,96,135,161,45,67,12,86,320,1991/1992
"Simmons,Lionel",527,1162,.454,1,5,.200,526,1157,.455,281,365,.770,149,485,634,337,135,218,132,205,1336,1991/1992
"Skiles,Scott",359,868,.414,91,250,.364,268,618,.434,248,277,.895,36,166,202,544,74,233,5,188,1057,1991/1992
"Smith,Charles",251,539,.466,0,6,.000,251,533,.471,212,270,.785,95,206,301,56,41,69,98,159,714,1991/1992
"Smith,Doug",291,702,.415,0,11,.000,291,691,.421,89,121,.736,129,262,391,129,62,97,34,259,671,1991/1992
"Smith,Kenny",432,910,.475,54,137,.394,378,773,.489,219,253,.866,34,143,177,562,104,227,7,112,1137,1991/1992
"Smith,LaBradford",100,246,.407,2,21,.095,98,225,.436,45,56,.804,30,51,81,99,44,63,1,98,247,1991/1992
"Smith,Larry",50,92,.543,0,1,.000,50,91,.549,4,11,.364,107,149,256,33,21,44,7,121,104,1991/1992
"Smith,Otis",116,318,.365,8,21,.381,108,297,.364,70,91,.769,40,76,116,57,36,62,13,85,310,1991/1992
"Smith,Steve",297,654,.454,40,125,.320,257,529,.486,95,127,.748,81,107,188,278,59,152,19,162,729,1991/1992
"Smith,Tony",113,283,.399,0,11,.000,113,272,.415,49,75,.653,31,45,76,109,39,50,8,91,275,1991/1992
"Smits,Rik",436,855,.510,0,2,.000,436,853,.511,152,193,.788,124,293,417,116,29,130,100,231,1024,1991/1992
"Smrek,Mike",0,0,,0,0,,0,0,,0,0,,0,1,1,0,0,0,0,0,0,1991/1992
"Sparrow,Rory",58,151,.384,3,15,.200,55,136,.404,8,13,.615,3,25,28,83,12,33,5,57,127,1991/1992
"Sparrow,Rory",1,8,.125,1,2,.500,0,6,.000,0,0,,0,1,1,4,0,2,0,2,3,1991/1992
"Sparrow,Rory",57,143,.399,2,13,.154,55,130,.423,8,13,.615,3,24,27,79,12,31,5,55,124,1991/1992
"Spencer,Felton",141,331,.426,0,0,,141,331,.426,123,178,.691,167,268,435,53,27,70,79,241,405,1991/1992
"Starks,John",405,902,.449,94,270,.348,311,632,.492,235,302,.778,45,146,191,276,103,150,18,231,1139,1991/1992
"Stewart,Larry",303,590,.514,0,3,.000,303,587,.516,188,233,.807,186,263,449,120,51,112,44,225,794,1991/1992
"Stockton,John",453,939,.482,83,204,.407,370,735,.503,308,366,.842,68,202,270,1126,244,286,22,234,1297,1991/1992
"Strickland,Rod",300,659,.455,5,15,.333,295,644,.458,182,265,.687,92,173,265,491,118,160,17,122,787,1991/1992
"Strong,Derek",0,4,.000,0,0,,0,4,.000,3,4,.750,1,4,5,1,0,1,0,1,3,1991/1992
"Strothers,Lamont",4,12,.333,0,2,.000,4,10,.400,2,4,.500,1,0,1,1,1,2,1,2,10,1991/1992
"Sundvold,Jon",1,3,.333,1,1,1.000,0,2,.000,0,0,,0,0,0,2,0,0,0,2,3,1991/1992
"Sutton,Greg",93,240,.388,26,89,.292,67,151,.444,34,45,.756,6,41,47,91,26,70,9,111,246,1991/1992
"Teagle,Terry",364,805,.452,1,4,.250,363,801,.453,151,197,.766,91,92,183,113,66,114,9,148,880,1991/1992
"Thomas,Carl",5,12,.417,1,2,.500,4,10,.400,1,2,.500,0,0,0,1,1,1,0,3,12,1991/1992
"Thomas,Charles",18,51,.353,2,17,.118,16,34,.471,10,15,.667,6,16,22,22,4,17,1,20,48,1991/1992
"Thomas,Isiah",564,1264,.446,25,86,.291,539,1178,.458,292,378,.772,68,179,247,560,118,252,15,194,1445,1991/1992
"Thompson,Billy",0,0,,0,0,,0,0,,0,0,,0,0,0,0,0,0,0,0,0,1991/1992
"Thompson,LaSalle",168,359,.468,0,2,.000,168,357,.471,58,71,.817,98,283,381,102,52,98,34,207,394,1991/1992
"Thompson,Stephen",14,37,.378,0,1,.000,14,36,.389,3,8,.375,11,8,19,8,6,5,3,9,31,1991/1992
"Thompson,Stephen",1,3,.333,0,0,,1,3,.333,0,0,,0,1,1,1,0,2,0,2,2,1991/1992
"Thompson,Stephen",13,34,.382,0,1,.000,13,33,.394,3,8,.375,11,7,18,7,6,3,3,7,29,1991/1992
"Thornton,Bob",1,7,.143,0,0,,1,7,.143,2,2,1.000,2,0,2,0,0,0,0,1,4,1991/1992
"Thorpe,Otis",558,943,.592,0,7,.000,558,936,.596,304,463,.657,285,577,862,250,52,237,37,307,1420,1991/1992
"Threatt,Sedale",509,1041,.489,20,62,.323,489,979,.499,202,243,.831,43,210,253,593,168,182,16,231,1240,1991/1992
"Tisdale,Wayman",522,1043,.500,0,2,.000,522,1041,.501,151,198,.763,135,334,469,106,55,124,79,248,1195,1991/1992
"Tolbert,Tom",33,86,.384,2,8,.250,31,78,.397,22,40,.550,14,41,55,21,10,20,6,73,90,1991/1992
"Tucker,Trent",60,129,.465,19,48,.396,41,81,.506,16,20,.800,8,29,37,27,21,14,3,39,155,1991/1992
"Turner,Andre",111,261,.425,1,16,.063,110,245,.449,61,77,.792,17,73,90,177,57,84,2,59,284,1991/1992
"Turner,Jeff",225,499,.451,1,8,.125,224,491,.456,79,114,.693,62,184,246,92,24,106,16,229,530,1991/1992
"Turner,John",43,98,.439,0,0,,43,98,.439,31,59,.525,38,40,78,12,6,32,4,40,117,1991/1992
"Vandeweghe,Kiki",188,383,.491,26,66,.394,162,317,.511,65,81,.802,31,57,88,57,15,27,8,87,467,1991/1992
"Vaught,Loy",271,551,.492,4,5,.800,267,546,.489,55,69,.797,160,352,512,71,37,66,31,165,601,1991/1992
"Vianna,João",1,2,.500,0,0,,1,2,.500,0,0,,0,0,0,2,0,1,0,3,2,1991/1992
"Vincent,Sam",150,349,.430,1,13,.077,149,336,.443,110,130,.846,19,82,101,148,35,72,4,55,411,1991/1992
"Volkov,Alexander",251,569,.441,35,110,.318,216,459,.471,125,198,.631,103,162,265,250,66,102,30,178,662,1991/1992
"Vranković,Stojko",15,32,.469,0,0,,15,32,.469,7,12,.583,8,20,28,5,0,10,17,22,37,1991/1992
"Walker,Darrell",161,381,.423,0,10,.000,161,371,.434,65,105,.619,85,153,238,205,63,79,18,134,387,1991/1992
"Webb,Spud",448,1006,.445,73,199,.367,375,807,.465,262,305,.859,30,193,223,547,125,229,24,193,1231,1991/1992
"West,Doug",463,894,.518,4,23,.174,459,871,.527,186,231,.805,107,150,257,281,66,120,26,239,1116,1991/1992
"West,Mark",196,310,.632,0,0,,196,310,.632,109,171,.637,134,238,372,22,14,82,81,239,501,1991/1992
"Whatley,Ennis",21,51,.412,0,4,.000,21,47,.447,27,31,.871,6,15,21,34,14,14,3,12,69,1991/1992
"White,Randy",145,382,.380,4,27,.148,141,355,.397,124,162,.765,96,140,236,31,31,68,22,157,418,1991/1992
"Wiggins,Mitchell",88,229,.384,0,1,.000,88,228,.386,35,51,.686,43,51,94,22,20,25,1,67,211,1991/1992
"Wiley,Morlon",83,193,.430,14,42,.333,69,151,.457,24,35,.686,24,57,81,180,47,60,3,89,204,1991/1992
"Wiley,Morlon",9,28,.321,0,4,.000,9,24,.375,3,5,.600,2,5,7,13,4,8,0,13,21,1991/1992
"Wiley,Morlon",3,5,.600,0,0,,3,5,.600,0,0,,0,1,1,1,0,0,0,3,6,1991/1992
"Wiley,Morlon",71,160,.444,14,38,.368,57,122,.467,21,30,.700,22,51,73,166,43,52,3,73,177,1991/1992
"Wilkins,Dominique",424,914,.464,37,128,.289,387,786,.492,294,352,.835,103,192,295,158,52,122,24,77,1179,1991/1992
"Wilkins,Gerald",431,964,.447,38,108,.352,393,856,.459,116,159,.730,74,132,206,219,76,113,17,195,1016,1991/1992
"Williams,Buck",340,563,.604,0,1,.000,340,562,.605,221,293,.754,260,444,704,108,62,130,41,244,901,1991/1992
"Williams,Herb",367,851,.431,1,6,.167,366,845,.433,124,171,.725,106,348,454,94,35,114,98,189,859,1991/1992
"Williams,Hot Rod",341,678,.503,0,4,.000,341,674,.506,270,359,.752,228,379,607,196,60,83,182,191,952,1991/1992
"Williams,Jayson",75,206,.364,0,0,,75,206,.364,56,88,.636,62,83,145,12,20,44,20,110,206,1991/1992
"Williams,Kenny",113,218,.518,0,4,.000,113,214,.528,26,43,.605,64,65,129,40,20,22,41,99,252,1991/1992
"Williams,Micheal",404,824,.490,8,33,.242,396,791,.501,372,427,.871,73,209,282,647,233,240,22,262,1188,1991/1992
"Williams,Reggie",601,1277,.471,56,156,.359,545,1121,.486,216,269,.803,145,260,405,235,148,173,68,270,1474,1991/1992
"Williams,Scott",83,172,.483,0,3,.000,83,169,.491,48,74,.649,90,157,247,50,13,35,36,122,214,1991/1992
"Willis,Kevin",591,1224,.483,6,37,.162,585,1187,.493,292,363,.804,418,840,1258,173,72,197,54,223,1480,1991/1992
"Winchester,Kennard",13,30,.433,1,2,.500,12,28,.429,8,10,.800,6,9,15,8,2,2,2,5,35,1991/1992
"Winchester,Kennard",1,3,.333,0,0,,1,3,.333,0,0,,0,0,0,0,0,0,0,1,2,1991/1992
"Winchester,Kennard",12,27,.444,1,2,.500,11,25,.440,8,10,.800,6,9,15,8,2,2,2,4,33,1991/1992
"Wingate,David",266,572,.465,1,18,.056,265,554,.478,105,146,.719,80,189,269,247,123,124,21,162,638,1991/1992
"Wittman,Randy",8,19,.421,0,0,,8,19,.421,1,2,.500,1,8,9,11,2,3,0,4,17,1991/1992
"Wolf,Joe",100,277,.361,1,11,.091,99,266,.372,53,66,.803,97,143,240,61,32,60,14,124,254,1991/1992
"Woolridge,Orlando",452,907,.498,1,9,.111,451,898,.502,241,353,.683,109,151,260,88,41,133,33,154,1146,1991/1992
"Worthy,James",450,1007,.447,9,43,.209,441,964,.457,166,204,.814,98,207,305,252,76,127,23,89,1075,1991/1992
"Young,Danny",100,255,.392,23,70,.329,77,185,.416,57,67,.851,16,59,75,172,46,47,4,53,280,1991/1992
"Young,Danny",16,40,.400,3,10,.300,13,30,.433,10,14,.714,0,9,9,20,6,5,0,6,45,1991/1992
"Young,Danny",84,215,.391,20,60,.333,64,155,.413,47,53,.887,16,50,66,152,40,42,4,47,235,1991/1992
"Abdelnaby,Alaa",245,473,.518,0,1,.000,245,472,.519,88,116,.759,126,211,337,27,25,97,26,189,578,1992/1993
"Abdelnaby,Alaa",26,56,.464,0,1,.000,26,55,.473,12,16,.750,12,25,37,10,6,13,4,24,64,1992/1993
"Abdelnaby,Alaa",219,417,.525,0,0,,219,417,.525,76,100,.760,114,186,300,17,19,84,22,165,514,1992/1993
"Abdul-Rauf,Mahmoud",633,1407,.450,70,197,.355,563,1210,.465,217,232,.935,51,174,225,344,84,187,8,179,1553,1992/1993
"Acres,Mark",26,49,.531,1,2,.500,25,47,.532,11,16,.688,26,41,67,5,3,13,6,34,64,1992/1993
"Acres,Mark",2,9,.222,1,2,.500,1,7,.143,1,2,.500,2,4,6,0,0,2,0,2,6,1992/1993
"Acres,Mark",24,40,.600,0,0,,24,40,.600,10,14,.714,24,37,61,5,3,11,6,32,58,1992/1993
"Adams,Michael",365,831,.439,68,212,.321,297,619,.480,237,277,.856,52,188,240,526,100,175,4,146,1035,1992/1993
"Addison,Rafael",182,411,.443,7,34,.206,175,377,.464,57,70,.814,45,87,132,53,23,64,11,125,428,1992/1993
"Aguirre,Mark",187,422,.443,30,83,.361,157,339,.463,99,129,.767,43,109,152,105,16,68,7,101,503,1992/1993
"Ainge,Danny",337,730,.462,150,372,.403,187,358,.522,123,145,.848,49,165,214,260,69,113,8,175,947,1992/1993
"Alexander,Victor",344,667,.516,10,22,.455,334,645,.518,111,162,.685,132,288,420,93,34,120,53,218,809,1992/1993
"Anderson,Eric",5,18,.278,0,0,,5,18,.278,11,13,.846,6,8,14,3,3,5,1,14,21,1992/1993
"Anderson,Kenny",370,850,.435,7,25,.280,363,825,.440,180,232,.776,51,175,226,449,96,153,11,140,927,1992/1993
"Anderson,Nick",594,1324,.449,88,249,.353,506,1075,.471,298,402,.741,122,355,477,265,128,164,56,200,1574,1992/1993
"Anderson,Ron",225,544,.414,39,120,.325,186,424,.439,72,89,.809,62,122,184,93,31,63,5,75,561,1992/1993
"Anderson,Willie",80,186,.430,1,8,.125,79,178,.444,22,28,.786,7,50,57,79,14,44,6,52,183,1992/1993
"Anthony,Greg",174,419,.415,4,30,.133,170,389,.437,107,159,.673,42,128,170,398,113,104,12,141,459,1992/1993
"Armstrong,B.J.",408,818,.499,63,139,.453,345,679,.508,130,151,.861,27,122,149,330,66,83,6,169,1009,1992/1993
"Askew,Vincent",152,309,.492,2,6,.333,150,303,.495,105,149,.705,62,99,161,122,40,69,19,135,411,1992/1993
"Askew,Vincent",8,17,.471,0,0,,8,17,.471,11,15,.733,7,4,11,5,2,8,1,11,27,1992/1993
"Askew,Vincent",144,292,.493,2,6,.333,142,286,.497,94,134,.701,55,95,150,117,38,61,18,124,384,1992/1993
"Askins,Keith",88,213,.413,22,65,.338,66,148,.446,29,40,.725,74,124,198,31,31,37,29,141,227,1992/1993
"Augmon,Stacey",397,792,.501,0,4,.000,397,788,.504,227,307,.739,141,146,287,170,91,157,18,141,1021,1992/1993
"Austin,Isaac",50,112,.446,0,1,.000,50,111,.450,29,44,.659,38,41,79,6,8,23,14,60,129,1992/1993
"Avent,Anthony",347,802,.433,0,2,.000,347,800,.434,112,172,.651,180,332,512,91,57,140,73,237,806,1992/1993
"Bagley,John",9,25,.360,0,1,.000,9,24,.375,5,6,.833,1,6,7,20,2,17,0,11,23,1992/1993
"Bailey,Thurl",203,446,.455,0,0,,203,446,.455,119,142,.838,53,162,215,61,20,60,47,88,525,1992/1993
"Bardo,Steve",19,62,.306,1,6,.167,18,56,.321,12,17,.706,10,27,37,29,8,17,3,28,51,1992/1993
"Barkley,Charles",716,1376,.520,67,220,.305,649,1156,.561,445,582,.765,237,691,928,385,119,233,74,196,1944,1992/1993
"Barros,Dana",214,474,.451,64,169,.379,150,305,.492,49,59,.831,18,89,107,151,63,58,3,78,541,1992/1993
"Barry,Jon",76,206,.369,21,63,.333,55,143,.385,33,49,.673,10,33,43,68,35,42,3,57,206,1992/1993
"Battle,John",83,200,.415,1,6,.167,82,194,.423,56,72,.778,4,25,29,54,9,22,5,39,223,1992/1993
"Battle,Kenny",6,13,.462,0,1,.000,6,12,.500,2,2,1.000,7,4,11,2,1,2,0,2,14,1992/1993
"Bedford,William",9,27,.333,1,1,1.000,8,26,.308,6,12,.500,1,9,10,0,0,1,1,15,25,1992/1993
"Benjamin,Benoit",133,271,.491,0,0,,133,271,.491,69,104,.663,51,158,209,22,31,78,48,134,335,1992/1993
"Benjamin,Benoit",81,163,.497,0,0,,81,163,.497,47,67,.701,27,86,113,12,17,42,35,73,209,1992/1993
"Benjamin,Benoit",52,108,.481,0,0,,52,108,.481,22,37,.595,24,72,96,10,14,36,13,61,126,1992/1993
"Bennett,Tony",110,260,.423,26,80,.325,84,180,.467,30,41,.732,12,51,63,136,30,50,0,110,276,1992/1993
"Benoit,David",258,592,.436,34,98,.347,224,494,.453,114,152,.750,116,276,392,43,45,90,43,201,664,1992/1993
"Blackman,Rolando",239,539,.443,31,73,.425,208,466,.446,71,90,.789,23,79,102,157,22,65,10,129,580,1992/1993
"Blackwell,Alex",14,42,.333,0,3,.000,14,39,.359,6,8,.750,10,13,23,7,4,5,2,14,34,1992/1993
"Blanks,Lance",65,150,.433,11,43,.256,54,107,.505,20,32,.625,18,50,68,72,16,31,5,61,161,1992/1993
"Blanton,Ricky",3,7,.429,0,0,,3,7,.429,0,0,,2,1,3,1,2,1,0,1,6,1992/1993
"Blaylock,Mookie",414,964,.429,118,315,.375,296,649,.456,123,169,.728,89,191,280,671,203,187,23,156,1069,1992/1993
"Bogues,Muggsy",331,730,.453,6,26,.231,325,704,.462,140,168,.833,51,247,298,711,161,154,5,179,808,1992/1993
"Bol,Manute",52,127,.409,10,32,.313,42,95,.442,12,19,.632,44,149,193,18,14,50,119,87,126,1992/1993
"Bond,Walter",227,565,.402,7,42,.167,220,523,.421,129,167,.772,52,144,196,122,75,112,18,223,590,1992/1993
"Bonner,Anthony",229,497,.461,0,7,.000,229,490,.467,143,241,.593,188,267,455,96,86,105,17,183,601,1992/1993
"Bowie,Anthony",268,569,.471,15,48,.313,253,521,.486,67,84,.798,36,158,194,175,54,84,14,131,618,1992/1993
"Bowie,Sam",287,638,.450,2,6,.333,285,632,.451,141,181,.779,158,398,556,127,32,120,128,226,717,1992/1993
"Brandon,Terrell",297,621,.478,13,42,.310,284,579,.491,118,143,.825,37,142,179,302,79,107,27,122,725,1992/1993
"Breuer,Randy",15,31,.484,0,0,,15,31,.484,2,5,.400,10,18,28,6,2,5,3,12,32,1992/1993
"Brickowski,Frank",456,836,.545,8,26,.308,448,810,.553,195,268,.728,120,285,405,196,80,202,44,235,1115,1992/1993
"Brooks,Kevin",93,233,.399,6,26,.231,87,207,.420,35,40,.875,22,59,81,34,10,39,2,46,227,1992/1993
"Brooks,Scott",183,385,.475,41,99,.414,142,286,.497,112,135,.830,22,77,99,243,79,72,3,136,519,1992/1993
"Brown,Chucky",160,331,.483,0,5,.000,160,326,.491,71,98,.724,88,144,232,51,20,56,24,112,391,1992/1993
"Brown,Dee",328,701,.468,26,82,.317,302,619,.488,192,242,.793,45,201,246,461,138,136,32,203,874,1992/1993
"Brown,Mike",176,409,.430,0,1,.000,176,408,.431,113,164,.689,147,244,391,64,32,95,23,190,465,1992/1993
"Brown,Randy",225,486,.463,2,6,.333,223,480,.465,115,157,.732,75,137,212,196,108,120,34,206,567,1992/1993
"Bryant,Mark",186,370,.503,0,1,.000,186,369,.504,104,148,.703,132,192,324,41,37,65,23,226,476,1992/1993
"Buechler,Jud",176,403,.437,20,59,.339,156,344,.453,65,87,.747,81,114,195,94,47,55,19,98,437,1992/1993
"Bullard,Matt",213,494,.431,91,243,.374,122,251,.486,58,74,.784,66,156,222,110,30,57,11,129,575,1992/1993
"Burton,Willie",54,141,.383,5,15,.333,49,126,.389,91,127,.717,22,48,70,16,13,50,16,58,204,1992/1993
"Burtt,Steve",10,26,.385,1,3,.333,9,23,.391,8,10,.800,2,1,3,6,2,4,0,5,29,1992/1993
"Cage,Michael",219,416,.526,0,1,.000,219,415,.528,61,130,.469,268,391,659,69,76,59,46,183,499,1992/1993
"Cambridge,Dexter",151,312,.484,0,4,.000,151,308,.490,68,99,.687,88,79,167,58,24,63,6,128,370,1992/1993
"Campbell,Elden",238,520,.458,0,3,.000,238,517,.460,130,204,.637,127,205,332,48,59,69,100,165,606,1992/1993
"Campbell,Tony",194,396,.490,2,5,.400,192,391,.491,59,87,.678,59,96,155,62,34,51,5,150,449,1992/1993
"Carr,Antoine",379,705,.538,0,5,.000,379,700,.541,174,224,.777,107,281,388,97,35,96,87,264,932,1992/1993
"Cartwright,Bill",141,343,.411,0,0,,141,343,.411,72,98,.735,83,150,233,83,20,62,10,154,354,1992/1993
"Catledge,Terry",36,73,.493,0,0,,36,73,.493,27,34,.794,18,28,46,5,4,25,1,31,99,1992/1993
"Causwell,Duane",175,321,.545,0,1,.000,175,320,.547,103,165,.624,112,191,303,35,32,58,87,192,453,1992/1993
"Ceballos,Cedric",381,662,.576,0,2,.000,381,660,.577,187,258,.725,172,236,408,77,54,106,28,103,949,1992/1993
"Chambers,Tom",320,716,.447,11,28,.393,309,688,.449,241,288,.837,96,249,345,101,43,92,23,212,892,1992/1993
"Chapman,Rex",287,602,.477,43,116,.371,244,486,.502,132,163,.810,19,69,88,116,38,79,10,119,749,1992/1993
"Cheeks,Maurice",51,93,.548,0,2,.000,51,91,.560,24,27,.889,5,37,42,107,33,33,2,35,126,1992/1993
"Chilcutt,Pete",165,340,.485,0,0,,165,340,.485,32,46,.696,80,114,194,64,22,54,21,102,362,1992/1993
"Christie,Doug",45,106,.425,2,12,.167,43,94,.457,50,66,.758,24,27,51,53,22,50,5,53,142,1992/1993
"Coleman,Derrick",564,1226,.460,23,99,.232,541,1127,.480,421,521,.808,247,605,852,276,92,243,126,210,1572,1992/1993
"Coles,Bimbo",318,686,.464,42,137,.307,276,549,.503,177,220,.805,58,108,166,373,80,108,11,199,855,1992/1993
"Conlon,Marty",81,171,.474,0,4,.000,81,167,.485,57,81,.704,48,75,123,37,13,28,5,43,219,1992/1993
"Conner,Lester",28,62,.452,0,0,,28,62,.452,18,19,.947,16,33,49,65,34,21,4,39,74,1992/1993
"Cooper,Duane",62,158,.392,7,30,.233,55,128,.430,25,35,.714,13,37,50,150,18,69,2,66,156,1992/1993
"Corbin,Tyrone",385,766,.503,0,5,.000,385,761,.506,180,218,.826,194,325,519,173,108,108,32,252,950,1992/1993
"Corchiani,Chris",14,24,.583,0,3,.000,14,21,.667,16,21,.762,1,6,7,16,6,8,0,18,44,1992/1993
"Corchiani,Chris",13,23,.565,0,3,.000,13,20,.650,16,21,.762,1,6,7,16,6,8,0,17,42,1992/1993
"Corchiani,Chris",1,1,1.000,0,0,,1,1,1.000,0,0,,0,0,0,0,0,0,0,1,2,1992/1993
"Courtney,Joe",13,32,.406,0,0,,13,32,.406,7,9,.778,4,15,19,3,5,6,5,17,33,1992/1993
"Courtney,Joe",4,9,.444,0,0,,4,9,.444,3,4,.750,2,0,2,1,2,3,1,9,11,1992/1993
"Courtney,Joe",9,23,.391,0,0,,9,23,.391,4,5,.800,2,15,17,2,3,3,4,8,22,1992/1993
"Crotty,John",37,72,.514,2,14,.143,35,58,.603,26,38,.684,4,13,17,55,11,30,0,29,102,1992/1993
"Cummings,Terry",11,29,.379,0,0,,11,29,.379,5,10,.500,6,13,19,4,1,2,1,17,27,1992/1993
"Ćurčić,Radisav",16,41,.390,0,0,,16,41,.390,26,36,.722,17,32,49,12,7,8,2,30,58,1992/1993
"Curry,Dell",498,1102,.452,95,237,.401,403,865,.466,136,157,.866,51,235,286,180,87,129,23,150,1227,1992/1993
"Daniels,Lloyd",285,644,.443,59,177,.333,226,467,.484,72,99,.727,86,130,216,148,38,102,30,144,701,1992/1993
"Daugherty,Brad",520,911,.571,1,2,.500,519,909,.571,391,492,.795,164,562,726,312,53,150,56,174,1432,1992/1993
"Davis,Dale",304,535,.568,0,0,,304,535,.568,119,225,.529,291,432,723,69,63,79,148,274,727,1992/1993
"Davis,Hubert",110,251,.438,6,19,.316,104,232,.448,43,54,.796,13,43,56,83,22,45,4,71,269,1992/1993
"Davis,Terry",393,863,.455,2,8,.250,391,855,.457,167,281,.594,259,442,701,68,36,160,28,199,955,1992/1993
"Dawkins,Johnny",258,590,.437,26,84,.310,232,506,.458,113,142,.796,33,103,136,339,80,121,4,91,655,1992/1993
"Day,Todd",358,828,.432,54,184,.293,304,644,.472,213,297,.717,144,147,291,117,75,118,48,222,983,1992/1993
"Del Negro,Vinny",218,430,.507,6,24,.250,212,406,.522,101,117,.863,19,144,163,291,44,92,1,146,543,1992/1993
"Dele,Bison",40,78,.513,0,1,.000,40,77,.519,16,20,.800,24,32,56,5,14,25,17,48,96,1992/1993
"Divac,Vlade",397,819,.485,21,75,.280,376,744,.505,235,341,.689,220,509,729,232,128,214,140,311,1050,1992/1993
"Donaldson,James",8,14,.571,0,0,,8,14,.571,5,9,.556,6,23,29,1,1,4,7,13,21,1992/1993
"Douglas,Sherman",264,530,.498,6,29,.207,258,501,.515,84,150,.560,65,97,162,508,49,161,10,166,618,1992/1993
"Dreiling,Greg",19,58,.328,0,4,.000,19,54,.352,8,15,.533,26,40,66,8,5,9,8,60,46,1992/1993
"Drexler,Clyde",350,816,.429,31,133,.233,319,683,.467,245,292,.839,126,183,309,278,95,115,37,159,976,1992/1993
"Duckworth,Kevin",301,688,.438,0,2,.000,301,686,.439,127,174,.730,118,269,387,70,45,87,39,222,729,1992/1993
"Dudley,Chris",94,266,.353,0,0,,94,266,.353,57,110,.518,215,298,513,16,17,54,103,195,245,1992/1993
"Dumars,Joe",677,1454,.466,112,299,.375,565,1155,.489,343,397,.864,63,85,148,308,78,138,7,141,1809,1992/1993
"Dumas,Richard",302,576,.524,1,3,.333,301,573,.525,152,215,.707,100,123,223,60,85,92,39,127,757,1992/1993
"Durham,Pat",6,25,.240,0,0,,6,25,.240,9,12,.750,5,9,14,4,1,7,1,6,21,1992/1993
"Eaton,Mark",71,130,.546,0,0,,71,130,.546,35,50,.700,73,191,264,17,18,43,79,143,177,1992/1993
"Edwards,Blue",554,1083,.512,37,106,.349,517,977,.529,237,300,.790,123,259,382,214,129,175,45,242,1382,1992/1993
"Edwards,James",122,270,.452,0,0,,122,270,.452,84,118,.712,30,70,100,41,10,51,7,122,328,1992/1993
"Edwards,Kevin",216,462,.468,5,17,.294,211,445,.474,119,141,.844,48,73,121,120,68,75,12,69,556,1992/1993
"Ehlo,Craig",385,785,.490,93,244,.381,292,541,.540,86,120,.717,113,290,403,254,104,124,22,170,949,1992/1993
"Elie,Mario",240,524,.458,45,129,.349,195,395,.494,183,214,.855,59,157,216,177,74,89,20,145,708,1992/1993
"Elliott,Sean",451,918,.491,37,104,.356,414,814,.509,268,337,.795,85,237,322,265,68,152,28,132,1207,1992/1993
"Ellis,Dale",545,1092,.499,119,297,.401,426,795,.536,157,197,.797,81,231,312,107,78,111,18,179,1366,1992/1993
"Ellis,LaPhonso",483,958,.504,2,13,.154,481,945,.509,237,317,.748,274,470,744,151,72,153,111,293,1205,1992/1993
"Ellison,Pervis",341,655,.521,0,4,.000,341,651,.524,170,242,.702,138,295,433,117,45,110,108,154,852,1992/1993
"English,Jo Jo",3,10,.300,0,3,.000,3,7,.429,0,2,.000,2,4,6,1,3,4,2,5,6,1992/1993
"Ewing,Patrick",779,1550,.503,1,7,.143,778,1543,.504,400,556,.719,191,789,980,151,74,265,161,286,1959,1992/1993
"Ferrell,Duane",327,696,.470,9,36,.250,318,660,.482,176,226,.779,97,94,191,132,59,103,17,160,839,1992/1993
"Ferry,Danny",220,459,.479,34,82,.415,186,377,.493,99,113,.876,81,198,279,137,29,83,49,171,573,1992/1993
"Fleming,Vern",280,554,.505,7,36,.194,273,518,.527,143,197,.726,63,106,169,224,63,121,9,126,710,1992/1993
"Floyd,Sleepy",124,305,.407,16,56,.286,108,249,.434,81,102,.794,14,72,86,132,32,68,6,59,345,1992/1993
"Foster,Greg",55,120,.458,0,4,.000,55,116,.474,15,21,.714,32,51,83,21,3,25,14,58,125,1992/1993
"Foster,Greg",11,25,.440,0,0,,11,25,.440,2,3,.667,8,19,27,11,0,9,5,17,24,1992/1993
"Foster,Greg",44,95,.463,0,4,.000,44,91,.484,13,18,.722,24,32,56,10,3,16,9,41,101,1992/1993
"Fox,Rick",184,380,.484,4,23,.174,180,357,.504,81,101,.802,55,104,159,113,61,77,21,133,453,1992/1993
"Gamble,Kevin",459,906,.507,52,139,.374,407,767,.531,123,149,.826,46,200,246,226,86,81,37,185,1093,1992/1993
"Garland,Winston",152,343,.443,6,13,.462,146,330,.442,81,89,.910,32,76,108,138,39,67,4,116,391,1992/1993
"Gatling,Chris",249,462,.539,0,6,.000,249,456,.546,150,207,.725,129,191,320,40,44,102,53,197,648,1992/1993
"Gattison,Kenny",203,384,.529,0,3,.000,203,381,.533,102,169,.604,108,245,353,68,48,64,55,237,508,1992/1993
"Geiger,Matt",76,145,.524,0,4,.000,76,141,.539,62,92,.674,46,74,120,14,15,36,18,123,214,1992/1993
"George,Tate",51,135,.378,0,5,.000,51,130,.392,20,24,.833,9,18,27,59,10,31,3,25,122,1992/1993
"Gill,Kendall",463,1032,.449,17,62,.274,446,970,.460,224,290,.772,120,220,340,268,98,174,36,191,1167,1992/1993
"Gilliam,Armen",359,774,.464,0,1,.000,359,773,.464,274,325,.843,136,336,472,116,37,157,54,123,992,1992/1993
"Glass,Gerald",142,339,.419,7,33,.212,135,306,.441,25,39,.641,61,81,142,77,33,35,18,104,316,1992/1993
"Glass,Gerald",8,27,.296,0,2,.000,8,25,.320,4,6,.667,1,2,3,9,3,5,0,6,20,1992/1993
"Glass,Gerald",134,312,.429,7,31,.226,127,281,.452,21,33,.636,60,79,139,68,30,30,18,98,296,1992/1993
"Gminski,Mike",42,83,.506,0,0,,42,83,.506,9,10,.900,34,51,85,7,1,11,9,28,93,1992/1993
"Graham,Paul",256,560,.457,42,141,.298,214,419,.511,96,131,.733,61,129,190,164,86,120,6,185,650,1992/1993
"Grant,Gary",210,476,.441,11,42,.262,199,434,.459,55,74,.743,27,112,139,353,106,129,9,168,486,1992/1993
"Grant,Greg",77,220,.350,20,68,.294,57,152,.375,20,31,.645,24,43,67,206,43,54,1,73,194,1992/1993
"Grant,Harvey",560,1149,.487,1,10,.100,559,1139,.491,218,300,.727,133,279,412,205,72,90,44,168,1339,1992/1993
"Grant,Horace",421,829,.508,1,5,.200,420,824,.510,174,281,.619,341,388,729,201,89,110,96,218,1017,1992/1993
"Grayer,Jeff",165,353,.467,2,14,.143,163,339,.481,91,136,.669,71,86,157,70,31,54,8,120,423,1992/1993
"Green,A.C.",379,706,.537,16,46,.348,363,660,.550,277,375,.739,287,424,711,116,88,116,39,149,1051,1992/1993
"Green,Litterial",87,198,.439,1,10,.100,86,188,.457,60,96,.625,11,23,34,116,23,42,4,70,235,1992/1993
"Green,Sean",28,55,.509,3,10,.300,25,45,.556,3,4,.750,4,5,9,7,2,9,1,11,62,1992/1993
"Green,Sidney",34,89,.382,0,2,.000,34,87,.391,25,31,.806,32,86,118,24,6,20,5,37,93,1992/1993
"Green,Sidney",20,49,.408,0,0,,20,49,.408,13,15,.867,18,53,71,19,5,12,3,21,53,1992/1993
"Green,Sidney",14,40,.350,0,2,.000,14,38,.368,12,16,.750,14,33,47,5,1,8,2,16,40,1992/1993
"Gugliotta,Tom",484,1135,.426,38,135,.281,446,1000,.446,181,281,.644,219,562,781,306,134,230,35,195,1187,1992/1993
"Guidinger,Jay",19,55,.345,0,0,,19,55,.345,13,25,.520,26,38,64,17,9,10,10,48,51,1992/1993
"Hammonds,Tom",105,221,.475,0,1,.000,105,220,.477,38,62,.613,38,89,127,24,18,34,12,77,248,1992/1993
"Hammonds,Tom",19,45,.422,0,0,,19,45,.422,5,8,.625,5,26,31,8,0,3,4,20,43,1992/1993
"Hammonds,Tom",86,176,.489,0,1,.000,86,175,.491,33,54,.611,33,63,96,16,18,31,8,57,205,1992/1993
"Hardaway,Tim",522,1168,.447,102,309,.330,420,859,.489,273,367,.744,60,203,263,699,116,220,12,152,1419,1992/1993
"Harper,Derek",393,939,.419,101,257,.393,292,682,.428,239,316,.756,42,81,123,334,80,136,16,145,1126,1992/1993
"Harper,Ron",542,1203,.451,52,186,.280,490,1017,.482,307,399,.769,117,308,425,360,177,222,73,212,1443,1992/1993
"Hastings,Scott",57,112,.509,2,8,.250,55,104,.529,40,55,.727,44,93,137,34,12,29,8,115,156,1992/1993
"Hawkins,Hersey",551,1172,.470,122,307,.397,429,865,.496,419,487,.860,91,255,346,317,137,180,30,189,1643,1992/1993
"Henson,Steve",71,182,.390,37,80,.463,34,102,.333,34,40,.850,12,43,55,155,30,52,1,85,213,1992/1993
"Herrera,Carl",240,444,.541,0,2,.000,240,442,.543,125,176,.710,148,306,454,61,47,92,35,190,605,1992/1993
"Higgins,Rod",199,483,.412,43,133,.323,156,350,.446,130,151,.861,66,127,193,119,51,63,29,141,571,1992/1993
"Higgins,Sean",96,215,.447,13,37,.351,83,178,.466,35,47,.745,23,45,68,66,13,64,5,54,240,1992/1993
"Hill,Tyrone",251,494,.508,0,4,.000,251,490,.512,138,221,.624,255,499,754,68,41,92,40,320,640,1992/1993
"Hodge,Donald",161,400,.403,0,0,,161,400,.403,71,104,.683,93,201,294,75,33,90,37,204,393,1992/1993
"Hoppen,Dave",1,1,1.000,0,0,,1,1,1.000,0,2,.000,1,3,4,0,0,0,0,2,2,1992/1993
"Hornacek,Jeff",582,1239,.470,97,249,.390,485,990,.490,250,289,.865,84,258,342,548,131,222,21,203,1511,1992/1993
"Horry,Robert",323,682,.474,12,47,.255,311,635,.490,143,200,.715,113,279,392,191,80,156,83,210,801,1992/1993
"Houston,Byron",145,325,.446,2,7,.286,143,318,.450,129,194,.665,119,196,315,69,44,87,43,253,421,1992/1993
"Howard,Brian",183,414,.442,1,7,.143,182,407,.447,72,94,.766,66,146,212,67,55,68,34,217,439,1992/1993
"Howard,Stephen",35,93,.376,0,0,,35,93,.376,34,53,.642,26,34,60,10,15,23,12,58,104,1992/1993
"Humphries,Jay",287,659,.436,15,75,.200,272,584,.466,101,130,.777,40,103,143,317,101,132,11,236,690,1992/1993
"Irvin,Byron",9,18,.500,1,1,1.000,8,17,.471,3,6,.500,2,2,4,2,1,4,0,5,22,1992/1993
"Iuzzolino,Mike",221,478,.462,54,144,.375,167,334,.500,114,149,.765,31,109,140,328,49,129,6,101,610,1992/1993
"Jackson,Jaren",53,128,.414,2,5,.400,51,123,.415,23,27,.852,19,20,39,35,19,17,5,45,131,1992/1993
"Jackson,Jim",184,466,.395,21,73,.288,163,393,.415,68,92,.739,42,80,122,131,40,115,11,80,457,1992/1993
"Jackson,Mark",459,945,.486,22,82,.268,437,863,.506,241,300,.803,129,259,388,724,136,220,12,158,1181,1992/1993
"James,Henry",21,51,.412,3,13,.231,18,38,.474,22,26,.846,7,4,11,1,3,7,0,9,67,1992/1993
"James,Henry",20,45,.444,3,10,.300,17,35,.486,17,20,.850,6,4,10,1,3,7,0,9,60,1992/1993
"James,Henry",1,6,.167,0,3,.000,1,3,.333,5,6,.833,1,0,1,0,0,0,0,0,7,1992/1993
"Jennings,Keith",25,42,.595,5,9,.556,20,33,.606,14,18,.778,2,9,11,23,4,7,0,18,69,1992/1993
"Johnson,Avery",256,510,.502,0,8,.000,256,502,.510,144,182,.791,20,126,146,561,85,145,16,141,656,1992/1993
"Johnson,Buck",193,403,.479,0,3,.000,193,400,.483,92,126,.730,78,117,195,89,36,70,18,187,478,1992/1993
"Johnson,Dave",57,149,.383,3,14,.214,54,135,.400,40,59,.678,18,30,48,13,8,28,1,23,157,1992/1993
"Johnson,Eddie",463,991,.467,17,56,.304,446,935,.477,234,257,.911,124,148,272,135,36,134,4,173,1177,1992/1993
"Johnson,Frank",136,312,.436,1,12,.083,135,300,.450,59,76,.776,41,72,113,186,60,80,8,112,332,1992/1993
"Johnson,Kevin",282,565,.499,1,8,.125,281,557,.504,226,276,.819,30,74,104,384,85,151,19,100,791,1992/1993
"Johnson,Larry",728,1385,.526,18,71,.254,710,1314,.540,336,438,.767,281,583,864,353,53,227,27,187,1810,1992/1993
"Jones,Charles",33,63,.524,0,1,.000,33,62,.532,22,38,.579,87,190,277,42,38,38,77,144,88,1992/1993
"Jordan,Michael",992,2003,.495,81,230,.352,911,1773,.514,476,569,.837,135,387,522,428,221,207,61,188,2541,1992/1993
"Jordan,Thomas",18,41,.439,0,0,,18,41,.439,8,17,.471,5,14,19,3,3,12,5,14,44,1992/1993
"Keefe,Adam",188,376,.500,0,1,.000,188,375,.501,166,237,.700,171,261,432,80,57,100,16,195,542,1992/1993
"Kemp,Shawn",515,1047,.492,0,4,.000,515,1043,.494,358,503,.712,287,546,833,155,119,217,146,327,1388,1992/1993
"Kempton,Tim",19,48,.396,0,0,,19,48,.396,18,31,.581,12,27,39,19,4,16,4,30,56,1992/1993
"Kerr,Steve",53,122,.434,6,26,.231,47,96,.490,22,24,.917,5,40,45,70,10,27,1,36,134,1992/1993
"Kerr,Steve",5,10,.500,0,2,.000,5,8,.625,2,2,1.000,0,7,7,11,2,2,0,2,12,1992/1993
"Kerr,Steve",48,112,.429,6,24,.250,42,88,.477,20,22,.909,5,33,38,59,8,25,1,34,122,1992/1993
"Kersey,Jerome",281,642,.438,8,28,.286,273,614,.445,116,183,.634,126,280,406,121,80,84,41,181,686,1992/1993
"Kessler,Alec",57,122,.467,5,11,.455,52,111,.468,36,47,.766,25,66,91,14,4,21,12,63,155,1992/1993
"Kimble,Bo",14,33,.424,2,8,.250,12,25,.480,3,8,.375,3,8,11,5,1,6,0,10,33,1992/1993
"Kimbrough,Stan",2,6,.333,1,2,.500,1,4,.250,0,0,,0,0,0,1,1,0,0,1,5,1992/1993
"King,Bernard",91,177,.514,2,7,.286,89,170,.524,39,57,.684,35,41,76,18,11,21,3,53,223,1992/1993
"King,Rich",2,5,.400,0,0,,2,5,.400,2,2,1.000,1,4,5,1,0,3,0,1,6,1992/1993
"King,Stacey",160,340,.471,2,6,.333,158,334,.473,86,122,.705,105,102,207,71,26,70,20,128,408,1992/1993
"Kite,Greg",38,84,.452,0,1,.000,38,83,.458,13,24,.542,66,127,193,10,13,35,12,133,89,1992/1993
"Kleine,Joe",108,267,.404,0,6,.000,108,261,.414,41,58,.707,113,233,346,39,17,37,17,123,257,1992/1993
"Knight,Negele",124,317,.391,0,7,.000,124,310,.400,67,86,.779,28,36,64,145,23,73,4,66,315,1992/1993
"Kofoed,Bart",3,13,.231,0,1,.000,3,12,.250,11,14,.786,0,1,1,10,2,3,1,1,17,1992/1993
"Koncak,Jon",124,267,.464,3,8,.375,121,259,.467,24,50,.480,100,327,427,140,75,52,100,264,275,1992/1993
"Krystkowiak,Larry",198,425,.466,0,1,.000,198,424,.467,117,147,.796,74,205,279,68,42,62,13,181,513,1992/1993
"Laettner,Christian",503,1061,.474,4,40,.100,499,1021,.489,462,553,.835,171,537,708,223,105,275,83,290,1472,1992/1993
"Laimbeer,Bill",292,574,.509,10,27,.370,282,547,.516,93,104,.894,110,309,419,127,46,59,40,212,687,1992/1993
"Lane,Jerome",27,54,.500,0,0,,27,54,.500,5,20,.250,24,29,53,17,12,7,3,32,59,1992/1993
"Lang,Andrew",149,351,.425,1,5,.200,148,346,.428,87,114,.763,136,300,436,79,46,89,141,261,386,1992/1993
"Lee,Doug",2,7,.286,1,3,.333,1,4,.250,0,0,,0,2,2,5,0,3,1,7,5,1992/1993
"Legler,Tim",105,241,.436,22,65,.338,83,176,.472,57,71,.803,25,34,59,46,24,28,6,63,289,1992/1993
"Legler,Tim",1,3,.333,0,0,,1,3,.333,0,0,,0,1,1,0,0,0,0,0,2,1992/1993
"Legler,Tim",104,238,.437,22,65,.338,82,173,.474,57,71,.803,25,33,58,46,24,28,6,63,287,1992/1993
"Les,Jim",110,259,.425,66,154,.429,44,105,.419,42,50,.840,20,69,89,169,40,48,7,81,328,1992/1993
"Lewis,Reggie",663,1410,.470,14,60,.233,649,1350,.481,326,376,.867,88,259,347,298,118,133,77,248,1666,1992/1993
"Liberty,Marcus",252,620,.406,22,59,.373,230,561,.410,102,156,.654,131,204,335,105,64,79,21,143,628,1992/1993
"Lichti,Todd",124,276,.449,2,6,.333,122,270,.452,81,102,.794,35,67,102,52,28,49,11,60,331,1992/1993
"Lister,Alton",19,42,.452,0,0,,19,42,.452,7,13,.538,15,29,44,5,0,18,9,40,45,1992/1993
"Lohaus,Brad",283,614,.461,85,230,.370,198,384,.516,73,101,.723,59,217,276,127,47,93,74,178,724,1992/1993
"Long,Grant",397,847,.469,6,26,.231,391,821,.476,261,341,.765,197,371,568,182,104,133,31,264,1061,1992/1993
"Longley,Luc",133,292,.455,0,0,,133,292,.455,53,74,.716,71,169,240,51,47,88,77,169,319,1992/1993
"Lynch,Kevin",30,59,.508,0,1,.000,30,58,.517,26,38,.684,12,23,35,25,11,24,6,44,86,1992/1993
"Mack,Sam",47,118,.398,3,22,.136,44,96,.458,45,58,.776,18,30,48,15,14,22,5,44,142,1992/1993
"MacLean,Don",157,361,.435,3,6,.500,154,355,.434,90,111,.811,33,89,122,39,11,42,4,82,407,1992/1993
"Macon,Mark",158,381,.415,0,6,.000,158,375,.421,42,60,.700,33,70,103,126,69,72,3,135,358,1992/1993
"Mahorn,Rick",101,214,.472,1,3,.333,100,211,.474,88,110,.800,93,186,279,33,19,58,31,156,291,1992/1993
"Majerle,Dan",509,1096,.464,167,438,.381,342,658,.520,203,261,.778,120,263,383,311,138,133,33,180,1388,1992/1993
"Malone,Jeff",595,1205,.494,3,9,.333,592,1196,.495,236,277,.852,31,142,173,128,42,125,4,117,1429,1992/1993
"Malone,Karl",797,1443,.552,4,20,.200,793,1423,.557,619,836,.740,227,692,919,308,124,240,85,261,2217,1992/1993
"Malone,Moses",13,42,.310,0,0,,13,42,.310,24,31,.774,22,24,46,7,1,10,8,6,50,1992/1993
"Manning,Danny",702,1379,.509,8,30,.267,694,1349,.514,388,484,.802,198,322,520,207,108,230,101,323,1800,1992/1993
"Marčiulionis,Šarūnas",178,328,.543,3,15,.200,175,313,.559,162,213,.761,40,57,97,105,51,76,2,92,521,1992/1993
"Mason,Anthony",316,629,.502,0,0,,316,629,.502,199,292,.682,231,409,640,170,43,137,19,240,831,1992/1993
"Maxey,Marlon",93,169,.550,0,1,.000,93,168,.554,45,70,.643,66,98,164,12,11,38,18,75,231,1992/1993
"Maxwell,Vernon",349,858,.407,120,361,.332,229,497,.461,164,228,.719,29,192,221,297,86,140,8,124,982,1992/1993
"Mayberry,Lee",171,375,.456,43,110,.391,128,265,.483,39,68,.574,26,92,118,273,59,85,7,148,424,1992/1993
"Mays,Travis",129,309,.417,29,84,.345,100,225,.444,54,82,.659,20,33,53,72,21,51,3,59,341,1992/1993
"McCann,Bob",200,410,.488,0,2,.000,200,408,.490,95,152,.625,92,190,282,68,51,79,58,202,495,1992/1993
"McCloud,George",216,525,.411,58,181,.320,158,344,.459,75,102,.735,60,145,205,192,53,107,11,165,565,1992/1993
"McCray,Rodney",92,204,.451,2,5,.400,90,199,.452,36,52,.692,53,105,158,81,12,53,15,99,222,1992/1993
"McDaniel,Xavier",457,924,.495,6,22,.273,451,902,.500,191,241,.793,168,321,489,163,72,171,51,249,1111,1992/1993
"McHale,Kevin",298,649,.459,2,18,.111,296,631,.469,164,195,.841,95,263,358,73,16,92,59,126,762,1992/1993
"McKey,Derrick",387,780,.496,40,112,.357,347,668,.519,220,297,.741,121,206,327,197,105,152,58,208,1034,1992/1993
"McMillan,Nate",213,459,.464,25,65,.385,188,394,.477,95,134,.709,84,222,306,384,173,139,33,240,546,1992/1993
"Miller,Oliver",121,255,.475,0,3,.000,121,252,.480,71,100,.710,70,205,275,118,38,108,100,145,313,1992/1993
"Miller,Reggie",571,1193,.479,167,419,.399,404,774,.522,427,485,.880,67,191,258,262,120,145,26,182,1736,1992/1993
"Mills,Terry",494,1072,.461,10,36,.278,484,1036,.467,201,254,.791,176,296,472,111,44,142,50,282,1199,1992/1993
"Miner,Harold",292,615,.475,3,9,.333,289,606,.477,163,214,.762,74,73,147,73,34,92,8,130,750,1992/1993
"Mitchell,Sam",215,483,.445,4,23,.174,211,460,.459,150,185,.811,93,155,248,76,23,51,10,207,584,1992/1993
"Moore,Tracy",103,249,.414,23,67,.343,80,182,.440,53,61,.869,23,29,52,47,21,32,4,54,282,1992/1993
"Morris,Chris",436,907,.481,17,76,.224,419,831,.504,197,248,.794,227,227,454,106,144,119,52,171,1086,1992/1993
"Morris,Isaiah",26,57,.456,0,0,,26,57,.456,3,4,.750,6,6,12,4,3,8,1,14,55,1992/1993
"Mourning,Alonzo",572,1119,.511,0,3,.000,572,1116,.513,495,634,.781,263,542,805,76,27,236,271,286,1639,1992/1993
"Mullin,Chris",474,930,.510,60,133,.451,414,797,.519,183,226,.810,42,190,232,166,68,139,41,76,1191,1992/1993
"Murdock,Eric",438,936,.468,31,119,.261,407,817,.498,231,296,.780,95,189,284,603,174,207,7,177,1138,1992/1993
"Murray,Tracy",108,260,.415,21,70,.300,87,190,.458,35,40,.875,40,43,83,11,8,31,5,59,272,1992/1993
"Mustaf,Jerrod",57,130,.438,0,1,.000,57,129,.442,33,53,.623,29,54,83,10,14,22,11,40,147,1992/1993
"Mutombo,Dikembe",398,781,.510,0,0,,398,781,.510,335,492,.681,344,726,1070,147,43,216,287,284,1131,1992/1993
"Nance,Larry",533,971,.549,0,4,.000,533,967,.551,202,247,.818,184,484,668,223,54,107,198,223,1268,1992/1993
"Nealy,Ed",26,69,.377,8,27,.296,18,42,.429,9,12,.750,12,52,64,15,12,7,2,41,69,1992/1993
"Nealy,Ed",16,46,.348,7,22,.318,9,24,.375,7,10,.700,8,40,48,13,9,5,1,35,46,1992/1993
"Nealy,Ed",10,23,.435,1,5,.200,9,18,.500,2,2,1.000,4,12,16,2,3,2,1,6,23,1992/1993
"Newbern,Melvin",42,113,.372,1,8,.125,41,105,.390,34,60,.567,19,18,37,57,23,32,1,42,119,1992/1993
"Newman,Johnny",279,534,.522,12,45,.267,267,489,.546,194,240,.808,72,71,143,117,45,90,19,154,764,1992/1993
"Norman,Ken",498,975,.511,10,38,.263,488,937,.521,131,220,.595,209,362,571,165,59,125,58,156,1137,1992/1993
"O'Neal,Shaquille",733,1304,.562,0,2,.000,733,1302,.563,427,721,.592,342,780,1122,152,60,307,286,321,1893,1992/1993
"O'Sullivan,Dan",3,5,.600,0,0,,3,5,.600,3,4,.750,2,4,6,1,1,0,0,4,9,1992/1993
"O'Sullivan,Dan",2,3,.667,0,0,,2,3,.667,0,0,,2,2,4,0,0,0,0,1,4,1992/1993
"O'Sullivan,Dan",1,2,.500,0,0,,1,2,.500,3,4,.750,0,2,2,1,1,0,0,3,5,1992/1993
"Oakley,Charles",219,431,.508,0,1,.000,219,430,.509,127,176,.722,288,420,708,126,85,124,15,289,565,1992/1993
"Ogg,Alan",5,13,.385,0,0,,5,13,.385,3,4,.750,3,7,10,4,1,3,3,6,13,1992/1993
"Ogg,Alan",3,9,.333,0,0,,3,9,.333,2,2,1.000,1,5,6,4,1,3,3,6,8,1992/1993
"Ogg,Alan",2,4,.500,0,0,,2,4,.500,1,2,.500,2,2,4,0,0,0,0,0,5,1992/1993
"Olajuwon,Hakeem",848,1603,.529,0,8,.000,848,1595,.532,444,570,.779,283,785,1068,291,150,262,342,305,2140,1992/1993
"Othick,Matt",3,5,.600,2,4,.500,1,1,1.000,0,2,.000,1,1,2,7,1,4,0,7,8,1992/1993
"Overton,Doug",152,323,.471,3,13,.231,149,310,.481,59,81,.728,25,81,106,157,31,72,6,81,366,1992/1993
"Owens,Billy",247,493,.501,1,11,.091,246,482,.510,117,183,.639,108,156,264,144,35,106,28,105,612,1992/1993
"Pack,Robert",285,606,.470,1,8,.125,284,598,.475,239,311,.768,52,108,160,335,81,185,10,182,810,1992/1993
"Paddio,Gerald",71,159,.447,2,8,.250,69,151,.457,14,21,.667,17,33,50,33,14,16,6,24,158,1992/1993
"Palmer,Walter",27,57,.474,0,0,,27,57,.474,6,9,.667,12,32,44,5,1,10,5,29,60,1992/1993
"Parish,Robert",416,777,.535,0,0,,416,777,.535,162,235,.689,246,494,740,61,57,120,107,201,994,1992/1993
"Paxson,John",105,233,.451,19,41,.463,86,192,.448,17,20,.850,9,39,48,136,38,31,2,99,246,1992/1993
"Payne,Kenny",38,90,.422,4,18,.222,34,72,.472,4,4,1.000,4,20,24,18,5,7,2,15,84,1992/1993
"Payton,Gary",476,963,.494,7,34,.206,469,929,.505,151,196,.770,95,186,281,399,177,148,21,250,1110,1992/1993
"Peeler,Anthony",297,634,.468,46,118,.390,251,516,.486,162,206,.786,64,115,179,166,60,123,14,193,802,1992/1993
"Perdue,Will",137,246,.557,0,1,.000,137,245,.559,67,111,.604,103,184,287,74,22,74,47,139,341,1992/1993
"Perkins,Sam",381,799,.477,24,71,.338,357,728,.490,250,305,.820,163,361,524,156,60,108,82,225,1036,1992/1993
"Perkins,Sam",242,527,.459,5,29,.172,237,498,.476,184,222,.829,111,268,379,128,40,76,51,139,673,1992/1993
"Perkins,Sam",139,272,.511,19,42,.452,120,230,.522,66,83,.795,52,93,145,28,20,32,31,86,363,1992/1993
"Perry,Tim",287,613,.468,10,49,.204,277,564,.491,147,207,.710,154,255,409,126,40,123,91,159,731,1992/1993
"Person,Chuck",541,1248,.433,118,332,.355,423,916,.462,109,168,.649,98,335,433,343,67,219,30,198,1309,1992/1993
"Petrović,Dražen",587,1134,.518,75,167,.449,512,967,.529,315,362,.870,42,148,190,247,94,204,13,237,1564,1992/1993
"Phills,Bobby",38,82,.463,2,5,.400,36,77,.468,15,25,.600,6,11,17,10,10,18,2,19,93,1992/1993
"Pierce,Ricky",524,1071,.489,42,113,.372,482,958,.503,313,352,.889,58,134,192,220,100,160,7,167,1403,1992/1993
"Pinckney,Ed",10,24,.417,0,0,,10,24,.417,12,13,.923,14,29,43,1,4,8,7,13,32,1992/1993
"Pippen,Scottie",628,1327,.473,22,93,.237,606,1234,.491,232,350,.663,203,418,621,507,173,246,73,219,1510,1992/1993
"Plummer,Gary",106,228,.465,0,3,.000,106,225,.471,69,95,.726,53,120,173,40,14,78,11,141,281,1992/1993
"Polynice,Olden",210,429,.490,0,1,.000,210,428,.491,66,142,.465,181,237,418,29,31,54,21,126,486,1992/1993
"Porter,Terry",503,1108,.454,143,345,.414,360,763,.472,327,388,.843,58,258,316,419,101,199,10,122,1476,1992/1993
"Pressey,Paul",29,66,.439,0,4,.000,29,62,.468,21,27,.778,8,23,31,30,11,23,5,36,79,1992/1993
"Price,Brent",100,279,.358,8,48,.167,92,231,.398,54,68,.794,28,75,103,154,56,85,3,90,262,1992/1993
"Price,Mark",477,986,.484,122,293,.416,355,693,.512,289,305,.948,37,164,201,602,89,196,11,105,1365,1992/1993
"Pullard,Anthony",8,18,.444,0,0,,8,18,.444,1,3,.333,2,6,8,2,2,5,2,5,17,1992/1993
"Rambis,Kurt",67,129,.519,0,2,.000,67,127,.528,43,65,.662,77,150,227,53,43,42,18,122,177,1992/1993
"Rambis,Kurt",4,7,.571,0,0,,4,7,.571,1,2,.500,2,4,6,1,3,6,0,3,9,1992/1993
"Rambis,Kurt",63,122,.516,0,2,.000,63,120,.525,42,63,.667,75,146,221,52,40,36,18,119,168,1992/1993
"Randall,Mark",40,80,.500,1,8,.125,39,72,.542,16,26,.615,27,28,55,11,4,17,2,33,97,1992/1993
"Randall,Mark",0,1,.000,0,1,.000,0,0,,0,0,,0,0,0,1,0,1,0,1,0,1992/1993
"Randall,Mark",40,79,.506,1,7,.143,39,72,.542,16,26,.615,27,28,55,10,4,16,2,32,97,1992/1993
"Rasmussen,Blair",30,80,.375,2,6,.333,28,74,.378,9,13,.692,20,35,55,5,5,12,10,61,71,1992/1993
"Reid,J.R.",283,595,.476,0,5,.000,283,590,.480,214,280,.764,120,336,456,80,47,125,31,266,780,1992/1993
"Reid,J.R.",42,98,.429,0,1,.000,42,97,.433,43,58,.741,20,50,70,24,11,24,5,49,127,1992/1993
"Reid,J.R.",241,497,.485,0,4,.000,241,493,.489,171,222,.770,100,286,386,56,36,101,26,217,653,1992/1993
"Rice,Glen",582,1324,.440,148,386,.383,434,938,.463,242,295,.820,92,332,424,180,92,157,25,201,1554,1992/1993
"Richardson,Pooh",337,703,.479,3,29,.103,334,674,.496,92,124,.742,63,204,267,573,94,167,12,132,769,1992/1993
"Richmond,Mitch",371,782,.474,48,130,.369,323,652,.495,197,233,.845,18,136,154,221,53,130,9,137,987,1992/1993
"Rivers,Doc",216,494,.437,39,123,.317,177,371,.477,133,162,.821,26,166,192,405,123,114,9,215,604,1992/1993
"Roberts,Fred",226,428,.528,12,29,.414,214,399,.536,135,169,.799,91,146,237,118,57,67,27,138,599,1992/1993
"Roberts,Stanley",375,711,.527,0,0,,375,711,.527,120,246,.488,181,297,478,59,34,121,141,332,870,1992/1993
"Robertson,Alvin",247,539,.458,40,122,.328,207,417,.496,84,128,.656,107,162,269,263,155,133,18,218,618,1992/1993
"Robertson,Alvin",139,290,.479,17,55,.309,122,235,.519,44,70,.629,47,90,137,156,90,77,9,120,339,1992/1993
"Robertson,Alvin",108,249,.434,23,67,.343,85,182,.467,40,58,.690,60,72,132,107,65,56,9,98,279,1992/1993
"Robinson,Clifford",632,1336,.473,19,77,.247,613,1259,.487,287,416,.690,165,377,542,182,98,173,163,287,1570,1992/1993
"Robinson,David",676,1348,.501,3,17,.176,673,1331,.506,561,766,.732,229,727,956,301,127,241,264,239,1916,1992/1993
"Robinson,Larry",6,16,.375,0,1,.000,6,15,.400,3,5,.600,1,2,3,3,1,1,1,0,15,1992/1993
"Robinson,Rumeal",270,638,.423,20,56,.357,250,582,.430,112,195,.574,49,110,159,323,96,140,12,169,672,1992/1993
"Rodman,Dennis",183,429,.427,15,73,.205,168,356,.472,87,163,.534,367,765,1132,102,48,103,45,201,468,1992/1993
"Rollins,Tree",11,41,.268,0,2,.000,11,39,.282,9,12,.750,12,48,60,10,6,9,15,43,31,1992/1993
"Rooks,Sean",368,747,.493,0,2,.000,368,745,.494,234,389,.602,196,340,536,95,38,160,81,204,970,1992/1993
"Royal,Donald",194,391,.496,0,3,.000,194,388,.500,318,390,.815,116,179,295,80,36,113,25,179,706,1992/1993
"Rudd,Delaney",7,36,.194,1,11,.091,6,25,.240,11,14,.786,4,5,9,17,1,11,0,7,26,1992/1993
"Ruland,Jeff",5,11,.455,0,0,,5,11,.455,2,4,.500,9,9,18,2,2,6,0,16,12,1992/1993
"Salley,John",154,307,.502,0,0,,154,307,.502,115,144,.799,113,200,313,83,32,101,70,192,423,1992/1993
"Sanders,Jeff",10,25,.400,0,0,,10,25,.400,4,8,.500,12,17,29,6,8,11,1,16,24,1992/1993
"Sanders,Mike",197,396,.497,1,4,.250,196,392,.500,59,78,.756,52,118,170,75,39,57,30,150,454,1992/1993
"Schayes,Danny",105,263,.399,0,3,.000,105,260,.404,112,137,.818,72,177,249,78,36,65,36,148,322,1992/1993
"Scheffler,Steve",25,48,.521,0,0,,25,48,.521,16,24,.667,15,21,36,5,6,5,1,37,66,1992/1993
"Schintzius,Dwayne",2,7,.286,0,0,,2,7,.286,3,3,1.000,2,6,8,2,2,0,2,4,7,1992/1993
"Schrempf,Detlef",517,1085,.476,8,52,.154,509,1033,.493,525,653,.804,210,570,780,493,79,243,27,305,1567,1992/1993
"Scott,Byron",296,659,.449,44,135,.326,252,524,.481,156,184,.848,27,107,134,157,55,70,13,98,792,1992/1993
"Scott,Dennis",329,763,.431,108,268,.403,221,495,.446,92,117,.786,38,148,186,136,57,104,18,131,858,1992/1993
"Sealy,Malik",136,319,.426,7,31,.226,129,288,.448,51,74,.689,60,52,112,47,36,58,7,74,330,1992/1993
"Seikaly,Rony",417,868,.480,1,8,.125,416,860,.484,397,540,.735,259,587,846,100,38,203,83,260,1232,1992/1993
"Sellers,Brad",49,130,.377,0,1,.000,49,129,.380,37,39,.949,27,56,83,46,6,27,11,40,135,1992/1993
"Shackleford,Charles",80,164,.488,0,2,.000,80,162,.494,31,49,.633,65,140,205,26,13,36,25,92,191,1992/1993
"Shaw,Brian",197,501,.393,43,130,.331,154,371,.415,61,78,.782,70,187,257,235,48,96,19,163,498,1992/1993
"Simmons,Lionel",468,1055,.444,1,11,.091,467,1044,.447,298,364,.819,156,339,495,312,95,196,38,197,1235,1992/1993
"Skiles,Scott",416,891,.467,80,235,.340,336,656,.512,289,324,.892,52,238,290,735,86,267,2,244,1201,1992/1993
"Smith,Charles",358,764,.469,0,2,.000,358,762,.470,287,367,.782,170,262,432,142,48,155,96,254,1003,1992/1993
"Smith,Chris",125,289,.433,2,14,.143,123,275,.447,95,120,.792,32,64,96,196,48,68,16,96,347,1992/1993
"Smith,Doug",289,666,.434,0,4,.000,289,662,.437,56,74,.757,96,232,328,104,48,115,52,280,634,1992/1993
"Smith,Kenny",387,744,.520,96,219,.438,291,525,.554,195,222,.878,28,132,160,446,80,163,7,110,1065,1992/1993
"Smith,LaBradford",261,570,.458,8,23,.348,253,547,.463,109,127,.858,26,80,106,186,58,103,9,178,639,1992/1993
"Smith,Larry",38,87,.437,0,0,,38,87,.437,9,22,.409,103,165,268,28,23,39,16,133,85,1992/1993
"Smith,Reggie",10,27,.370,0,1,.000,10,26,.385,3,14,.214,15,6,21,1,4,4,1,16,23,1992/1993
"Smith,Steve",279,619,.451,53,132,.402,226,487,.464,155,197,.787,56,141,197,267,50,129,16,148,766,1992/1993
"Smith,Tony",133,275,.484,2,11,.182,131,264,.496,62,82,.756,46,41,87,63,50,40,7,72,330,1992/1993
"Smits,Rik",494,1017,.486,0,0,,494,1017,.486,167,228,.732,126,306,432,121,27,147,75,285,1155,1992/1993
"Spencer,Andre",73,163,.448,0,2,.000,73,161,.453,41,54,.759,38,43,81,24,17,26,7,64,187,1992/1993
"Spencer,Andre",0,3,.000,0,0,,0,3,.000,0,0,,0,1,1,0,2,2,0,3,0,1992/1993
"Spencer,Andre",73,160,.456,0,2,.000,73,158,.462,41,54,.759,38,42,80,24,15,24,7,61,187,1992/1993
"Spencer,Elmore",44,82,.537,0,0,,44,82,.537,16,32,.500,17,45,62,8,8,26,18,54,104,1992/1993
"Spencer,Felton",105,226,.465,0,0,,105,226,.465,83,127,.654,134,190,324,17,23,70,66,243,293,1992/1993
"Sprewell,Latrell",449,968,.464,73,198,.369,376,770,.488,211,283,.746,79,192,271,295,126,203,52,166,1182,1992/1993
"Starks,John",513,1199,.428,108,336,.321,405,863,.469,263,331,.795,54,150,204,404,91,173,12,234,1397,1992/1993
"Stevens,Barry",1,2,.500,0,0,,1,2,.500,0,0,,2,0,2,0,0,0,0,1,2,1992/1993
"Stewart,Larry",306,564,.543,0,2,.000,306,562,.544,184,253,.727,154,229,383,146,47,153,29,191,796,1992/1993
"Stith,Bryant",124,278,.446,0,4,.000,124,274,.453,99,119,.832,39,85,124,49,24,44,5,82,347,1992/1993
"Stivrins,Alex",19,39,.487,0,2,.000,19,37,.514,3,4,.750,7,12,19,3,2,7,2,11,41,1992/1993
"Stivrins,Alex",11,18,.611,0,1,.000,11,17,.647,0,0,,2,6,8,1,1,5,1,7,22,1992/1993
"Stivrins,Alex",0,1,.000,0,0,,0,1,.000,0,0,,0,0,0,0,0,0,0,0,0,1992/1993
"Stivrins,Alex",4,11,.364,0,0,,4,11,.364,3,4,.750,3,3,6,2,1,2,0,4,11,1992/1993
"Stivrins,Alex",4,9,.444,0,1,.000,4,8,.500,0,0,,2,3,5,0,0,0,1,0,8,1992/1993
"Stockton,John",437,899,.486,72,187,.385,365,712,.513,293,367,.798,64,173,237,987,199,266,21,224,1239,1992/1993
"Strickland,Rod",396,816,.485,4,30,.133,392,786,.499,273,381,.717,120,217,337,559,131,199,24,153,1069,1992/1993
"Strong,Derek",42,92,.457,4,8,.500,38,84,.452,68,85,.800,40,75,115,14,11,13,1,20,156,1992/1993
"Strothers,Lamont",20,61,.328,2,13,.154,18,48,.375,8,10,.800,8,6,14,13,8,15,0,13,50,1992/1993
"Teagle,Terry",2,7,.286,0,0,,2,7,.286,1,2,.500,0,3,3,2,0,1,0,1,5,1992/1993
"Thomas,Isiah",526,1258,.418,61,198,.308,465,1060,.439,278,377,.737,71,161,232,671,123,284,18,222,1391,1992/1993
"Thompson,LaSalle",104,213,.488,0,1,.000,104,212,.491,29,39,.744,55,123,178,34,29,47,24,137,237,1992/1993
"Thorpe,Otis",385,690,.558,0,2,.000,385,688,.560,153,256,.598,219,370,589,181,43,151,19,234,923,1992/1993
"Threatt,Sedale",522,1028,.508,14,53,.264,508,975,.521,177,215,.823,47,226,273,564,142,173,11,248,1235,1992/1993
"Tisdale,Wayman",544,1068,.509,0,2,.000,544,1066,.510,175,231,.758,127,373,500,108,52,117,47,277,1263,1992/1993
"Tolbert,Tom",226,454,.498,9,28,.321,217,426,.509,122,168,.726,133,279,412,91,33,124,21,192,583,1992/1993
"Tucker,Trent",143,295,.485,52,131,.397,91,164,.555,18,22,.818,16,55,71,82,24,18,6,65,356,1992/1993
"Turner,Jeff",231,437,.529,10,17,.588,221,420,.526,56,70,.800,74,178,252,107,19,66,9,192,528,1992/1993
"Vandeweghe,Kiki",92,203,.453,12,37,.324,80,166,.482,58,66,.879,12,36,48,25,13,20,7,45,254,1992/1993
"Vaught,Loy",313,616,.508,1,4,.250,312,612,.510,116,155,.748,164,328,492,54,55,83,39,172,743,1992/1993
"Vētra,Gundars",19,40,.475,3,3,1.000,16,37,.432,4,6,.667,4,4,8,6,2,2,0,12,45,1992/1993
"Walker,Darrell",34,96,.354,0,1,.000,34,95,.358,12,26,.462,22,36,58,53,33,25,2,63,80,1992/1993
"Walker,Darrell",3,19,.158,0,1,.000,3,18,.167,2,6,.333,4,15,19,9,10,13,0,12,8,1992/1993
"Walker,Darrell",31,77,.403,0,0,,31,77,.403,10,20,.500,18,21,39,44,23,12,2,51,72,1992/1993
"Washington,Duane",0,5,.000,0,0,,0,5,.000,0,0,,0,2,2,5,1,2,0,2,0,1992/1993
"Weatherspoon,Clarence",494,1053,.469,1,4,.250,493,1049,.470,291,408,.713,179,410,589,147,85,176,67,188,1280,1992/1993
"Webb,Marcus",13,25,.520,0,1,.000,13,24,.542,13,21,.619,5,5,10,2,1,5,2,11,39,1992/1993
"Webb,Spud",342,789,.433,37,135,.274,305,654,.466,279,328,.851,44,149,193,481,104,194,6,177,1000,1992/1993
"Werdann,Robert",18,59,.305,0,1,.000,18,58,.310,17,31,.548,23,29,52,7,6,12,4,38,53,1992/1993
"West,Doug",646,1249,.517,2,23,.087,644,1226,.525,249,296,.841,89,158,247,235,85,165,21,279,1543,1992/1993
"West,Mark",175,285,.614,0,0,,175,285,.614,86,166,.518,153,305,458,29,16,93,103,243,436,1992/1993
"White,Randy",235,540,.435,10,42,.238,225,498,.452,138,184,.750,154,216,370,49,63,108,45,226,618,1992/1993
"Wiley,Morlon",96,254,.378,54,154,.351,42,100,.420,17,26,.654,29,62,91,181,65,80,3,127,263,1992/1993
"Wiley,Morlon",26,81,.321,15,51,.294,11,30,.367,5,8,.625,9,26,35,81,26,29,2,49,72,1992/1993
"Wiley,Morlon",70,173,.405,39,103,.379,31,70,.443,12,18,.667,20,36,56,100,39,51,1,78,191,1992/1993
"Wilkins,Dominique",741,1584,.468,120,316,.380,621,1268,.490,519,627,.828,187,295,482,227,70,184,27,116,2121,1992/1993
"Wilkins,Eddie Lee",55,97,.567,0,2,.000,55,95,.579,48,78,.615,14,26,40,2,7,17,1,34,158,1992/1993
"Wilkins,Gerald",361,797,.453,16,58,.276,345,739,.467,152,181,.840,74,140,214,183,78,94,18,154,890,1992/1993
"Williams,Buck",270,528,.511,0,1,.000,270,527,.512,138,214,.645,232,458,690,75,81,101,61,270,678,1992/1993
"Williams,Corey",31,85,.365,1,3,.333,30,82,.366,18,22,.818,19,12,31,23,4,11,2,24,81,1992/1993
"Williams,Herb",72,175,.411,0,0,,72,175,.411,14,21,.667,44,102,146,19,21,22,28,78,158,1992/1993
"Williams,Hot Rod",263,560,.470,0,0,,263,560,.470,212,296,.716,127,288,415,152,48,116,105,171,738,1992/1993
"Williams,Jayson",21,46,.457,0,0,,21,46,.457,7,18,.389,22,19,41,0,4,8,4,24,49,1992/1993
"Williams,John",205,477,.430,12,53,.226,193,424,.455,70,129,.543,88,228,316,142,83,79,23,188,492,1992/1993
"Williams,Kenny",150,282,.532,0,3,.000,150,279,.538,48,68,.706,102,126,228,38,21,28,45,87,348,1992/1993
"Williams,Lorenzo",17,36,.472,0,0,,17,36,.472,2,7,.286,17,38,55,5,5,8,17,29,36,1992/1993
"Williams,Lorenzo",1,3,.333,0,0,,1,3,.333,0,0,,3,6,9,0,0,2,2,4,2,1992/1993
"Williams,Lorenzo",0,2,.000,0,0,,0,2,.000,0,0,,1,1,2,0,1,0,1,2,0,1992/1993
"Williams,Lorenzo",16,31,.516,0,0,,16,31,.516,2,7,.286,13,31,44,5,4,6,14,23,34,1992/1993
"Williams,Micheal",353,791,.446,26,107,.243,327,684,.478,419,462,.907,84,189,273,661,165,227,23,268,1151,1992/1993
"Williams,Reggie",535,1167,.458,33,122,.270,502,1045,.480,238,296,.804,132,296,428,295,126,194,76,284,1341,1992/1993
"Williams,Scott",166,356,.466,0,7,.000,166,349,.476,90,126,.714,168,283,451,68,55,73,66,230,422,1992/1993
"Williams,Walt",358,823,.435,61,191,.319,297,632,.470,224,302,.742,115,150,265,178,66,179,29,209,1001,1992/1993
"Willis,Kevin",616,1218,.506,7,29,.241,609,1189,.512,196,300,.653,335,693,1028,165,68,213,41,264,1435,1992/1993
"Winchester,Kennard",61,139,.439,4,19,.211,57,120,.475,17,22,.773,17,32,49,13,10,15,10,40,143,1992/1993
"Wingate,David",180,336,.536,1,6,.167,179,330,.542,79,107,.738,49,125,174,183,66,89,9,135,440,1992/1993
"Wolf,Joe",20,44,.455,0,1,.000,20,43,.465,13,16,.813,14,34,48,5,7,7,1,24,53,1992/1993
"Wolf,Joe",0,1,.000,0,0,,0,1,.000,1,2,.500,1,2,3,0,0,2,1,2,1,1992/1993
"Wolf,Joe",20,43,.465,0,1,.000,20,42,.476,12,14,.857,13,32,45,5,7,5,0,22,52,1992/1993
"Wood,David",52,117,.444,5,21,.238,47,96,.490,46,55,.836,38,59,97,34,13,29,12,93,155,1992/1993
"Woods,Randy",23,66,.348,3,14,.214,20,52,.385,19,26,.731,6,8,14,40,14,16,1,26,68,1992/1993
"Woolridge,Orlando",289,599,.482,0,9,.000,289,590,.490,120,177,.678,87,98,185,115,27,79,27,122,698,1992/1993
"Woolridge,Orlando",271,566,.479,0,9,.000,271,557,.487,113,168,.673,84,92,176,112,26,73,25,114,655,1992/1993
"Woolridge,Orlando",18,33,.545,0,0,,18,33,.545,7,9,.778,3,6,9,3,1,6,2,8,43,1992/1993
"Worthy,James",510,1142,.447,30,111,.270,480,1031,.466,171,211,.810,73,174,247,278,92,137,27,87,1221,1992/1993
"Wright,Howard",4,5,.800,0,0,,4,5,.800,0,2,.000,1,1,2,0,0,0,0,0,8,1992/1993
"Young,Danny",69,167,.413,22,68,.324,47,99,.475,28,32,.875,13,34,47,119,31,30,5,36,188,1992/1993
"Abdelnaby,Alaa",24,55,.436,0,0,,24,55,.436,16,25,.640,12,34,46,3,2,17,3,20,64,1993/1994
"Abdul-Rauf,Mahmoud",588,1279,.460,42,133,.316,546,1146,.476,219,229,.956,27,141,168,362,82,151,10,150,1437,1993/1994
"Adams,Michael",285,698,.408,55,191,.288,230,507,.454,224,270,.830,37,146,183,480,96,167,6,140,849,1993/1994
"Aguirre,Mark",163,348,.468,37,93,.398,126,255,.494,50,72,.694,28,88,116,104,21,70,8,98,413,1993/1994
"Ainge,Danny",224,537,.417,80,244,.328,144,293,.491,78,94,.830,28,103,131,180,57,81,8,140,606,1993/1994
"Alexander,Gary",8,14,.571,0,0,,8,14,.571,3,9,.333,7,8,15,2,3,8,0,10,19,1993/1994
"Alexander,Gary",1,2,.500,0,0,,1,2,.500,0,2,.000,1,2,3,1,0,1,0,3,2,1993/1994
"Alexander,Gary",7,12,.583,0,0,,7,12,.583,3,7,.429,6,6,12,1,3,7,0,7,17,1993/1994
"Alexander,Victor",266,502,.530,2,13,.154,264,489,.540,68,129,.527,114,194,308,66,28,86,32,168,602,1993/1994
"Anderson,Eric",7,17,.412,2,2,1.000,5,15,.333,5,14,.357,6,11,17,2,0,2,1,9,21,1993/1994
"Anderson,Greg",201,370,.543,1,3,.333,200,367,.545,88,154,.571,183,388,571,51,55,94,68,234,491,1993/1994
"Anderson,Kenny",576,1381,.417,40,132,.303,536,1249,.429,346,423,.818,89,233,322,784,158,266,15,201,1538,1993/1994
"Anderson,Nick",504,1054,.478,101,314,.322,403,740,.545,168,250,.672,113,363,476,294,134,165,33,148,1277,1993/1994
"Anderson,Ron",35,86,.407,7,26,.269,28,60,.467,19,23,.826,16,37,53,17,8,10,3,16,96,1993/1994
"Anderson,Ron",15,43,.349,4,12,.333,11,31,.355,10,12,.833,8,18,26,6,5,1,2,9,44,1993/1994
"Anderson,Ron",20,43,.465,3,14,.214,17,29,.586,9,11,.818,8,19,27,11,3,9,1,7,52,1993/1994
"Anderson,Willie",394,837,.471,22,68,.324,372,769,.484,145,171,.848,68,174,242,347,71,153,46,187,955,1993/1994
"Anthony,Greg",225,571,.394,48,160,.300,177,411,.431,130,168,.774,43,146,189,365,114,127,13,163,628,1993/1994
"Armstrong,B.J.",479,1007,.476,60,135,.444,419,872,.481,194,227,.855,28,142,170,323,80,131,9,147,1212,1993/1994
"Askew,Vincent",273,567,.481,6,31,.194,267,536,.498,175,211,.829,60,124,184,194,73,70,19,145,727,1993/1994
"Askins,Keith",36,88,.409,4,21,.190,32,67,.478,9,10,.900,33,49,82,13,11,21,1,57,85,1993/1994
"Augmon,Stacey",439,861,.510,1,7,.143,438,854,.513,333,436,.764,178,216,394,187,149,147,45,179,1212,1993/1994
"Austin,Isaac",29,66,.439,0,1,.000,29,65,.446,14,23,.609,25,44,69,17,5,17,10,29,72,1993/1994
"Avent,Anthony",150,398,.377,0,0,,150,398,.377,89,123,.724,144,194,338,65,33,85,31,147,389,1993/1994
"Avent,Anthony",92,228,.404,0,0,,92,228,.404,61,79,.772,60,94,154,33,16,43,20,60,245,1993/1994
"Avent,Anthony",58,170,.341,0,0,,58,170,.341,28,44,.636,84,100,184,32,17,42,11,87,144,1993/1994
"Bagley,John",0,2,.000,0,0,,0,2,.000,2,2,1.000,0,1,1,3,0,0,0,2,2,1993/1994
"Bailey,Thurl",232,455,.510,0,2,.000,232,453,.512,119,149,.799,66,149,215,54,20,58,58,93,583,1993/1994
"Baker,Vin",435,869,.501,1,5,.200,434,864,.502,234,411,.569,277,344,621,163,60,162,114,231,1105,1993/1994
"Barkley,Charles",518,1046,.495,48,178,.270,470,868,.541,318,452,.704,198,529,727,296,101,206,37,160,1402,1993/1994
"Barros,Dana",412,878,.469,135,354,.381,277,524,.529,116,145,.800,28,168,196,424,107,167,5,96,1075,1993/1994
"Barry,Jon",158,382,.414,32,115,.278,126,267,.472,97,122,.795,36,110,146,168,102,83,17,110,445,1993/1994
"Battle,John",130,273,.476,5,19,.263,125,254,.492,73,97,.753,7,32,39,83,22,41,1,66,338,1993/1994
"Benjamin,Benoit",283,589,.480,0,0,,283,589,.480,152,214,.710,135,364,499,44,35,97,90,198,718,1993/1994
"Bennett,Tony",105,263,.399,27,75,.360,78,188,.415,11,15,.733,16,74,90,163,39,40,1,84,248,1993/1994
"Benoit,David",139,361,.385,12,59,.203,127,302,.421,68,88,.773,89,171,260,23,23,37,37,115,358,1993/1994
"Blackman,Rolando",161,369,.436,30,84,.357,131,285,.460,48,53,.906,23,70,93,76,25,44,6,100,400,1993/1994
"Blaylock,Mookie",444,1079,.411,114,341,.334,330,738,.447,116,159,.730,117,307,424,789,212,196,44,144,1118,1993/1994
"Blount,Corie",76,174,.437,0,0,,76,174,.437,46,75,.613,76,118,194,56,19,52,33,93,198,1993/1994
"Bogues,Muggsy",354,751,.471,2,12,.167,352,739,.476,125,155,.806,78,235,313,780,133,171,2,147,835,1993/1994
"Bol,Manute",4,19,.211,0,3,.000,4,16,.250,0,0,,3,15,18,1,2,5,16,13,8,1993/1994
"Bol,Manute",1,12,.083,0,3,.000,1,9,.111,0,0,,1,10,11,0,0,5,6,4,2,1993/1994
"Bol,Manute",0,0,,0,0,,0,0,,0,0,,0,1,1,1,0,0,1,1,0,1993/1994
"Bol,Manute",3,7,.429,0,0,,3,7,.429,0,0,,2,4,6,0,2,0,9,8,6,1993/1994
"Bond,Walter",63,156,.404,19,54,.352,44,102,.431,31,40,.775,20,41,61,31,16,17,12,90,176,1993/1994
"Bonner,Anthony",162,288,.563,0,0,,162,288,.563,50,105,.476,150,194,344,88,76,89,13,175,374,1993/1994
"Bowie,Anthony",139,289,.481,1,18,.056,138,271,.509,41,49,.837,29,91,120,102,32,58,12,81,320,1993/1994
"Bowie,Sam",75,172,.436,1,4,.250,74,168,.440,72,83,.867,27,104,131,47,4,43,28,65,223,1993/1994
"Bradley,Shawn",201,491,.409,0,3,.000,201,488,.412,102,168,.607,98,208,306,98,45,148,147,170,504,1993/1994
"Brandon,Terrell",230,548,.420,7,32,.219,223,516,.432,139,162,.858,38,121,159,277,84,111,16,108,606,1993/1994
"Breuer,Randy",8,26,.308,0,1,.000,8,25,.320,3,14,.214,15,41,56,8,6,9,19,30,19,1993/1994
"Brickowski,Frank",368,754,.488,4,20,.200,364,734,.496,195,254,.768,85,319,404,222,80,181,27,242,935,1993/1994
"Brickowski,Frank",251,521,.482,3,18,.167,248,503,.493,148,191,.775,53,226,279,165,52,125,16,165,653,1993/1994
"Brickowski,Frank",117,233,.502,1,2,.500,116,231,.502,47,63,.746,32,93,125,57,28,56,11,77,282,1993/1994
"Brooks,Kevin",36,99,.364,4,23,.174,32,76,.421,9,10,.900,5,16,21,3,0,12,2,19,85,1993/1994
"Brooks,Scott",142,289,.491,23,61,.377,119,228,.522,74,85,.871,10,92,102,149,51,55,2,98,381,1993/1994
"Brown,Chucky",1,1,1.000,0,0,,1,1,1.000,1,1,1.000,0,1,1,0,0,0,0,2,3,1993/1994
"Brown,Dee",490,1021,.480,30,96,.313,460,925,.497,182,219,.831,63,237,300,347,156,126,47,207,1192,1993/1994
"Brown,Mike",111,260,.427,0,2,.000,111,258,.430,77,118,.653,119,328,447,72,51,75,29,218,299,1993/1994
"Brown,P.J.",167,402,.415,1,6,.167,166,396,.419,115,152,.757,188,305,493,93,71,72,93,177,450,1993/1994
"Brown,Randy",110,251,.438,0,4,.000,110,247,.445,53,87,.609,40,72,112,133,63,75,14,132,273,1993/1994
"Bryant,Mark",185,384,.482,0,1,.000,185,383,.483,72,104,.692,117,198,315,37,32,66,29,187,442,1993/1994
"Buechler,Jud",42,84,.500,12,29,.414,30,55,.545,10,20,.500,13,19,32,16,8,12,1,24,106,1993/1994
"Bullard,Matt",78,226,.345,50,154,.325,28,72,.389,20,26,.769,23,61,84,64,14,28,6,67,226,1993/1994
"Burns,Evers",22,55,.400,0,0,,22,55,.400,12,23,.522,13,17,30,9,6,7,3,33,56,1993/1994
"Burrell,Scott",98,234,.419,2,6,.333,96,228,.421,46,70,.657,46,86,132,62,37,45,16,88,244,1993/1994
"Burton,Willie",124,283,.438,3,15,.200,121,268,.451,120,158,.759,50,86,136,39,18,54,20,96,371,1993/1994
"Butler,Mitchell",207,418,.495,0,5,.000,207,413,.501,104,180,.578,106,119,225,77,54,87,20,131,518,1993/1994
"Cage,Michael",171,314,.545,0,1,.000,171,313,.546,36,74,.486,164,280,444,45,77,51,38,179,378,1993/1994
"Campbell,Elden",373,808,.462,0,2,.000,373,806,.463,188,273,.689,167,352,519,86,64,98,146,241,934,1993/1994
"Campbell,Tony",227,512,.443,7,28,.250,220,484,.455,94,120,.783,76,110,186,82,50,84,15,134,555,1993/1994
"Campbell,Tony",63,128,.492,1,3,.333,62,125,.496,30,37,.811,28,32,60,31,20,29,1,59,157,1993/1994
"Campbell,Tony",164,384,.427,6,25,.240,158,359,.440,64,83,.771,48,78,126,51,30,55,14,75,398,1993/1994
"Carr,Antoine",78,160,.488,0,1,.000,78,159,.491,42,58,.724,12,39,51,15,9,15,22,75,198,1993/1994
"Cartwright,Bill",98,191,.513,0,0,,98,191,.513,39,57,.684,43,109,152,57,8,50,8,83,235,1993/1994
"Cassell,Sam",162,388,.418,26,88,.295,136,300,.453,90,107,.841,25,109,134,192,59,94,7,136,440,1993/1994
"Causwell,Duane",71,137,.518,0,0,,71,137,.518,40,68,.588,68,118,186,11,19,33,49,109,182,1993/1994
"Ceballos,Cedric",425,795,.535,0,9,.000,425,786,.541,160,221,.724,153,191,344,91,59,93,23,124,1010,1993/1994
"Chambers,Tom",329,748,.440,14,45,.311,315,703,.448,221,281,.786,87,239,326,79,40,89,32,232,893,1993/1994
"Chapman,Rex",431,865,.498,64,165,.388,367,700,.524,168,206,.816,57,89,146,185,59,117,8,83,1094,1993/1994
"Cheaney,Calbert",327,696,.470,1,23,.043,326,673,.484,124,161,.770,88,102,190,126,63,108,10,148,779,1993/1994
"Chilcutt,Pete",203,448,.453,3,15,.200,200,433,.462,41,65,.631,129,242,371,86,53,74,39,164,450,1993/1994
"Chilcutt,Pete",152,328,.463,0,1,.000,152,327,.465,31,52,.596,100,171,271,71,43,56,28,116,335,1993/1994
"Chilcutt,Pete",51,120,.425,3,14,.214,48,106,.453,10,13,.769,29,71,100,15,10,18,11,48,115,1993/1994
"Christie,Doug",244,562,.434,39,119,.328,205,443,.463,145,208,.697,93,142,235,136,89,140,28,186,672,1993/1994
"Coleman,Ben",12,25,.480,0,0,,12,25,.480,4,8,.500,10,16,26,0,2,7,2,9,28,1993/1994
"Coleman,Derrick",541,1209,.447,38,121,.314,503,1088,.462,439,567,.774,262,608,870,262,68,208,142,209,1559,1993/1994
"Coles,Bimbo",233,519,.449,20,99,.202,213,420,.507,102,131,.779,50,109,159,263,75,107,12,132,588,1993/1994
"Conlon,Marty",95,165,.576,0,2,.000,95,163,.583,43,53,.811,53,86,139,34,9,33,8,69,233,1993/1994
"Conlon,Marty",66,109,.606,0,1,.000,66,108,.611,31,38,.816,34,55,89,28,5,23,7,36,163,1993/1994
"Conlon,Marty",29,56,.518,0,1,.000,29,55,.527,12,15,.800,19,31,50,6,4,10,1,33,70,1993/1994
"Conner,Lester",14,38,.368,0,3,.000,14,35,.400,3,6,.500,10,14,24,31,14,9,1,12,31,1993/1994
"Cook,Anthony",26,54,.481,0,1,.000,26,53,.491,10,25,.400,20,36,56,4,3,12,14,22,62,1993/1994
"Cook,Anthony",0,1,.000,0,0,,0,1,.000,0,0,,0,0,0,0,0,1,2,0,0,1993/1994
"Cook,Anthony",26,53,.491,0,1,.000,26,52,.500,10,25,.400,20,36,56,4,3,11,12,22,62,1993/1994
"Cooper,Duane",18,41,.439,1,7,.143,17,34,.500,11,15,.733,2,7,9,28,3,20,0,12,48,1993/1994
"Corbin,Tyrone",268,588,.456,6,29,.207,262,559,.469,117,144,.813,150,239,389,122,99,92,24,212,659,1993/1994
"Corchiani,Chris",40,94,.426,11,38,.289,29,56,.518,26,38,.684,8,36,44,86,22,38,2,47,117,1993/1994
"Courtney,Joe",67,148,.453,2,3,.667,65,145,.448,32,47,.681,28,28,56,15,10,21,12,44,168,1993/1994
"Courtney,Joe",40,78,.513,0,0,,40,78,.513,23,32,.719,14,13,27,9,3,10,6,23,103,1993/1994
"Courtney,Joe",27,70,.386,2,3,.667,25,67,.373,9,15,.600,14,15,29,6,7,11,6,21,65,1993/1994
"Crotty,John",45,99,.455,11,24,.458,34,75,.453,31,36,.861,11,20,31,77,15,27,1,36,132,1993/1994
"Cummings,Terry",183,428,.428,0,2,.000,183,426,.430,63,107,.589,132,165,297,50,31,59,13,137,429,1993/1994
"Cureton,Earl",2,8,.250,0,0,,2,8,.250,0,2,.000,4,8,12,0,0,1,0,4,4,1993/1994
"Curry,Dell",533,1171,.455,152,378,.402,381,793,.480,117,134,.873,71,191,262,221,98,120,27,161,1335,1993/1994
"Curry,Michael",3,14,.214,0,2,.000,3,12,.250,3,4,.750,0,1,1,1,1,3,0,6,9,1993/1994
"Daniels,Lloyd",140,372,.376,44,125,.352,96,247,.389,46,64,.719,45,66,111,94,29,60,16,69,370,1993/1994
"Daugherty,Brad",296,606,.488,0,0,,296,606,.488,256,326,.785,128,380,508,149,41,110,36,145,848,1993/1994
"Davis,Antonio",216,425,.508,0,1,.000,216,424,.509,194,302,.642,190,315,505,55,45,107,84,189,626,1993/1994
"Davis,Brian",40,126,.317,1,3,.333,39,123,.317,50,68,.735,21,34,55,22,16,19,4,34,131,1993/1994
"Davis,Dale",308,582,.529,0,1,.000,308,581,.530,155,294,.527,280,438,718,100,48,102,106,214,771,1993/1994
"Davis,Hubert",238,505,.471,53,132,.402,185,373,.496,85,103,.825,23,44,67,165,40,76,4,118,614,1993/1994
"Davis,Terry",24,59,.407,0,0,,24,59,.407,8,12,.667,30,44,74,6,9,5,1,27,56,1993/1994
"Dawkins,Johnny",177,423,.418,37,105,.352,140,318,.440,84,100,.840,28,95,123,263,63,111,5,74,475,1993/1994
"Day,Todd",351,845,.415,33,148,.223,318,697,.456,231,331,.698,115,195,310,138,103,129,52,221,966,1993/1994
"Dehere,Terry",129,342,.377,23,57,.404,106,285,.372,61,81,.753,25,43,68,78,28,61,3,69,342,1993/1994
"Del Negro,Vinny",309,634,.487,15,43,.349,294,591,.497,140,170,.824,27,134,161,320,64,102,1,168,773,1993/1994
"Dele,Bison",251,464,.541,0,3,.000,251,461,.544,137,211,.649,138,308,446,50,49,104,87,221,639,1993/1994
"Demps,Dell",2,6,.333,0,0,,2,6,.333,0,2,.000,0,0,0,1,2,1,0,1,4,1993/1994
"Divac,Vlade",453,895,.506,9,47,.191,444,848,.524,208,303,.686,282,569,851,307,92,191,112,288,1123,1993/1994
"Douglas,Sherman",425,919,.462,13,56,.232,412,863,.477,177,276,.641,70,123,193,683,89,233,11,171,1040,1993/1994
"Dreiling,Greg",52,104,.500,1,1,1.000,51,103,.495,27,38,.711,47,123,170,31,16,43,24,159,132,1993/1994
"Drexler,Clyde",473,1105,.428,71,219,.324,402,886,.454,286,368,.777,154,291,445,333,98,167,34,202,1303,1993/1994
"Duckworth,Kevin",184,441,.417,0,0,,184,441,.417,88,132,.667,103,222,325,56,37,101,35,223,456,1993/1994
"Dudley,Chris",6,25,.240,0,0,,6,25,.240,2,4,.500,16,8,24,5,4,2,3,18,14,1993/1994
"Dumars,Joe",505,1118,.452,124,320,.388,381,798,.477,276,330,.836,35,116,151,261,63,159,4,118,1410,1993/1994
"Earl,Acie",151,372,.406,0,1,.000,151,371,.407,108,160,.675,85,162,247,12,24,72,53,178,410,1993/1994
"Edwards,Bill",2,18,.111,0,5,.000,2,13,.154,2,5,.400,5,9,14,4,3,4,1,6,6,1993/1994
"Edwards,Blue",382,800,.478,38,106,.358,344,694,.496,151,189,.799,104,225,329,171,83,146,27,235,953,1993/1994
"Edwards,Doug",17,49,.347,0,1,.000,17,48,.354,9,16,.563,7,11,18,8,2,6,5,9,43,1993/1994
"Edwards,James",78,168,.464,0,0,,78,168,.464,54,79,.684,11,54,65,22,4,30,3,90,210,1993/1994
"Edwards,Kevin",471,1028,.458,35,99,.354,436,929,.469,167,217,.770,94,187,281,232,120,135,34,150,1144,1993/1994
"Ehlo,Craig",316,708,.446,77,221,.348,239,487,.491,112,154,.727,71,208,279,273,136,130,26,161,821,1993/1994
"Elie,Mario",208,466,.446,56,167,.335,152,299,.508,154,179,.860,28,153,181,208,50,109,8,124,626,1993/1994
"Elliott,Sean",360,791,.455,26,87,.299,334,704,.474,139,173,.803,68,195,263,197,54,129,27,174,885,1993/1994
"Ellis,Dale",478,967,.494,131,332,.395,347,635,.546,83,107,.776,70,185,255,80,66,75,11,141,1170,1993/1994
"Ellis,Harold",159,292,.545,0,4,.000,159,288,.552,106,149,.711,94,59,153,31,73,43,2,97,424,1993/1994
"Ellis,LaPhonso",483,963,.502,7,23,.304,476,940,.506,242,359,.674,220,462,682,167,63,172,80,304,1215,1993/1994
"Ellis,LeRon",88,182,.484,0,0,,88,182,.484,45,68,.662,70,118,188,24,17,21,25,83,221,1993/1994
"Ellison,Pervis",137,292,.469,0,3,.000,137,289,.474,70,97,.722,77,165,242,70,25,73,50,140,344,1993/1994
"English,Jo Jo",56,129,.434,8,17,.471,48,112,.429,10,21,.476,9,36,45,38,8,36,10,61,130,1993/1994
"Ewing,Patrick",745,1503,.496,4,14,.286,741,1489,.498,445,582,.765,219,666,885,179,90,260,217,275,1939,1993/1994
"Farmer,Jim",2,6,.333,0,2,.000,2,4,.500,0,0,,0,2,2,4,0,5,0,3,4,1993/1994
"Ferrell,Duane",184,379,.485,1,9,.111,183,370,.495,144,184,.783,62,67,129,65,44,64,16,85,513,1993/1994
"Ferry,Danny",149,334,.446,14,51,.275,135,283,.477,38,43,.884,47,94,141,74,28,41,22,113,350,1993/1994
"Fleming,Vern",147,318,.462,0,4,.000,147,314,.468,64,87,.736,27,96,123,173,40,87,6,98,358,1993/1994
"Floyd,Sleepy",70,209,.335,8,36,.222,62,173,.358,52,78,.667,10,60,70,101,12,61,8,71,200,1993/1994
"Ford,Alphonso",7,13,.538,1,1,1.000,6,12,.500,1,2,.500,0,0,0,1,2,1,0,2,16,1993/1994
"Foster,Greg",4,7,.571,0,0,,4,7,.571,2,2,1.000,0,3,3,0,0,1,1,3,10,1993/1994
"Fox,Rick",340,728,.467,33,100,.330,307,628,.489,174,230,.757,105,250,355,217,81,158,52,244,887,1993/1994
"Frank,Tellis",67,160,.419,0,2,.000,67,158,.424,54,76,.711,83,137,220,57,35,49,35,163,188,1993/1994
"Gaines,Corey",9,20,.450,2,5,.400,7,15,.467,13,15,.867,3,10,13,30,2,5,0,12,33,1993/1994
"Gallagher,Chad",3,3,1.000,0,0,,3,3,1.000,0,0,,0,0,0,0,0,0,0,2,6,1993/1994
"Gamble,Kevin",368,804,.458,25,103,.243,343,701,.489,103,126,.817,41,118,159,149,57,77,22,134,864,1993/1994
"Gatling,Chris",271,461,.588,0,1,.000,271,460,.589,129,208,.620,143,254,397,41,40,84,63,223,671,1993/1994
"Gattison,Kenny",233,445,.524,0,0,,233,445,.524,126,195,.646,105,253,358,95,59,79,46,229,592,1993/1994
"Gaze,Andrew",8,17,.471,4,8,.500,4,9,.444,2,2,1.000,1,6,7,5,2,3,1,9,22,1993/1994
"Geiger,Matt",202,352,.574,1,5,.200,201,347,.579,116,149,.779,119,184,303,32,36,61,29,201,521,1993/1994
"Gill,Kendall",429,969,.443,38,120,.317,391,849,.461,215,275,.782,91,177,268,275,151,143,32,194,1111,1993/1994
"Gilliam,Armen",348,682,.510,0,1,.000,348,681,.511,274,361,.759,197,303,500,69,38,106,61,129,970,1993/1994
"Gminski,Mike",36,103,.350,0,0,,36,103,.350,14,18,.778,22,52,74,11,13,13,16,23,86,1993/1994
"Gminski,Mike",31,79,.392,0,0,,31,79,.392,11,14,.786,19,40,59,11,13,11,13,20,73,1993/1994
"Gminski,Mike",5,24,.208,0,0,,5,24,.208,3,4,.750,3,12,15,0,0,2,3,3,13,1993/1994
"Grace,Ricky",2,3,.667,0,0,,2,3,.667,0,2,.000,0,1,1,1,0,0,0,3,4,1993/1994
"Graham,Greg",122,305,.400,2,25,.080,120,280,.429,92,110,.836,21,65,86,66,61,65,4,54,338,1993/1994
"Graham,Paul",21,57,.368,3,13,.231,18,44,.409,13,17,.765,4,8,12,13,4,5,5,11,58,1993/1994
"Grant,Gary",253,563,.449,17,62,.274,236,501,.471,65,76,.855,42,100,142,291,119,136,12,139,588,1993/1994
"Grant,Harvey",356,774,.460,2,7,.286,354,767,.462,84,131,.641,109,242,351,107,70,56,49,179,798,1993/1994
"Grant,Horace",460,878,.524,0,6,.000,460,872,.528,137,230,.596,306,463,769,236,74,109,84,164,1057,1993/1994
"Grant,Josh",59,146,.404,17,61,.279,42,85,.494,22,29,.759,27,62,89,24,18,30,8,62,157,1993/1994
"Grayer,Jeff",191,363,.526,2,12,.167,189,351,.538,71,118,.602,76,115,191,62,33,63,13,103,455,1993/1994
"Green,A.C.",465,926,.502,8,35,.229,457,891,.513,266,362,.735,275,478,753,137,70,100,38,142,1204,1993/1994
"Green,Litterial",22,57,.386,1,4,.250,21,53,.396,28,37,.757,6,6,12,9,6,13,1,16,73,1993/1994
"Green,Sean",63,183,.344,10,41,.244,53,142,.373,13,18,.722,10,24,34,16,18,27,6,21,149,1993/1994
"Green,Sean",63,182,.346,10,41,.244,53,141,.376,13,18,.722,10,24,34,16,18,27,6,21,149,1993/1994
"Green,Sean",0,1,.000,0,0,,0,1,.000,0,0,,0,0,0,0,0,0,0,0,0,1993/1994
"Gugliotta,Tom",540,1159,.466,40,148,.270,500,1011,.495,213,311,.685,189,539,728,276,172,247,51,174,1333,1993/1994
"Guibert,Andrés",6,20,.300,0,0,,6,20,.300,3,6,.500,10,6,16,2,0,6,1,6,15,1993/1994
"Guidinger,Jay",16,32,.500,0,0,,16,32,.500,15,21,.714,15,18,33,3,4,16,5,23,47,1993/1994
"Haley,Jack",21,48,.438,0,0,,21,48,.438,17,21,.810,6,18,24,1,0,10,0,18,59,1993/1994
"Hammink,Geert",1,3,.333,0,0,,1,3,.333,0,0,,1,0,1,1,0,0,0,1,2,1993/1994
"Hammonds,Tom",115,230,.500,0,0,,115,230,.500,71,104,.683,62,137,199,34,20,41,12,91,301,1993/1994
"Hardaway,Anfernee",509,1092,.466,50,187,.267,459,905,.507,245,330,.742,192,247,439,544,190,292,51,205,1313,1993/1994
"Harper,Derek",303,744,.407,73,203,.360,230,541,.425,112,163,.687,20,121,141,334,125,135,8,163,791,1993/1994
"Harper,Derek",130,342,.380,37,105,.352,93,237,.392,28,50,.560,10,45,55,98,45,54,4,46,325,1993/1994
"Harper,Derek",173,402,.430,36,98,.367,137,304,.451,84,113,.743,10,76,86,236,80,81,4,117,466,1993/1994
"Harper,Ron",569,1335,.426,71,236,.301,498,1099,.453,299,418,.715,129,331,460,344,144,242,54,167,1508,1993/1994
"Harris,Lucious",162,385,.421,7,33,.212,155,352,.440,87,119,.731,45,112,157,106,49,78,10,117,418,1993/1994
"Harris,Tony",9,31,.290,3,9,.333,6,22,.273,23,25,.920,3,7,10,8,4,6,0,8,44,1993/1994
"Harvey,Antonio",29,79,.367,0,0,,29,79,.367,12,26,.462,26,33,59,5,8,17,19,39,70,1993/1994
"Haskin,Scott",21,45,.467,0,0,,21,45,.467,13,19,.684,17,38,55,6,2,13,15,33,55,1993/1994
"Hawkins,Hersey",395,859,.460,78,235,.332,317,624,.508,312,362,.862,89,288,377,216,135,158,22,167,1180,1993/1994
"Henry,Skeeter",1,5,.200,0,2,.000,1,3,.333,2,4,.500,0,2,2,4,0,1,0,1,4,1993/1994
"Henson,Steve",1,2,.500,1,1,1.000,0,1,.000,0,0,,0,1,1,5,0,1,0,3,3,1993/1994
"Herrera,Carl",142,310,.458,0,0,,142,310,.458,69,97,.711,101,184,285,37,32,69,26,159,353,1993/1994
"Higgins,Rod",71,163,.436,22,50,.440,49,113,.434,31,42,.738,25,57,82,36,25,21,14,53,195,1993/1994
"Hill,Tyrone",216,398,.543,0,2,.000,216,396,.545,171,256,.668,184,315,499,46,53,78,35,193,603,1993/1994
"Hodge,Donald",46,101,.455,0,0,,46,101,.455,44,52,.846,46,49,95,32,15,30,13,66,136,1993/1994
"Horford,Tito",0,2,.000,0,0,,0,2,.000,0,0,,1,2,3,0,1,1,3,3,0,1993/1994
"Hornacek,Jeff",472,1004,.470,70,208,.337,402,796,.505,260,296,.878,60,219,279,419,127,171,13,186,1274,1993/1994
"Hornacek,Jeff",325,715,.455,52,166,.313,273,549,.497,178,204,.873,41,171,212,315,95,138,10,115,880,1993/1994
"Hornacek,Jeff",147,289,.509,18,42,.429,129,247,.522,82,92,.891,19,48,67,104,32,33,3,71,394,1993/1994
"Horry,Robert",322,702,.459,44,136,.324,278,566,.491,115,157,.732,128,312,440,231,119,137,75,186,803,1993/1994
"Houston,Allan",272,671,.405,35,117,.299,237,554,.428,89,108,.824,19,101,120,100,34,99,13,165,668,1993/1994
"Houston,Byron",81,177,.458,1,7,.143,80,170,.471,33,54,.611,67,127,194,32,33,49,31,181,196,1993/1994
"Howard,Stephen",10,17,.588,0,0,,10,17,.588,11,16,.688,10,6,16,1,1,6,3,13,31,1993/1994
"Humphries,Jay",233,535,.436,38,96,.396,195,439,.444,57,76,.750,35,92,127,219,65,95,11,168,561,1993/1994
"Hunter,Lindsey",335,893,.375,69,207,.333,266,686,.388,104,142,.732,47,142,189,390,121,184,10,174,843,1993/1994
"Hurley,Bobby",54,146,.370,2,16,.125,52,130,.400,24,30,.800,6,28,34,115,13,48,1,28,134,1993/1994
"Jackson,Jaren",34,87,.391,0,6,.000,34,81,.420,12,14,.857,6,11,17,27,4,14,2,20,80,1993/1994
"Jackson,Jim",637,1432,.445,17,60,.283,620,1372,.452,285,347,.821,169,219,388,374,87,334,25,161,1576,1993/1994
"Jackson,Mark",331,732,.452,36,127,.283,295,605,.488,167,211,.791,107,241,348,678,120,232,6,115,865,1993/1994
"Jackson,Stanley",17,33,.515,1,5,.200,16,28,.571,3,3,1.000,12,15,27,16,5,10,0,13,38,1993/1994
"Jamerson,Dave",0,7,.000,0,0,,0,7,.000,2,3,.667,0,4,4,1,0,1,0,0,2,1993/1994
"Jamerson,Dave",0,2,.000,0,0,,0,2,.000,1,1,1.000,0,1,1,0,0,0,0,0,1,1993/1994
"Jamerson,Dave",0,5,.000,0,0,,0,5,.000,1,2,.500,0,3,3,1,0,1,0,0,1,1993/1994
"James,Henry",16,42,.381,4,18,.222,12,24,.500,5,5,1.000,6,8,14,1,2,2,0,9,41,1993/1994
"Jennings,Keith",138,342,.404,56,151,.371,82,191,.429,100,120,.833,16,73,89,218,65,74,0,62,432,1993/1994
"Jent,Chris",13,26,.500,4,11,.364,9,15,.600,1,2,.500,4,11,15,7,0,5,0,13,31,1993/1994
"Johnson,Avery",356,724,.492,0,12,.000,356,712,.500,178,253,.704,41,135,176,433,113,172,8,160,890,1993/1994
"Johnson,Dave",17,54,.315,0,1,.000,17,53,.321,13,21,.619,9,7,16,4,4,9,0,7,47,1993/1994
"Johnson,Eddie",339,738,.459,59,150,.393,280,588,.476,99,127,.780,80,144,224,125,36,84,8,143,836,1993/1994
"Johnson,Ervin",44,106,.415,0,0,,44,106,.415,29,46,.630,48,70,118,7,10,24,22,45,117,1993/1994
"Johnson,Frank",134,299,.448,2,12,.167,132,287,.460,54,69,.783,29,53,82,148,41,65,1,120,324,1993/1994
"Johnson,Kevin",477,980,.487,6,27,.222,471,953,.494,380,464,.819,55,112,167,637,125,235,10,127,1340,1993/1994
"Johnson,Larry",346,672,.515,5,21,.238,341,651,.524,137,197,.695,143,305,448,184,29,116,14,131,834,1993/1994
"Jones,Charles",36,78,.462,0,1,.000,36,77,.468,19,34,.559,89,146,235,29,14,12,43,136,91,1993/1994
"Jones,Popeye",195,407,.479,0,1,.000,195,406,.480,78,107,.729,299,306,605,99,61,94,31,246,468,1993/1994
"Jordan,Adonis",6,23,.261,3,10,.300,3,13,.231,0,0,,3,3,6,19,0,6,1,6,15,1993/1994
"Jordan,Reggie",44,103,.427,2,4,.500,42,99,.424,35,51,.686,46,21,67,26,14,14,5,26,125,1993/1994
"Keefe,Adam",96,213,.451,0,0,,96,213,.451,81,111,.730,77,124,201,34,20,60,9,80,273,1993/1994
"Kemp,Shawn",533,990,.538,1,4,.250,532,986,.540,364,491,.741,312,539,851,207,142,259,166,312,1431,1993/1994
"Kempton,Tim",15,38,.395,0,0,,15,38,.395,9,16,.563,10,14,24,9,6,11,2,33,39,1993/1994
"Kempton,Tim",9,26,.346,0,0,,9,26,.346,7,10,.700,6,8,14,6,4,4,1,25,25,1993/1994
"Kempton,Tim",6,12,.500,0,0,,6,12,.500,2,6,.333,4,6,10,3,2,7,1,8,14,1993/1994
"Kerr,Steve",287,577,.497,52,124,.419,235,453,.519,83,97,.856,26,105,131,210,75,57,3,97,709,1993/1994
"Kersey,Jerome",203,469,.433,1,8,.125,202,461,.438,101,135,.748,130,201,331,75,71,63,49,213,508,1993/1994
"Kessler,Alec",11,25,.440,5,9,.556,6,16,.375,6,8,.750,4,6,10,2,1,5,1,14,33,1993/1994
"Kidd,Warren",100,169,.592,0,0,,100,169,.592,47,86,.547,76,157,233,19,19,44,23,129,247,1993/1994
"King,Chris",19,48,.396,2,7,.286,17,41,.415,15,26,.577,5,10,15,11,4,12,0,12,55,1993/1994
"King,Rich",15,34,.441,0,1,.000,15,33,.455,11,22,.500,9,11,20,8,1,7,2,18,41,1993/1994
"King,Stacey",146,341,.428,0,2,.000,146,339,.431,93,136,.684,90,151,241,58,31,83,42,121,385,1993/1994
"King,Stacey",68,171,.398,0,2,.000,68,169,.402,36,53,.679,50,82,132,39,18,43,12,64,172,1993/1994
"King,Stacey",78,170,.459,0,0,,78,170,.459,57,83,.687,40,69,109,19,13,40,30,57,213,1993/1994
"Kite,Greg",13,35,.371,0,0,,13,35,.371,8,22,.364,22,48,70,4,2,17,12,61,34,1993/1994
"Kleine,Joe",125,256,.488,5,11,.455,120,245,.490,30,39,.769,50,143,193,45,14,35,19,118,285,1993/1994
"Knight,Negele",225,475,.474,4,21,.190,221,454,.487,141,174,.810,28,75,103,197,34,94,11,121,595,1993/1994
"Knight,Negele",1,4,.250,0,0,,1,4,.250,0,0,,0,0,0,0,0,0,1,1,2,1993/1994
"Knight,Negele",224,471,.476,4,21,.190,220,450,.489,141,174,.810,28,75,103,197,34,94,10,120,593,1993/1994
"Koncak,Jon",159,369,.431,0,3,.000,159,366,.434,24,36,.667,83,282,365,102,63,44,125,236,342,1993/1994
"Krystkowiak,Larry",71,148,.480,0,1,.000,71,147,.483,31,39,.795,38,85,123,35,14,29,4,74,173,1993/1994
"Kukoč,Toni",313,726,.431,32,118,.271,281,608,.462,156,210,.743,98,199,297,252,81,167,33,122,814,1993/1994
"Laettner,Christian",396,883,.448,6,25,.240,390,858,.455,375,479,.783,160,442,602,307,87,259,86,264,1173,1993/1994
"Laimbeer,Bill",47,90,.522,3,9,.333,44,81,.543,11,13,.846,9,47,56,14,6,10,4,30,108,1993/1994
"Lang,Andrew",215,458,.469,1,4,.250,214,454,.471,73,106,.689,126,187,313,51,38,81,87,192,504,1993/1994
"Leckner,Eric",139,286,.486,0,2,.000,139,284,.489,84,130,.646,75,207,282,86,18,86,34,190,362,1993/1994
"Legler,Tim",231,528,.438,52,139,.374,179,389,.460,142,169,.840,36,92,128,120,52,60,13,133,656,1993/1994
"Les,Jim",13,34,.382,8,18,.444,5,16,.313,11,13,.846,5,8,13,39,7,11,1,16,45,1993/1994
"Lever,Fat",227,557,.408,26,74,.351,201,483,.416,75,98,.765,83,200,283,213,159,88,15,155,555,1993/1994
"Liberty,Marcus",40,123,.325,10,28,.357,30,95,.316,19,39,.487,26,35,61,17,11,24,4,34,109,1993/1994
"Liberty,Marcus",4,7,.571,0,1,.000,4,6,.667,1,2,.500,0,5,5,2,0,2,0,5,9,1993/1994
"Liberty,Marcus",36,116,.310,10,27,.370,26,89,.292,18,37,.486,26,30,56,15,11,22,4,29,100,1993/1994
"Lichti,Todd",20,51,.392,2,2,1.000,18,49,.367,16,25,.640,8,14,22,11,7,5,1,16,58,1993/1994
"Lichti,Todd",4,9,.444,0,0,,4,9,.444,0,0,,3,1,4,2,2,2,0,3,8,1993/1994
"Lichti,Todd",10,28,.357,2,2,1.000,8,26,.308,9,11,.818,3,7,10,3,0,0,0,9,31,1993/1994
"Lichti,Todd",6,14,.429,0,0,,6,14,.429,7,14,.500,2,6,8,6,5,3,1,4,19,1993/1994
"Lohaus,Brad",102,281,.363,46,134,.343,56,147,.381,20,29,.690,33,117,150,62,30,58,55,142,270,1993/1994
"Long,Grant",300,672,.446,1,6,.167,299,666,.449,187,238,.786,190,305,495,170,89,125,26,244,788,1993/1994
"Longley,Luc",219,465,.471,0,1,.000,219,464,.472,90,125,.720,129,304,433,109,45,119,79,216,528,1993/1994
"Longley,Luc",134,289,.464,0,1,.000,134,288,.465,56,80,.700,87,208,295,46,35,79,58,131,324,1993/1994
"Longley,Luc",85,176,.483,0,0,,85,176,.483,34,45,.756,42,96,138,63,10,40,21,85,204,1993/1994
"Lynch,George",291,573,.508,0,5,.000,291,568,.512,99,166,.596,220,190,410,96,102,87,27,177,681,1993/1994
"Mackey,Malcolm",14,37,.378,0,2,.000,14,35,.400,4,8,.500,12,12,24,1,0,2,3,9,32,1993/1994
"MacLean,Don",517,1030,.502,3,21,.143,514,1009,.509,328,398,.824,140,327,467,160,47,152,22,169,1365,1993/1994
"Macon,Mark",69,184,.375,2,10,.200,67,174,.385,23,34,.676,18,23,41,51,39,40,1,73,163,1993/1994
"Macon,Mark",14,45,.311,0,3,.000,14,42,.333,8,10,.800,3,4,7,11,6,14,1,17,36,1993/1994
"Macon,Mark",55,139,.396,2,7,.286,53,132,.402,15,24,.625,15,19,34,40,33,26,0,56,127,1993/1994
"Madkins,Gerald",11,31,.355,5,15,.333,6,16,.375,8,10,.800,1,10,11,19,9,13,0,16,35,1993/1994
"Mahorn,Rick",23,47,.489,0,1,.000,23,46,.500,13,20,.650,16,38,54,5,3,7,5,38,59,1993/1994
"Majerle,Dan",476,1138,.418,192,503,.382,284,635,.447,176,238,.739,120,229,349,275,129,137,43,153,1320,1993/1994
"Malone,Jeff",525,1081,.486,7,12,.583,518,1069,.485,205,247,.830,51,148,199,125,40,85,5,123,1262,1993/1994
"Malone,Jeff",338,692,.488,3,6,.500,335,686,.488,129,153,.843,28,87,115,66,26,57,5,77,808,1993/1994
"Malone,Jeff",187,389,.481,4,6,.667,183,383,.478,76,94,.809,23,61,84,59,14,28,0,46,454,1993/1994
"Malone,Karl",772,1552,.497,8,32,.250,764,1520,.503,511,736,.694,235,705,940,328,125,234,126,268,2063,1993/1994
"Malone,Moses",102,232,.440,0,1,.000,102,231,.442,90,117,.769,106,120,226,34,11,59,17,52,294,1993/1994
"Manning,Danny",586,1201,.488,3,17,.176,583,1184,.492,228,341,.669,131,334,465,261,99,233,82,260,1403,1993/1994
"Manning,Danny",409,829,.493,2,14,.143,407,815,.499,174,258,.674,82,214,296,176,53,147,57,167,994,1993/1994
"Manning,Danny",177,372,.476,1,3,.333,176,369,.477,54,83,.651,49,120,169,85,46,86,25,93,409,1993/1994
"Marble,Roy",2,12,.167,0,0,,2,12,.167,0,3,.000,3,5,8,1,0,3,2,1,4,1993/1994
"Martin,Bob",40,88,.455,0,0,,40,88,.455,31,51,.608,36,81,117,17,8,29,33,106,111,1993/1994
"Mashburn,Jamal",561,1382,.406,85,299,.284,476,1083,.440,306,438,.699,107,246,353,266,89,245,14,205,1513,1993/1994
"Mason,Anthony",206,433,.476,0,1,.000,206,432,.477,116,161,.720,158,269,427,151,31,107,9,190,528,1993/1994
"Maxey,Marlon",89,167,.533,0,2,.000,89,165,.539,70,98,.714,75,124,199,10,16,40,33,113,248,1993/1994
"Maxwell,Vernon",380,976,.389,120,403,.298,260,573,.454,143,191,.749,42,187,229,380,125,185,20,143,1023,1993/1994
"Mayberry,Lee",167,402,.415,41,119,.345,126,283,.445,58,84,.690,26,75,101,215,46,97,4,114,433,1993/1994
"McDaniel,Xavier",387,839,.461,10,41,.244,377,798,.472,144,213,.676,142,258,400,126,48,116,39,193,928,1993/1994
"McKey,Derrick",355,710,.500,9,31,.290,346,679,.510,192,254,.756,129,273,402,327,111,228,49,248,911,1993/1994
"McMillan,Nate",177,396,.447,52,133,.391,125,263,.475,31,55,.564,50,233,283,387,216,126,22,201,437,1993/1994
"Mee,Darnell",28,88,.318,5,24,.208,23,64,.359,12,27,.444,17,18,35,16,15,18,13,34,73,1993/1994
"Miller,Oliver",277,455,.609,2,9,.222,275,446,.617,80,137,.584,140,336,476,244,83,164,156,230,636,1993/1994
"Miller,Reggie",524,1042,.503,123,292,.421,401,750,.535,403,444,.908,30,182,212,248,119,175,24,193,1574,1993/1994
"Mills,Chris",284,677,.419,38,122,.311,246,555,.443,137,176,.778,134,267,401,128,54,89,50,232,743,1993/1994
"Mills,Terry",588,1151,.511,24,73,.329,564,1078,.523,181,227,.797,193,479,672,177,64,153,62,309,1381,1993/1994
"Miner,Harold",254,532,.477,4,6,.667,250,526,.475,149,180,.828,75,81,156,95,31,95,13,132,661,1993/1994
"Mitchell,Sam",140,306,.458,0,5,.000,140,301,.465,82,110,.745,71,119,190,65,33,50,9,152,362,1993/1994
"Moore,Tracy",2,3,.667,0,0,,2,3,.667,2,2,1.000,0,1,1,0,2,0,0,0,6,1993/1994
"Morningstar,Darren",39,82,.476,0,0,,39,82,.476,18,30,.600,31,50,81,15,14,19,2,70,96,1993/1994
"Morningstar,Darren",38,81,.469,0,0,,38,81,.469,18,30,.600,31,49,80,15,14,19,2,69,94,1993/1994
"Morningstar,Darren",1,1,1.000,0,0,,1,1,1.000,0,0,,0,1,1,0,0,0,0,1,2,1993/1994
"Morris,Chris",203,454,.447,53,147,.361,150,307,.489,85,118,.720,91,137,228,83,55,52,49,120,544,1993/1994
"Mourning,Alonzo",427,845,.505,0,2,.000,427,843,.507,433,568,.762,177,433,610,86,27,199,188,207,1287,1993/1994
"Mullin,Chris",410,869,.472,55,151,.364,355,718,.494,165,219,.753,64,281,345,315,107,178,53,114,1040,1993/1994
"Murdock,Eric",477,1019,.468,69,168,.411,408,851,.479,234,288,.813,91,170,261,546,197,206,12,189,1257,1993/1994
"Mureșan,Gheorghe",128,235,.545,0,0,,128,235,.545,48,71,.676,66,126,192,18,28,54,48,120,304,1993/1994
"Murphy,Tod",6,12,.500,0,0,,6,12,.500,3,6,.500,4,6,10,4,2,1,0,10,15,1993/1994
"Murphy,Tod",6,12,.500,0,0,,6,12,.500,3,6,.500,4,5,9,3,2,1,0,8,15,1993/1994
"Murphy,Tod",0,0,,0,0,,0,0,,0,0,,0,1,1,1,0,0,0,2,0,1993/1994
"Murray,Tracy",167,355,.470,50,109,.459,117,246,.476,50,72,.694,43,68,111,31,21,37,20,76,434,1993/1994
"Mustaf,Jerrod",30,84,.357,0,0,,30,84,.357,13,22,.591,20,35,55,8,4,10,5,29,73,1993/1994
"Mutombo,Dikembe",365,642,.569,0,1,.000,365,641,.569,256,439,.583,286,685,971,127,59,206,336,262,986,1993/1994
"Myers,Pete",253,556,.455,8,29,.276,245,527,.465,136,194,.701,54,127,181,245,78,136,20,195,650,1993/1994
"Nance,Larry",153,314,.487,0,0,,153,314,.487,64,85,.753,77,150,227,49,27,38,55,96,370,1993/1994
"Nevitt,Chuck",0,0,,0,0,,0,0,,3,6,.500,1,0,1,0,0,1,0,1,3,1993/1994
"Newman,Johnny",313,664,.471,24,90,.267,289,574,.503,182,225,.809,86,94,180,72,69,90,27,196,832,1993/1994
"Newman,Johnny",91,174,.523,4,16,.250,87,158,.551,48,59,.814,21,37,58,29,18,28,5,44,234,1993/1994
"Newman,Johnny",222,490,.453,20,74,.270,202,416,.486,134,166,.807,65,57,122,43,51,62,22,152,598,1993/1994
"Norman,Ken",412,919,.448,63,189,.333,349,730,.478,92,183,.503,169,331,500,222,58,150,46,209,979,1993/1994
"O'Neal,Shaquille",953,1591,.599,0,2,.000,953,1589,.600,471,850,.554,384,688,1072,195,76,222,231,281,2377,1993/1994
"O'Sullivan,Dan",4,12,.333,0,0,,4,12,.333,9,12,.750,2,8,10,3,0,3,0,10,17,1993/1994
"Oakley,Charles",363,760,.478,0,3,.000,363,757,.480,243,313,.776,349,616,965,218,110,193,18,293,969,1993/1994
"Olajuwon,Hakeem",894,1694,.528,8,19,.421,886,1675,.529,388,542,.716,229,726,955,287,128,271,297,289,2184,1993/1994
"Oliver,Jimmy",89,214,.416,13,32,.406,76,182,.418,25,33,.758,8,38,46,33,16,21,1,39,216,1993/1994
"Outlaw,Bo",98,167,.587,0,2,.000,98,165,.594,61,103,.592,81,131,212,36,36,31,37,94,257,1993/1994
"Overton,Doug",87,216,.403,1,11,.091,86,205,.420,43,52,.827,19,50,69,92,21,54,1,48,218,1993/1994
"Owens,Billy",492,971,.507,3,15,.200,489,956,.512,199,326,.610,230,410,640,326,83,214,60,269,1186,1993/1994
"Pack,Robert",223,503,.443,6,29,.207,217,474,.458,179,236,.758,25,98,123,356,81,204,9,147,631,1993/1994
"Paddio,Gerald",22,60,.367,0,1,.000,22,59,.373,9,16,.563,5,11,16,11,4,6,0,9,53,1993/1994
"Paddio,Gerald",9,23,.391,0,0,,9,23,.391,1,2,.500,0,5,5,4,1,4,0,2,19,1993/1994
"Paddio,Gerald",2,5,.400,0,0,,2,5,.400,0,0,,0,0,0,0,0,0,0,3,4,1993/1994
"Paddio,Gerald",11,32,.344,0,1,.000,11,31,.355,8,14,.571,5,6,11,7,3,2,0,4,30,1993/1994
"Parish,Robert",356,725,.491,0,0,,356,725,.491,154,208,.740,141,401,542,82,42,108,96,190,866,1993/1994
"Paxson,John",30,68,.441,9,22,.409,21,46,.457,1,2,.500,3,17,20,33,7,6,2,18,70,1993/1994
"Payton,Gary",584,1159,.504,15,54,.278,569,1105,.515,166,279,.595,105,164,269,494,188,173,19,227,1349,1993/1994
"Peeler,Anthony",176,409,.430,14,63,.222,162,346,.468,57,71,.803,48,61,109,94,43,59,8,93,423,1993/1994
"Peplowski,Mike",76,141,.539,0,1,.000,76,140,.543,24,44,.545,49,120,169,24,17,34,25,131,176,1993/1994
"Perdue,Will",47,112,.420,0,1,.000,47,111,.423,23,32,.719,40,86,126,34,8,42,11,61,117,1993/1994
"Perkins,Sam",341,779,.438,99,270,.367,242,509,.475,218,272,.801,120,246,366,111,67,103,31,197,999,1993/1994
"Perry,Elliot",42,113,.372,0,3,.000,42,110,.382,21,28,.750,12,27,39,125,25,43,1,36,105,1993/1994
"Perry,Tim",272,625,.435,73,200,.365,199,425,.468,102,176,.580,117,287,404,94,60,80,82,154,719,1993/1994
"Person,Chuck",356,843,.422,100,272,.368,256,571,.448,82,108,.759,55,198,253,185,45,121,12,164,894,1993/1994
"Petruška,Richard",20,46,.435,7,15,.467,13,31,.419,6,8,.750,9,22,31,1,2,15,3,15,53,1993/1994
"Phills,Bobby",242,514,.471,1,12,.083,241,502,.480,113,157,.720,71,141,212,133,67,63,12,135,598,1993/1994
"Pierce,Ricky",272,577,.471,6,32,.188,266,545,.488,189,211,.896,29,54,83,91,42,64,5,84,739,1993/1994
"Pinckney,Ed",151,289,.522,0,0,,151,289,.522,92,125,.736,160,318,478,62,58,62,44,131,394,1993/1994
"Pippen,Scottie",627,1278,.491,63,197,.320,564,1081,.522,270,409,.660,173,456,629,403,211,232,58,227,1587,1993/1994
"Polynice,Olden",346,662,.523,0,2,.000,346,660,.524,97,191,.508,299,510,809,41,42,78,67,189,789,1993/1994
"Polynice,Olden",222,406,.547,0,1,.000,222,405,.548,42,92,.457,148,308,456,22,24,49,36,108,486,1993/1994
"Polynice,Olden",124,256,.484,0,1,.000,124,255,.486,55,99,.556,151,202,353,19,18,29,31,81,303,1993/1994
"Porter,Terry",348,836,.416,110,282,.390,238,554,.430,204,234,.872,45,170,215,401,79,166,18,132,1010,1993/1994
"Price,Brent",141,326,.433,50,150,.333,91,176,.517,68,87,.782,31,59,90,213,55,119,2,114,400,1993/1994
"Price,Mark",480,1005,.478,118,297,.397,362,708,.511,238,268,.888,39,189,228,589,103,189,11,93,1316,1993/1994
"Rambis,Kurt",59,114,.518,0,1,.000,59,113,.522,46,71,.648,84,105,189,32,22,26,23,89,164,1993/1994
"Randall,Mark",17,50,.340,2,14,.143,15,36,.417,22,28,.786,9,13,22,11,8,10,3,18,58,1993/1994
"Rađa,Dino",491,942,.521,0,1,.000,491,941,.522,226,301,.751,191,386,577,114,70,149,67,276,1208,1993/1994
"Reid,J.R.",260,530,.491,0,3,.000,260,527,.493,107,153,.699,91,129,220,73,43,84,25,165,627,1993/1994
"Rice,Glen",663,1421,.467,132,346,.382,531,1075,.494,250,284,.880,76,358,434,184,110,130,32,186,1708,1993/1994
"Richardson,Pooh",160,354,.452,3,12,.250,157,342,.459,47,77,.610,28,82,110,237,32,88,3,78,370,1993/1994
"Richmond,Mitch",635,1428,.445,127,312,.407,508,1116,.455,426,511,.834,70,216,286,313,103,216,17,211,1823,1993/1994
"Rider,Isaiah",522,1115,.468,54,150,.360,468,965,.485,215,265,.811,118,197,315,202,54,218,28,194,1313,1993/1994
"Riley,Eric",34,70,.486,0,1,.000,34,69,.493,20,37,.541,24,35,59,9,5,15,9,30,88,1993/1994
"Rivers,Doc",55,127,.433,19,52,.365,36,75,.480,14,22,.636,4,35,39,100,25,29,5,44,143,1993/1994
"Roberts,Stanley",43,100,.430,0,0,,43,100,.430,18,44,.409,27,66,93,11,6,24,25,54,104,1993/1994
"Robinson,Clifford",641,1404,.457,13,53,.245,628,1351,.465,352,460,.765,164,386,550,159,118,169,111,263,1647,1993/1994
"Robinson,David",840,1658,.507,10,29,.345,830,1629,.510,693,925,.749,241,614,855,381,139,253,265,228,2383,1993/1994
"Robinson,James",104,285,.365,23,73,.315,81,212,.382,45,67,.672,34,44,78,68,30,52,15,69,276,1993/1994
"Robinson,Larry",10,20,.500,2,8,.250,8,12,.667,3,8,.375,4,6,10,6,7,10,0,8,25,1993/1994
"Robinson,Rumeal",55,152,.362,8,20,.400,47,132,.356,13,29,.448,6,26,32,63,18,43,3,48,131,1993/1994
"Robinson,Rumeal",42,119,.353,7,15,.467,35,104,.337,10,20,.500,4,20,24,45,15,25,3,33,101,1993/1994
"Robinson,Rumeal",13,33,.394,1,5,.200,12,28,.429,3,9,.333,2,6,8,18,3,18,0,15,30,1993/1994
"Rodman,Dennis",156,292,.534,5,24,.208,151,268,.563,53,102,.520,453,914,1367,184,52,138,32,229,370,1993/1994
"Rogers,Rodney",239,545,.439,35,92,.380,204,453,.450,127,189,.672,90,136,226,101,63,131,48,195,640,1993/1994
"Rollins,Tree",29,53,.547,0,0,,29,53,.547,18,30,.600,33,63,96,9,7,13,35,55,76,1993/1994
"Rooks,Sean",193,393,.491,0,1,.000,193,392,.492,150,210,.714,84,175,259,49,21,80,44,109,536,1993/1994
"Royal,Donald",174,347,.501,0,2,.000,174,345,.504,199,269,.740,94,154,248,61,50,76,16,121,547,1993/1994
"Russell,Bryon",135,279,.484,2,22,.091,133,257,.518,62,101,.614,61,120,181,54,68,55,19,138,334,1993/1994
"Salley,John",208,436,.477,2,3,.667,206,433,.476,164,225,.729,132,275,407,135,56,94,78,260,582,1993/1994
"Schayes,Danny",28,84,.333,0,0,,28,84,.333,29,32,.906,31,48,79,13,10,23,10,45,85,1993/1994
"Schayes,Danny",14,46,.304,0,0,,14,46,.304,21,22,.955,16,29,45,5,5,14,8,27,49,1993/1994
"Schayes,Danny",14,38,.368,0,0,,14,38,.368,8,10,.800,15,19,34,8,5,9,2,18,36,1993/1994
"Scheffler,Steve",28,46,.609,0,0,,28,46,.609,19,20,.950,11,15,26,6,7,8,0,25,75,1993/1994
"Schintzius,Dwayne",29,84,.345,0,0,,29,84,.345,10,17,.588,26,63,89,13,7,13,17,49,68,1993/1994
"Schrempf,Detlef",445,903,.493,22,68,.324,423,835,.507,300,390,.769,144,310,454,275,73,173,9,273,1212,1993/1994
"Scott,Byron",256,548,.467,27,74,.365,229,474,.483,157,195,.805,19,91,110,133,62,103,9,80,696,1993/1994
"Scott,Dennis",384,949,.405,155,388,.399,229,561,.408,123,159,.774,54,164,218,216,81,93,32,161,1046,1993/1994
"Sealy,Malik",111,274,.405,4,16,.250,107,258,.415,59,87,.678,43,75,118,48,31,51,8,84,285,1993/1994
"Seikaly,Rony",392,803,.488,0,2,.000,392,801,.489,304,422,.720,244,496,740,136,59,195,100,279,1088,1993/1994
"Shaw,Brian",278,667,.417,73,216,.338,205,451,.455,64,89,.719,104,246,350,385,71,173,21,195,693,1993/1994
"Simmons,Lionel",436,996,.438,6,17,.353,430,979,.439,251,323,.777,168,394,562,305,104,183,50,189,1129,1993/1994
"Skiles,Scott",276,644,.429,68,165,.412,208,479,.434,195,222,.878,42,147,189,503,47,193,2,171,815,1993/1994
"Smith,Charles",176,397,.443,8,16,.500,168,381,.441,87,121,.719,66,99,165,50,26,64,45,144,447,1993/1994
"Smith,Chris",184,423,.435,10,39,.256,174,384,.453,95,141,.674,15,107,122,285,38,101,18,131,473,1993/1994
"Smith,Doug",295,678,.435,2,9,.222,293,669,.438,106,127,.835,114,235,349,119,82,93,38,287,698,1993/1994
"Smith,Kenny",341,711,.480,89,220,.405,252,491,.513,135,155,.871,24,114,138,327,59,126,4,121,906,1993/1994
"Smith,LaBradford",124,306,.405,21,60,.350,103,246,.419,63,84,.750,34,50,84,109,40,50,5,96,332,1993/1994
"Smith,LaBradford",8,18,.444,0,0,,8,18,.444,15,20,.750,5,3,8,5,3,1,1,8,31,1993/1994
"Smith,LaBradford",116,288,.403,21,60,.350,95,228,.417,48,64,.750,29,47,76,104,37,49,4,88,301,1993/1994
"Smith,Reggie",29,72,.403,0,0,,29,72,.403,18,38,.474,40,59,99,4,12,12,6,47,76,1993/1994
"Smith,Steve",491,1076,.456,91,262,.347,400,814,.491,273,327,.835,156,196,352,394,84,202,35,217,1346,1993/1994
"Smith,Tony",272,617,.441,16,50,.320,256,567,.451,85,119,.714,106,89,195,148,59,76,14,128,645,1993/1994
"Smits,Rik",493,923,.534,0,1,.000,493,922,.535,238,300,.793,135,348,483,156,49,151,82,281,1224,1993/1994
"Spencer,Andre",52,118,.441,0,0,,52,118,.441,55,77,.714,30,43,73,22,19,21,7,43,159,1993/1994
"Spencer,Andre",9,18,.500,0,0,,9,18,.500,3,4,.750,4,8,12,3,1,2,2,6,21,1993/1994
"Spencer,Andre",43,100,.430,0,0,,43,100,.430,52,73,.712,26,35,61,19,18,19,5,37,138,1993/1994
"Spencer,Elmore",288,540,.533,0,2,.000,288,538,.535,97,162,.599,96,319,415,75,30,168,127,208,673,1993/1994
"Spencer,Felton",256,507,.505,0,0,,256,507,.505,165,272,.607,235,423,658,43,41,127,67,304,677,1993/1994
"Sprewell,Latrell",613,1417,.433,141,391,.361,472,1026,.460,353,456,.774,80,321,401,385,180,226,76,158,1720,1993/1994
"Starks,John",410,977,.420,113,337,.335,297,640,.464,187,248,.754,37,148,185,348,95,184,6,191,1120,1993/1994
"Stewart,Larry",3,8,.375,0,0,,3,8,.375,7,10,.700,1,6,7,2,2,2,1,4,13,1993/1994
"Stith,Bryant",365,811,.450,2,9,.222,363,802,.453,291,351,.829,119,230,349,199,116,131,16,165,1023,1993/1994
"Stockton,John",458,868,.528,48,149,.322,410,719,.570,272,338,.805,72,186,258,1031,199,266,22,236,1236,1993/1994
"Strickland,Rod",528,1093,.483,2,10,.200,526,1083,.486,353,471,.749,122,248,370,740,147,257,24,171,1411,1993/1994
"Strong,Derek",141,341,.413,3,13,.231,138,328,.421,159,206,.772,109,172,281,48,38,61,14,69,444,1993/1994
"Thomas,Isiah",318,763,.417,39,126,.310,279,637,.438,181,258,.702,46,113,159,399,68,202,6,126,856,1993/1994
"Thompson,Kevin",6,14,.429,0,1,.000,6,13,.462,1,2,.500,7,6,13,3,0,5,2,11,13,1993/1994
"Thompson,LaSalle",27,77,.351,0,0,,27,77,.351,16,30,.533,26,49,75,16,10,23,8,59,70,1993/1994
"Thorpe,Otis",449,801,.561,0,2,.000,449,799,.562,251,382,.657,271,599,870,189,66,185,28,253,1149,1993/1994
"Threatt,Sedale",411,852,.482,5,33,.152,406,819,.496,138,155,.890,28,125,153,344,110,106,19,186,965,1993/1994
"Tisdale,Wayman",552,1102,.501,0,0,,552,1102,.501,215,266,.808,159,401,560,139,37,124,52,290,1319,1993/1994
"Tolbert,Tom",74,177,.418,6,16,.375,68,161,.422,33,45,.733,36,72,108,30,13,39,15,61,187,1993/1994
"Toney,Sedric",2,12,.167,0,1,.000,2,11,.182,2,2,1.000,1,2,3,11,0,5,0,8,6,1993/1994
"Tower,Keith",4,9,.444,0,0,,4,9,.444,0,0,,0,6,6,1,0,0,0,6,8,1993/1994
"Turner,Jeff",199,426,.467,18,55,.327,181,371,.488,35,45,.778,79,192,271,60,23,75,11,239,451,1993/1994
"Van Exel,Nick",413,1049,.394,123,364,.338,290,685,.423,150,192,.781,47,191,238,466,85,145,8,154,1099,1993/1994
"Vaught,Loy",373,695,.537,0,5,.000,373,690,.541,131,182,.720,218,438,656,74,76,96,22,221,877,1993/1994
"Walker,Kenny",132,274,.482,0,3,.000,132,271,.487,87,125,.696,118,171,289,33,26,44,59,156,351,1993/1994
"Walters,Rex",60,115,.522,14,28,.500,46,87,.529,28,34,.824,6,32,38,71,15,30,3,41,162,1993/1994
"Weatherspoon,Clarence",602,1246,.483,4,17,.235,598,1229,.487,298,430,.693,254,578,832,192,100,195,116,152,1506,1993/1994
"Webb,Spud",373,810,.460,55,164,.335,318,646,.492,204,251,.813,44,178,222,528,93,168,23,182,1005,1993/1994
"Webber,Chris",572,1037,.552,0,14,.000,572,1023,.559,189,355,.532,305,389,694,272,93,206,164,247,1333,1993/1994
"Wennington,Bill",235,482,.488,0,2,.000,235,480,.490,72,88,.818,117,236,353,70,43,75,29,214,542,1993/1994
"Wenstrom,Matt",6,10,.600,0,0,,6,10,.600,6,10,.600,6,6,12,0,0,4,2,7,18,1993/1994
"Wesley,David",64,174,.368,11,47,.234,53,127,.417,44,53,.830,10,34,44,123,38,52,4,47,183,1993/1994
"West,Doug",434,891,.487,1,8,.125,433,883,.490,187,231,.810,61,170,231,172,65,137,24,236,1056,1993/1994
"West,Mark",162,286,.566,0,0,,162,286,.566,58,116,.500,112,183,295,33,31,74,109,214,382,1993/1994
"Whatley,Ennis",120,236,.508,0,6,.000,120,230,.522,52,66,.788,22,77,99,181,59,78,2,93,292,1993/1994
"White,Randy",45,112,.402,6,20,.300,39,92,.424,19,33,.576,30,53,83,11,10,18,10,46,115,1993/1994
"Whitney,Chris",25,82,.305,10,30,.333,15,52,.288,12,15,.800,5,24,29,53,11,37,1,53,72,1993/1994
"Wiley,Morlon",9,29,.310,3,10,.300,6,19,.316,0,0,,0,10,10,23,15,17,0,21,21,1993/1994
"Wiley,Morlon",3,8,.375,1,4,.250,2,4,.500,0,0,,0,4,4,7,2,6,0,4,7,1993/1994
"Wiley,Morlon",6,21,.286,2,6,.333,4,15,.267,0,0,,0,6,6,16,13,11,0,17,14,1993/1994
"Wilkins,Dominique",698,1588,.440,85,295,.288,613,1293,.474,442,522,.847,182,299,481,169,92,172,30,126,1923,1993/1994
"Wilkins,Dominique",430,996,.432,61,198,.308,369,798,.462,275,322,.854,119,186,305,114,63,120,22,87,1196,1993/1994
"Wilkins,Dominique",268,592,.453,24,97,.247,244,495,.493,167,200,.835,63,113,176,55,29,52,8,39,727,1993/1994
"Wilkins,Gerald",446,975,.457,84,212,.396,362,763,.474,194,250,.776,106,197,303,255,105,131,38,186,1170,1993/1994
"Williams,Aaron",2,8,.250,0,0,,2,8,.250,0,1,.000,1,2,3,1,0,1,0,4,4,1993/1994
"Williams,Buck",291,524,.555,0,1,.000,291,523,.556,201,296,.679,315,528,843,80,58,111,47,239,783,1993/1994
"Williams,Corey",5,13,.385,0,1,.000,5,12,.417,1,1,1.000,1,5,6,6,2,2,0,6,11,1993/1994
"Williams,Herb",103,233,.442,0,1,.000,103,232,.444,27,42,.643,56,126,182,28,18,39,43,108,233,1993/1994
"Williams,Hot Rod",394,825,.478,0,0,,394,825,.478,252,346,.728,207,368,575,193,78,139,130,219,1040,1993/1994
"Williams,Jayson",125,293,.427,0,0,,125,293,.427,72,119,.605,109,154,263,26,17,35,36,140,322,1993/1994
"Williams,John",81,188,.431,5,20,.250,76,168,.452,24,36,.667,37,90,127,97,25,35,10,85,191,1993/1994
"Williams,Kenny",191,391,.488,0,4,.000,191,387,.494,45,64,.703,93,112,205,52,24,45,49,99,427,1993/1994
"Williams,Lorenzo",49,110,.445,0,1,.000,49,109,.450,12,28,.429,95,122,217,25,18,22,46,92,110,1993/1994
"Williams,Lorenzo",1,6,.167,0,1,.000,1,5,.200,0,0,,3,1,4,2,2,0,3,3,2,1993/1994
"Williams,Lorenzo",0,1,.000,0,0,,0,1,.000,0,0,,0,4,4,0,1,1,2,2,0,1993/1994
"Williams,Lorenzo",48,103,.466,0,0,,48,103,.466,12,28,.429,92,117,209,23,15,21,41,87,108,1993/1994
"Williams,Micheal",314,687,.457,10,45,.222,304,642,.474,333,397,.839,67,154,221,512,118,203,24,193,971,1993/1994
"Williams,Reggie",418,1014,.412,64,230,.278,354,784,.452,165,225,.733,98,294,392,300,117,163,66,288,1065,1993/1994
"Williams,Scott",114,236,.483,1,5,.200,113,231,.489,60,98,.612,69,112,181,39,16,44,21,112,289,1993/1994
"Williams,Walt",226,580,.390,38,132,.288,188,448,.420,148,233,.635,71,164,235,132,52,145,23,200,638,1993/1994
"Willis,Kevin",627,1257,.499,9,24,.375,618,1233,.501,268,376,.713,335,628,963,150,79,188,38,250,1531,1993/1994
"Wilson,Trevor",187,388,.482,0,2,.000,187,386,.484,92,166,.554,120,153,273,72,38,93,11,123,466,1993/1994
"Wilson,Trevor",19,39,.487,0,0,,19,39,.487,13,25,.520,12,16,28,12,5,6,1,17,51,1993/1994
"Wilson,Trevor",168,349,.481,0,2,.000,168,347,.484,79,141,.560,108,137,245,60,33,87,10,106,415,1993/1994
"Wingate,David",136,283,.481,4,12,.333,132,271,.487,34,51,.667,30,104,134,104,42,53,6,85,310,1993/1994
"Wood,David",119,259,.459,22,49,.449,97,210,.462,62,82,.756,104,135,239,51,39,35,19,201,322,1993/1994
"Woods,Randy",49,133,.368,27,78,.346,22,55,.400,20,35,.571,13,16,29,71,24,34,2,40,145,1993/1994
"Woolridge,Orlando",364,773,.471,1,14,.071,363,759,.478,208,302,.689,103,195,298,139,41,142,56,186,937,1993/1994
"Workman,Haywoode",195,460,.424,18,56,.321,177,404,.438,93,116,.802,32,172,204,404,85,151,4,152,501,1993/1994
"Worthy,James",340,838,.406,32,111,.288,308,727,.424,100,135,.741,48,133,181,154,45,97,18,80,812,1993/1994
"Wright,Luther",8,23,.348,0,1,.000,8,22,.364,3,4,.750,6,4,10,0,1,6,2,21,19,1993/1994
"Abdelnaby,Alaa",118,231,.511,0,2,.000,118,229,.515,20,35,.571,37,77,114,13,15,45,12,104,256,1994/1995
"Abdelnaby,Alaa",117,220,.532,0,2,.000,117,218,.537,20,35,.571,34,72,106,13,15,40,12,102,254,1994/1995
"Abdelnaby,Alaa",1,11,.091,0,0,,1,11,.091,0,0,,3,5,8,0,0,5,0,2,2,1994/1995
"Abdul-Rauf,Mahmoud",472,1005,.470,83,215,.386,389,790,.492,138,156,.885,32,105,137,263,77,119,9,126,1165,1994/1995
"Adams,Michael",67,148,.453,29,81,.358,38,67,.567,25,30,.833,6,23,29,95,23,26,1,41,188,1994/1995
"Addison,Rafael",279,586,.476,24,83,.289,255,503,.507,74,99,.747,67,175,242,109,53,76,25,236,656,1994/1995
"Ainge,Danny",194,422,.460,78,214,.364,116,208,.558,105,130,.808,25,84,109,210,46,79,7,155,571,1994/1995
"Alexander,Victor",230,447,.515,6,25,.240,224,422,.531,36,60,.600,87,204,291,60,28,76,29,145,502,1994/1995
"Alston,Derrick",120,258,.465,0,4,.000,120,254,.472,59,120,.492,98,121,219,33,39,53,35,107,299,1994/1995
"Anderson,Greg",57,104,.548,0,0,,57,104,.548,34,71,.479,62,126,188,17,23,32,32,103,148,1994/1995
"Anderson,Kenny",411,1031,.399,97,294,.330,314,737,.426,348,414,.841,73,177,250,680,103,225,14,184,1267,1994/1995
"Anderson,Nick",439,923,.476,179,431,.415,260,492,.528,143,203,.704,85,250,335,314,125,141,22,124,1200,1994/1995
"Anderson,Willie",76,162,.469,3,19,.158,73,143,.510,30,41,.732,15,40,55,52,26,38,10,71,185,1994/1995
"Anthony,Greg",128,293,.437,56,155,.361,72,138,.522,60,76,.789,7,57,64,160,50,57,7,99,372,1994/1995
"Armstrong,B.J.",418,894,.468,108,253,.427,310,641,.484,206,233,.884,25,161,186,244,84,103,8,159,1150,1994/1995
"Armstrong,Darrell",3,8,.375,2,6,.333,1,2,.500,2,2,1.000,1,0,1,3,1,1,0,3,10,1994/1995
"Askew,Vincent",248,504,.492,31,94,.330,217,410,.529,176,238,.739,65,116,181,176,49,85,13,191,703,1994/1995
"Askins,Keith",81,207,.391,21,78,.269,60,129,.465,46,57,.807,86,112,198,39,35,25,17,109,229,1994/1995
"Augmon,Stacey",397,876,.453,7,26,.269,390,850,.459,252,346,.728,157,211,368,197,100,152,47,163,1053,1994/1995
"Avent,Anthony",105,244,.430,0,0,,105,244,.430,48,75,.640,97,196,293,41,28,53,50,170,258,1994/1995
"Baker,Vin",594,1229,.483,7,24,.292,587,1205,.487,256,432,.593,289,557,846,296,86,221,116,277,1451,1994/1995
"Barkley,Charles",554,1141,.486,74,219,.338,480,922,.521,379,507,.748,203,553,756,276,110,150,45,201,1561,1994/1995
"Barros,Dana",571,1165,.490,197,425,.464,374,740,.505,347,386,.899,27,247,274,619,149,242,4,159,1686,1994/1995
"Barry,Jon",57,134,.425,16,48,.333,41,86,.477,61,80,.763,15,34,49,85,30,41,4,54,191,1994/1995
"Battle,John",43,114,.377,11,31,.355,32,83,.386,19,26,.731,3,8,11,37,8,17,1,28,116,1994/1995
"Bazarevich,Sergei",11,22,.500,1,6,.167,10,16,.625,7,9,.778,1,6,7,14,1,7,1,10,30,1994/1995
"Benjamin,Benoit",271,531,.510,0,0,,271,531,.510,133,175,.760,94,346,440,38,23,125,64,151,675,1994/1995
"Bennett,Elmer",6,11,.545,0,2,.000,6,9,.667,3,4,.750,0,1,1,3,4,3,0,3,15,1994/1995
"Bennett,Tony",6,13,.462,2,9,.222,4,4,1.000,0,0,,0,2,2,4,0,3,0,6,14,1994/1995
"Benoit,David",285,587,.486,38,115,.330,247,472,.523,132,157,.841,96,272,368,58,45,75,47,183,740,1994/1995
"Blackwell,James",8,13,.615,0,0,,8,13,.615,2,3,.667,2,9,11,11,4,5,0,8,18,1994/1995
"Blackwell,James",2,3,.667,0,0,,2,3,.667,0,0,,0,3,3,5,1,2,0,1,4,1994/1995
"Blackwell,James",6,10,.600,0,0,,6,10,.600,2,3,.667,2,6,8,6,3,3,0,7,14,1994/1995
"Blaylock,Mookie",509,1198,.425,199,555,.359,310,643,.482,156,214,.729,117,276,393,616,200,242,26,164,1373,1994/1995
"Blount,Corie",100,210,.476,0,2,.000,100,208,.481,38,67,.567,107,133,240,60,26,59,33,146,238,1994/1995
"Bogues,Muggsy",348,730,.477,6,30,.200,342,700,.489,160,180,.889,51,206,257,675,103,132,0,151,862,1994/1995
"Bol,Manute",6,10,.600,3,5,.600,3,5,.600,0,0,,1,11,12,0,0,1,9,10,15,1994/1995
"Bond,Walter",39,84,.464,15,41,.366,24,43,.558,14,20,.700,8,24,32,24,6,17,4,47,107,1994/1995
"Bond,Walter",3,12,.250,1,4,.250,2,8,.250,3,4,.750,1,4,5,7,1,3,0,10,10,1994/1995
"Bond,Walter",36,72,.500,14,37,.378,22,35,.629,11,16,.688,7,20,27,17,5,14,4,37,97,1994/1995
"Bonner,Anthony",88,193,.456,1,5,.200,87,188,.463,44,67,.657,113,149,262,80,48,79,23,159,221,1994/1995
"Bowie,Anthony",177,369,.480,12,40,.300,165,329,.502,61,73,.836,54,85,139,159,47,86,21,138,427,1994/1995
"Bowie,Sam",118,267,.442,2,11,.182,116,256,.453,68,89,.764,72,216,288,118,21,91,80,182,306,1994/1995
"Bradley,Shawn",315,693,.455,0,3,.000,315,690,.457,148,232,.638,243,416,659,53,54,142,274,338,778,1994/1995
"Brandon,Terrell",341,762,.448,48,121,.397,293,641,.457,159,186,.855,35,151,186,363,107,144,14,118,889,1994/1995
"Breaux,Tim",45,121,.372,6,25,.240,39,96,.406,32,49,.653,16,18,34,15,11,16,4,25,128,1994/1995
"Brooks,Scott",126,275,.458,25,69,.362,101,206,.490,64,79,.810,14,52,66,116,34,47,4,56,341,1994/1995
"Brooks,Scott",35,65,.538,8,17,.471,27,48,.563,18,21,.857,1,12,13,22,8,14,1,14,96,1994/1995
"Brooks,Scott",91,210,.433,17,52,.327,74,158,.468,46,58,.793,13,40,53,94,26,33,3,42,245,1994/1995
"Brown,Chucky",105,174,.603,1,3,.333,104,171,.608,38,62,.613,64,125,189,30,11,29,14,105,249,1994/1995
"Brown,Dee",437,977,.447,126,327,.385,311,650,.478,236,277,.852,63,186,249,301,110,146,49,181,1236,1994/1995
"Brown,Mike",10,40,.250,0,1,.000,10,39,.256,15,27,.556,9,36,45,10,7,16,0,35,35,1994/1995
"Brown,P.J.",254,570,.446,4,24,.167,250,546,.458,139,207,.671,178,309,487,135,69,80,135,262,651,1994/1995
"Brown,Randy",124,287,.432,14,47,.298,110,240,.458,55,82,.671,24,84,108,133,99,78,19,153,317,1994/1995
"Bryant,Mark",101,192,.526,1,2,.500,100,190,.526,41,63,.651,55,106,161,28,19,39,16,109,244,1994/1995
"Buechler,Jud",90,183,.492,15,48,.313,75,135,.556,22,39,.564,36,62,98,50,24,30,12,64,217,1994/1995
"Burrell,Scott",277,593,.467,96,235,.409,181,358,.506,100,144,.694,96,272,368,161,75,85,40,187,750,1994/1995
"Burton,Willie",243,606,.401,106,275,.385,137,331,.414,220,267,.824,49,115,164,96,32,122,19,167,812,1994/1995
"Butler,Mitchell",214,508,.421,46,141,.326,168,367,.458,123,185,.665,43,127,170,91,61,106,10,155,597,1994/1995
"Cage,Michael",177,340,.521,0,2,.000,177,338,.524,53,88,.602,203,361,564,56,61,56,67,149,407,1994/1995
"Caldwell,Adrian",1,4,.250,0,0,,1,4,.250,3,6,.500,1,9,10,0,1,1,0,6,5,1994/1995
"Campbell,Elden",360,785,.459,0,1,.000,360,784,.459,193,290,.666,168,277,445,92,69,98,132,246,913,1994/1995
"Campbell,Tony",161,392,.411,15,42,.357,146,350,.417,132,159,.830,60,93,153,69,32,65,8,122,469,1994/1995
"Carr,Antoine",290,546,.531,1,4,.250,289,542,.533,165,201,.821,81,184,265,67,24,87,68,253,746,1994/1995
"Cartwright,Bill",27,69,.391,0,0,,27,69,.391,15,24,.625,25,62,87,10,6,18,3,70,69,1994/1995
"Cassell,Sam",253,593,.427,63,191,.330,190,402,.473,214,254,.843,38,173,211,405,94,167,14,209,783,1994/1995
"Causwell,Duane",76,147,.517,0,1,.000,76,146,.521,57,98,.582,57,117,174,15,14,33,80,146,209,1994/1995
"Ceballos,Cedric",497,977,.509,58,146,.397,439,831,.528,209,292,.716,169,295,464,105,60,143,19,131,1261,1994/1995
"Chambers,Tom",195,427,.457,4,24,.167,191,403,.474,109,135,.807,66,147,213,73,25,52,30,173,503,1994/1995
"Chapman,Rex",254,639,.397,86,274,.314,168,365,.460,137,159,.862,23,90,113,128,67,62,15,85,731,1994/1995
"Cheaney,Calbert",512,1129,.453,96,283,.339,416,846,.492,173,213,.812,105,216,321,177,80,151,21,215,1293,1994/1995
"Chilcutt,Pete",146,328,.445,35,86,.407,111,242,.459,31,42,.738,106,211,317,66,25,61,43,117,358,1994/1995
"Childs,Chris",106,279,.380,41,125,.328,65,154,.422,55,73,.753,14,55,69,219,42,76,3,116,308,1994/1995
"Christie,Doug",5,22,.227,1,7,.143,4,15,.267,4,5,.800,3,10,13,8,2,13,1,18,15,1994/1995
"Coleman,Derrick",371,875,.424,28,120,.233,343,755,.454,376,490,.767,167,424,591,187,35,172,94,162,1146,1994/1995
"Coles,Bimbo",261,607,.430,16,76,.211,245,531,.461,141,174,.810,46,145,191,416,99,156,13,185,679,1994/1995
"Colter,Steve",67,169,.396,8,35,.229,59,134,.440,54,71,.761,13,46,59,101,30,36,6,53,196,1994/1995
"Conlon,Marty",344,647,.532,8,29,.276,336,618,.544,119,194,.613,160,266,426,110,42,123,18,218,815,1994/1995
"Conner,Lester",0,0,,0,0,,0,0,,2,2,1.000,0,0,0,0,1,0,0,3,2,1994/1995
"Corbin,Tyrone",205,464,.442,14,56,.250,191,408,.468,78,114,.684,98,164,262,67,55,74,16,161,502,1994/1995
"Crotty,John",93,231,.403,11,36,.306,82,195,.421,98,121,.810,27,70,97,205,39,70,6,105,295,1994/1995
"Crowder,Corey",2,10,.200,0,4,.000,2,6,.333,2,6,.333,1,2,3,1,1,2,0,1,6,1994/1995
"Cummings,Terry",224,464,.483,0,0,,224,464,.483,72,123,.585,138,240,378,59,36,95,19,188,520,1994/1995
"Curley,Bill",58,134,.433,0,0,,58,134,.433,27,36,.750,54,70,124,25,21,25,21,128,143,1994/1995
"Curry,Dell",343,778,.441,154,361,.427,189,417,.453,95,111,.856,41,127,168,113,55,98,18,144,935,1994/1995
"Daniels,Lloyd",80,209,.383,26,100,.260,54,109,.495,22,27,.815,29,34,63,40,22,31,10,48,208,1994/1995
"Daniels,Lloyd",9,27,.333,3,14,.214,6,13,.462,2,2,1.000,2,5,7,4,2,8,0,8,23,1994/1995
"Daniels,Lloyd",71,182,.390,23,86,.267,48,96,.500,20,25,.800,27,29,56,36,20,23,10,40,185,1994/1995
"Dare,Yinka",0,1,.000,0,0,,0,1,.000,0,0,,0,1,1,0,0,1,0,2,0,1994/1995
"Davis,Antonio",109,245,.445,0,0,,109,245,.445,117,174,.672,105,175,280,25,19,64,29,134,335,1994/1995
"Davis,Dale",324,576,.563,0,1,.000,324,575,.563,138,259,.533,259,437,696,58,72,124,116,222,786,1994/1995
"Davis,Hubert",296,617,.480,131,288,.455,165,329,.502,97,120,.808,30,80,110,150,35,87,11,146,820,1994/1995
"Davis,Terry",49,113,.434,0,2,.000,49,111,.441,42,66,.636,63,93,156,10,6,30,3,76,140,1994/1995
"Dawkins,Johnny",125,270,.463,25,73,.342,100,197,.508,50,55,.909,28,85,113,205,52,86,1,74,325,1994/1995
"Dawson,Tony",3,8,.375,1,3,.333,2,5,.400,1,1,1.000,0,3,3,1,0,2,0,4,8,1994/1995
"Day,Todd",445,1049,.424,163,418,.390,282,631,.447,257,341,.754,95,227,322,134,104,157,63,283,1310,1994/1995
"Dehere,Terry",279,685,.407,48,163,.294,231,522,.443,229,292,.784,35,117,152,225,45,157,7,200,835,1994/1995
"Del Negro,Vinny",372,766,.486,66,162,.407,306,604,.507,128,162,.790,28,164,192,226,61,56,14,179,938,1994/1995
"Dele,Bison",196,333,.589,0,0,,196,333,.589,106,162,.654,98,200,298,53,38,114,43,210,498,1994/1995
"Divac,Vlade",485,957,.507,10,53,.189,475,904,.525,297,382,.777,261,568,829,329,109,205,174,305,1277,1994/1995
"Donaldson,James",44,74,.595,0,0,,44,74,.595,22,31,.710,19,88,107,14,6,22,28,66,110,1994/1995
"Douglas,Sherman",365,769,.475,20,82,.244,345,687,.502,204,296,.689,48,122,170,446,80,162,2,152,954,1994/1995
"Dreiling,Greg",42,102,.412,0,0,,42,102,.412,26,41,.634,32,84,116,22,6,25,22,108,110,1994/1995
"Drexler,Clyde",571,1238,.461,147,408,.360,424,830,.511,364,442,.824,152,328,480,362,136,186,45,206,1653,1994/1995
"Drexler,Clyde",305,712,.428,87,240,.363,218,472,.462,207,248,.835,84,150,234,208,74,97,22,117,904,1994/1995
"Drexler,Clyde",266,526,.506,60,168,.357,206,358,.575,157,194,.809,68,178,246,154,62,89,23,89,749,1994/1995
"Duckworth,Kevin",118,267,.442,2,10,.200,116,257,.451,45,70,.643,65,130,195,20,21,59,24,110,283,1994/1995
"Dudley,Chris",181,446,.406,0,1,.000,181,445,.407,85,183,.464,325,439,764,34,43,81,126,286,447,1994/1995
"Dumars,Joe",417,970,.430,103,338,.305,314,632,.497,277,344,.805,47,111,158,368,72,219,7,153,1214,1994/1995
"Dumas,Richard",37,73,.507,0,1,.000,37,72,.514,8,16,.500,18,11,29,7,10,9,2,22,82,1994/1995
"Dumas,Tony",96,250,.384,22,73,.301,74,177,.418,50,77,.649,32,30,62,57,13,50,4,78,264,1994/1995
"Durham,Pat",117,237,.494,5,26,.192,112,211,.531,63,96,.656,37,57,94,53,36,45,32,114,302,1994/1995
"Eackles,Ledell",143,326,.439,18,41,.439,125,285,.439,91,126,.722,33,62,95,72,19,53,2,88,395,1994/1995
"Earl,Acie",26,68,.382,0,0,,26,68,.382,14,29,.483,19,26,45,2,6,14,8,39,66,1994/1995
"Edwards,Blue",181,393,.461,22,75,.293,159,318,.500,75,90,.833,50,80,130,77,43,81,16,143,459,1994/1995
"Edwards,Blue",83,195,.426,11,43,.256,72,152,.474,43,48,.896,25,40,65,47,19,39,10,64,220,1994/1995
"Edwards,Blue",98,198,.495,11,32,.344,87,166,.524,32,42,.762,25,40,65,30,24,42,6,79,239,1994/1995
"Edwards,Doug",22,48,.458,0,1,.000,22,47,.468,23,32,.719,19,29,48,13,5,22,4,30,67,1994/1995
"Edwards,James",32,83,.386,0,0,,32,83,.386,11,17,.647,10,33,43,8,5,14,8,44,75,1994/1995
"Edwards,Kevin",69,154,.448,18,45,.400,51,109,.468,40,42,.952,10,27,37,27,19,35,5,42,196,1994/1995
"Ehlo,Craig",191,422,.453,51,134,.381,140,288,.486,44,71,.620,55,92,147,113,46,73,6,86,477,1994/1995
"Eisley,Howard",40,122,.328,9,37,.243,31,85,.365,31,40,.775,12,36,48,95,18,50,6,81,120,1994/1995
"Eisley,Howard",37,105,.352,8,32,.250,29,73,.397,31,40,.775,10,32,42,77,18,42,5,78,113,1994/1995
"Eisley,Howard",3,17,.176,1,5,.200,2,12,.167,0,0,,2,4,6,18,0,8,1,3,7,1994/1995
"Elie,Mario",243,487,.499,80,201,.398,163,286,.570,144,171,.842,50,146,196,189,65,104,12,158,710,1994/1995
"Elliott,Sean",502,1072,.468,136,333,.408,366,739,.495,326,404,.807,63,224,287,206,78,151,38,216,1466,1994/1995
"Ellis,Dale",351,774,.453,106,263,.403,245,511,.479,110,127,.866,56,166,222,57,37,81,9,142,918,1994/1995
"Ellis,Harold",91,189,.481,1,13,.077,90,176,.511,69,117,.590,56,32,88,40,67,49,12,102,252,1994/1995
"Ellis,LaPhonso",9,25,.360,0,0,,9,25,.360,6,6,1.000,7,10,17,4,1,5,5,12,24,1994/1995
"Ellison,Pervis",152,300,.507,0,2,.000,152,298,.510,71,99,.717,124,185,309,34,22,76,54,179,375,1994/1995
"English,Jo Jo",15,39,.385,3,12,.250,12,27,.444,10,13,.769,1,2,3,7,7,6,1,19,43,1994/1995
"Ewing,Patrick",730,1452,.503,6,21,.286,724,1431,.506,420,560,.750,157,710,867,212,68,256,159,272,1886,1994/1995
"Ferrell,Duane",83,173,.480,1,6,.167,82,167,.491,64,85,.753,50,38,88,31,26,43,6,79,231,1994/1995
"Ferry,Danny",223,500,.446,94,233,.403,129,267,.483,74,84,.881,30,113,143,96,27,59,22,131,614,1994/1995
"Fish,Matt",49,103,.476,0,1,.000,49,102,.480,25,37,.676,32,52,84,17,16,28,7,70,123,1994/1995
"Fleming,Vern",93,188,.495,0,7,.000,93,181,.514,65,90,.722,20,68,88,109,27,43,1,80,251,1994/1995
"Floyd,Sleepy",71,212,.335,25,88,.284,46,124,.371,30,43,.698,8,46,54,126,13,51,6,73,197,1994/1995
"Ford,Alphonso",9,39,.231,0,9,.000,9,30,.300,1,2,.500,8,12,20,9,1,8,0,5,19,1994/1995
"Foster,Greg",150,318,.472,7,23,.304,143,295,.485,78,111,.703,85,174,259,39,15,71,28,183,385,1994/1995
"Foster,Greg",41,86,.477,0,0,,41,86,.477,22,31,.710,18,36,54,16,2,17,8,54,104,1994/1995
"Foster,Greg",109,232,.470,7,23,.304,102,209,.488,56,80,.700,67,138,205,23,13,54,20,129,281,1994/1995
"Fox,Rick",169,351,.481,31,75,.413,138,276,.500,95,123,.772,61,94,155,139,52,78,19,154,464,1994/1995
"Gaines,Corey",24,51,.471,2,15,.133,22,36,.611,5,11,.455,1,17,18,33,8,14,1,23,55,1994/1995
"Gamble,Kevin",220,450,.489,39,98,.398,181,352,.514,87,111,.784,29,93,122,119,52,49,10,130,566,1994/1995
"Garland,Winston",170,410,.415,19,75,.253,151,335,.451,89,112,.795,48,120,168,318,71,105,13,184,448,1994/1995
"Gatling,Chris",324,512,.633,0,1,.000,324,511,.634,148,250,.592,144,299,443,51,39,117,52,184,796,1994/1995
"Gattison,Kenny",47,100,.470,0,1,.000,47,99,.475,31,51,.608,21,54,75,17,7,22,15,64,125,1994/1995
"Geiger,Matt",260,485,.536,4,10,.400,256,475,.539,93,143,.650,146,267,413,55,41,113,51,245,617,1994/1995
"George,Tate",1,3,.333,0,1,.000,1,2,.500,2,2,1.000,1,0,1,0,0,2,0,1,4,1994/1995
"Gill,Kendall",392,858,.457,63,171,.368,329,687,.479,155,209,.742,99,191,290,192,117,138,28,186,1002,1994/1995
"Gilliam,Armen",455,905,.503,0,2,.000,455,903,.504,302,392,.770,192,421,613,99,67,152,89,171,1212,1994/1995
"Graham,Greg",95,223,.426,6,28,.214,89,195,.456,55,73,.753,19,43,62,66,29,48,6,76,251,1994/1995
"Grandison,Ron",1,4,.250,0,0,,1,4,.250,0,0,,3,2,5,2,0,0,0,2,2,1994/1995
"Grant,Brian",413,809,.511,1,4,.250,412,805,.512,231,363,.636,207,391,598,99,49,163,116,276,1058,1994/1995
"Grant,Gary",78,166,.470,4,16,.250,74,150,.493,45,55,.818,8,27,35,93,29,44,3,66,205,1994/1995
"Grant,Greg",10,33,.303,2,7,.286,8,26,.308,9,12,.750,2,7,9,43,6,14,2,20,31,1994/1995
"Grant,Harvey",286,621,.461,8,26,.308,278,595,.467,103,146,.705,103,181,284,82,56,62,53,163,683,1994/1995
"Grant,Horace",401,707,.567,0,8,.000,401,699,.574,146,211,.692,223,492,715,173,76,85,88,203,948,1994/1995
"Grayer,Jeff",163,381,.428,5,15,.333,158,366,.432,58,83,.699,58,91,149,74,27,56,4,80,389,1994/1995
"Green,A.C.",311,617,.504,43,127,.339,268,490,.547,251,343,.732,194,475,669,127,55,114,31,146,916,1994/1995
"Gugliotta,Tom",371,837,.443,60,186,.323,311,651,.478,174,252,.690,165,407,572,279,132,189,62,203,976,1994/1995
"Gugliotta,Tom",33,83,.398,4,8,.500,29,75,.387,26,33,.788,16,37,53,18,21,15,11,19,96,1994/1995
"Gugliotta,Tom",176,397,.443,28,90,.311,148,307,.482,55,97,.567,100,197,297,122,50,93,23,98,435,1994/1995
"Gugliotta,Tom",162,357,.454,28,88,.318,134,269,.498,93,122,.762,49,173,222,139,61,81,28,86,445,1994/1995
"Guibert,Andrés",16,47,.340,0,4,.000,16,43,.372,13,19,.684,16,29,45,10,8,12,1,29,45,1994/1995
"Haley,Jack",26,61,.426,0,1,.000,26,60,.433,21,32,.656,8,19,27,2,3,13,5,31,73,1994/1995
"Hammink,Geert",1,3,.333,0,0,,1,3,.333,2,2,1.000,0,2,2,1,0,0,0,1,4,1994/1995
"Hammonds,Tom",139,260,.535,0,1,.000,139,259,.537,132,177,.746,55,167,222,36,11,56,14,132,410,1994/1995
"Hancock,Darrin",68,121,.562,1,3,.333,67,118,.568,16,39,.410,14,39,53,30,19,30,4,48,153,1994/1995
"Hardaway,Anfernee",585,1142,.512,87,249,.349,498,893,.558,356,463,.769,139,197,336,551,130,258,26,158,1613,1994/1995
"Hardaway,Tim",430,1007,.427,168,444,.378,262,563,.465,219,288,.760,46,144,190,578,88,214,12,155,1247,1994/1995
"Harmon,Jerome",21,53,.396,1,1,1.000,20,52,.385,3,6,.500,9,14,23,12,9,7,0,12,46,1994/1995
"Harper,Derek",337,756,.446,106,292,.363,231,464,.498,139,192,.724,31,163,194,458,79,151,10,219,919,1994/1995
"Harper,Ron",209,491,.426,31,110,.282,178,381,.467,81,131,.618,51,129,180,157,97,100,27,132,530,1994/1995
"Harris,Lucious",280,610,.459,55,142,.387,225,468,.481,136,170,.800,85,135,220,132,58,77,14,105,751,1994/1995
"Harris,Tony",3,8,.375,0,1,.000,3,7,.429,8,9,.889,0,0,0,0,0,1,0,2,14,1994/1995
"Harvey,Antonio",77,176,.438,1,1,1.000,76,175,.434,24,45,.533,39,63,102,23,15,25,41,87,179,1994/1995
"Hawkins,Hersey",390,809,.482,131,298,.440,259,511,.507,261,301,.867,60,254,314,262,122,150,18,178,1172,1994/1995
"Henson,Steve",37,86,.430,23,52,.442,14,34,.412,22,25,.880,3,23,26,85,9,30,0,52,119,1994/1995
"Herrera,Carl",171,327,.523,0,2,.000,171,325,.526,73,117,.624,98,180,278,44,40,71,38,136,415,1994/1995
"Higgins,Rod",3,12,.250,1,6,.167,2,6,.333,3,4,.750,4,3,7,3,1,1,1,7,10,1994/1995
"Higgins,Sean",105,273,.385,23,78,.295,82,195,.421,35,40,.875,25,52,77,29,10,35,9,93,268,1994/1995
"Hill,Grant",508,1064,.477,4,27,.148,504,1037,.486,374,511,.732,125,320,445,353,124,202,62,203,1394,1994/1995
"Hill,Tyrone",350,694,.504,0,1,.000,350,693,.505,263,397,.662,269,496,765,55,55,151,41,245,963,1994/1995
"Hodge,Donald",83,204,.407,4,14,.286,79,190,.416,39,51,.765,40,82,122,41,10,39,14,107,209,1994/1995
"Hornacek,Jeff",482,937,.514,89,219,.406,393,718,.547,284,322,.882,53,157,210,347,129,145,17,181,1337,1994/1995
"Horry,Robert",240,537,.447,86,227,.379,154,310,.497,86,113,.761,81,243,324,216,94,122,76,161,652,1994/1995
"Houston,Allan",398,859,.463,158,373,.424,240,486,.494,147,171,.860,29,138,167,164,61,113,14,182,1101,1994/1995
"Houston,Byron",49,107,.458,6,22,.273,43,85,.506,28,38,.737,20,35,55,6,13,20,5,50,132,1994/1995
"Hovasse,Tom",0,1,.000,0,1,.000,0,0,,0,0,,0,0,0,0,1,0,0,1,0,1994/1995
"Howard,Juwan",455,931,.489,0,7,.000,455,924,.492,194,292,.664,184,361,545,165,52,166,15,236,1104,1994/1995
"Humphries,Jay",8,34,.235,2,4,.500,6,30,.200,2,4,.500,4,9,13,19,9,17,0,35,20,1994/1995
"Humphries,Jay",4,25,.160,2,3,.667,2,22,.091,0,0,,2,8,10,9,7,12,0,25,10,1994/1995
"Humphries,Jay",4,9,.444,0,1,.000,4,8,.500,2,4,.500,2,1,3,10,2,5,0,10,10,1994/1995
"Hunter,Lindsey",119,318,.374,36,108,.333,83,210,.395,40,55,.727,24,51,75,159,51,79,7,94,314,1994/1995
"Hurley,Bobby",103,284,.363,21,76,.276,82,208,.394,58,76,.763,14,56,70,226,29,110,0,79,285,1994/1995
"Jackson,Jaren",25,68,.368,4,15,.267,21,53,.396,16,24,.667,18,24,42,19,9,17,5,33,70,1994/1995
"Jackson,Jim",484,1026,.472,35,110,.318,449,916,.490,306,380,.805,120,140,260,191,28,160,12,92,1309,1994/1995
"Jackson,Mark",239,566,.422,27,87,.310,212,479,.443,119,153,.778,73,233,306,616,105,210,16,148,624,1994/1995
"Jennings,Keith",190,425,.447,75,204,.368,115,221,.520,134,153,.876,26,122,148,373,95,120,2,133,589,1994/1995
"Johnson,Avery",448,863,.519,3,22,.136,445,841,.529,202,295,.685,49,159,208,670,114,207,13,154,1101,1994/1995
"Johnson,Ervin",85,192,.443,0,1,.000,85,191,.445,29,46,.630,101,188,289,16,17,54,67,163,199,1994/1995
"Johnson,Kevin",246,523,.470,4,26,.154,242,497,.487,234,289,.810,32,83,115,360,47,105,18,88,730,1994/1995
"Johnson,Larry",585,1219,.480,81,210,.386,504,1009,.500,274,354,.774,190,395,585,369,78,207,28,174,1525,1994/1995
"Jones,Askia",15,44,.341,2,12,.167,13,32,.406,13,16,.813,6,5,11,16,6,9,0,19,45,1994/1995
"Jones,Charles",1,3,.333,0,0,,1,3,.333,1,2,.500,2,5,7,0,0,0,1,8,3,1994/1995
"Jones,Eddie",342,744,.460,91,246,.370,251,498,.504,122,169,.722,79,170,249,128,131,75,41,175,897,1994/1995
"Jones,Popeye",372,839,.443,1,12,.083,371,827,.449,80,124,.645,329,515,844,163,35,124,27,267,825,1994/1995
"Jordan,Michael",166,404,.411,16,32,.500,150,372,.403,109,136,.801,25,92,117,90,30,35,13,47,457,1994/1995
"Keefe,Adam",172,298,.577,0,0,,172,298,.577,117,173,.676,135,192,327,30,36,62,25,141,461,1994/1995
"Kemp,Shawn",545,997,.547,2,7,.286,543,990,.548,438,585,.749,318,575,893,149,102,259,122,337,1530,1994/1995
"Kerr,Steve",261,495,.527,89,170,.524,172,325,.529,63,81,.778,20,99,119,151,44,48,3,114,674,1994/1995
"Kersey,Jerome",203,489,.415,7,27,.259,196,462,.424,95,124,.766,93,163,256,82,52,64,35,173,508,1994/1995
"Keys,Randolph",9,26,.346,0,9,.000,9,17,.529,2,2,1.000,6,11,17,2,1,2,2,16,20,1994/1995
"Kidd,Jason",330,857,.385,70,257,.272,260,600,.433,192,275,.698,152,278,430,607,151,250,24,146,922,1994/1995
"King,Rich",0,2,.000,0,0,,0,2,.000,0,2,.000,0,0,0,0,0,0,0,1,0,1994/1995
"King,Stacey",99,212,.467,0,1,.000,99,211,.469,68,102,.667,54,111,165,26,24,64,20,126,266,1994/1995
"Kite,Greg",3,17,.176,0,0,,3,17,.176,2,10,.200,12,10,22,1,0,6,0,15,8,1994/1995
"Kite,Greg",0,3,.000,0,0,,0,3,.000,0,0,,2,2,4,0,0,1,0,2,0,1994/1995
"Kite,Greg",3,14,.214,0,0,,3,14,.214,2,10,.200,10,8,18,1,0,5,0,13,8,1994/1995
"Kleine,Joe",119,265,.449,0,2,.000,119,263,.452,42,49,.857,82,177,259,39,14,35,18,174,280,1994/1995
"Knight,Negele",85,214,.397,11,28,.393,74,186,.398,18,25,.720,21,40,61,127,21,49,5,70,199,1994/1995
"Knight,Negele",7,15,.467,0,0,,7,15,.467,4,4,1.000,1,2,3,11,1,4,0,5,18,1994/1995
"Knight,Negele",78,199,.392,11,28,.393,67,171,.392,14,21,.667,20,38,58,116,20,45,5,65,181,1994/1995
"Koncak,Jon",77,187,.412,12,36,.333,65,151,.430,13,24,.542,23,161,184,52,36,20,46,137,179,1994/1995
"Krystkowiak,Larry",28,72,.389,0,0,,28,72,.389,27,30,.900,19,40,59,26,9,25,2,34,83,1994/1995
"Kukoč,Toni",487,967,.504,62,198,.313,425,769,.553,235,314,.748,155,285,440,372,102,165,16,163,1271,1994/1995
"Laettner,Christian",450,920,.489,13,40,.325,437,880,.497,409,500,.818,164,449,613,234,101,225,87,302,1322,1994/1995
"Lang,Andrew",320,677,.473,2,3,.667,318,674,.472,152,188,.809,154,302,456,72,45,108,144,271,794,1994/1995
"Lang,Antonio",4,10,.400,0,0,,4,10,.400,3,4,.750,3,1,4,1,0,5,2,11,11,1994/1995
"Leckner,Eric",87,165,.527,0,2,.000,87,163,.534,51,72,.708,47,127,174,14,15,39,15,122,225,1994/1995
"Lee,Doug",9,25,.360,7,18,.389,2,7,.286,18,21,.857,0,5,5,5,6,5,3,18,43,1994/1995
"Legler,Tim",60,115,.522,26,50,.520,34,65,.523,30,34,.882,12,28,40,27,12,20,1,33,176,1994/1995
"Les,Jim",11,38,.289,5,23,.217,6,15,.400,23,27,.852,6,20,26,44,4,21,0,28,50,1994/1995
"Levingston,Cliff",55,130,.423,0,1,.000,55,129,.426,19,45,.422,49,75,124,27,13,21,20,91,129,1994/1995
"Lister,Alton",66,134,.493,0,1,.000,66,133,.496,35,70,.500,67,169,236,12,16,38,57,146,167,1994/1995
"Lohaus,Brad",97,231,.420,63,155,.406,34,76,.447,10,15,.667,28,74,102,43,20,29,25,85,267,1994/1995
"Long,Grant",342,716,.478,11,31,.355,331,685,.483,244,325,.751,191,415,606,131,109,155,34,243,939,1994/1995
"Long,Grant",5,12,.417,0,0,,5,12,.417,6,10,.600,1,10,11,4,2,4,0,11,16,1994/1995
"Long,Grant",337,704,.479,11,31,.355,326,673,.484,238,315,.756,190,405,595,127,107,151,34,232,923,1994/1995
"Longley,Luc",135,302,.447,0,2,.000,135,300,.450,88,107,.822,82,181,263,73,24,86,45,177,358,1994/1995
"Lorthridge,Ryan",106,223,.475,3,14,.214,103,209,.493,57,88,.648,24,47,71,101,28,57,1,42,272,1994/1995
"Lynch,George",138,295,.468,3,21,.143,135,274,.493,62,86,.721,75,109,184,62,51,73,10,86,341,1994/1995
"MacLean,Don",158,361,.438,10,40,.250,148,321,.461,104,136,.765,46,119,165,51,15,44,3,97,430,1994/1995
"Macon,Mark",101,265,.381,20,62,.323,81,203,.399,54,68,.794,29,47,76,63,67,41,1,97,276,1994/1995
"Madkins,Gerald",2,6,.333,1,2,.500,1,4,.250,3,4,.750,0,0,0,1,2,3,0,2,8,1994/1995
"Mahorn,Rick",79,151,.523,1,3,.333,78,148,.527,39,49,.796,45,117,162,26,11,34,12,93,198,1994/1995
"Majerle,Dan",438,1031,.425,199,548,.363,239,483,.495,206,282,.730,104,271,375,340,96,105,38,155,1281,1994/1995
"Malone,Jeff",144,284,.507,11,28,.393,133,256,.520,51,59,.864,11,44,55,29,15,29,0,35,350,1994/1995
"Malone,Karl",830,1548,.536,11,41,.268,819,1507,.543,516,695,.742,156,715,871,285,129,236,85,269,2187,1994/1995
"Malone,Moses",13,35,.371,1,2,.500,12,33,.364,22,32,.688,20,26,46,6,2,11,3,15,49,1994/1995
"Manning,Danny",340,622,.547,6,21,.286,334,601,.556,136,202,.673,97,179,276,154,41,121,57,176,822,1994/1995
"Marčiulionis,Šarūnas",216,457,.473,35,87,.402,181,370,.489,145,198,.732,17,51,68,110,72,98,3,126,612,1994/1995
"Marshall,Donyell",345,876,.394,69,243,.284,276,633,.436,147,222,.662,137,268,405,105,45,115,88,157,906,1994/1995
"Marshall,Donyell",158,423,.374,32,106,.302,126,317,.397,83,122,.680,64,132,196,57,25,58,50,63,431,1994/1995
"Marshall,Donyell",187,453,.413,37,137,.270,150,316,.475,64,100,.640,73,136,209,48,20,57,38,94,475,1994/1995
"Martin,Bob",1,5,.200,0,0,,1,5,.200,0,0,,2,0,2,1,0,0,1,2,2,1994/1995
"Martin,Darrick",95,233,.408,7,38,.184,88,195,.451,57,65,.877,14,50,64,133,34,62,0,88,254,1994/1995
"Mashburn,Jamal",683,1566,.436,113,344,.328,570,1222,.466,447,605,.739,116,215,331,298,82,235,8,190,1926,1994/1995
"Mason,Anthony",287,507,.566,0,1,.000,287,506,.567,191,298,.641,182,468,650,240,69,123,21,253,765,1994/1995
"Massenburg,Tony",282,601,.469,0,3,.000,282,598,.472,177,235,.753,160,295,455,67,48,118,58,253,741,1994/1995
"Maxwell,Vernon",306,777,.394,143,441,.324,163,336,.485,99,144,.688,18,146,164,274,75,137,13,157,854,1994/1995
"Mayberry,Lee",172,408,.422,72,177,.407,100,231,.433,58,83,.699,21,61,82,276,51,106,4,123,474,1994/1995
"McCloud,George",144,328,.439,34,89,.382,110,239,.460,80,96,.833,82,65,147,53,23,40,9,71,402,1994/1995
"McDaniel,Xavier",246,546,.451,6,21,.286,240,525,.457,89,125,.712,94,206,300,108,30,89,20,146,587,1994/1995
"McIlvaine,Jim",34,71,.479,0,0,,34,71,.479,28,41,.683,40,65,105,10,10,19,60,95,96,1994/1995
"McKey,Derrick",411,833,.493,32,89,.360,379,744,.509,221,297,.744,125,269,394,276,125,168,49,260,1075,1994/1995
"McKie,Aaron",116,261,.444,11,28,.393,105,233,.451,50,73,.685,35,94,129,89,36,39,16,97,293,1994/1995
"McMillan,Nate",166,397,.418,53,155,.342,113,242,.467,34,58,.586,65,237,302,421,165,126,53,275,419,1994/1995
"Mee,Darnell",1,5,.200,1,3,.333,0,2,.000,0,0,,0,1,1,2,1,0,0,0,3,1994/1995
"Miller,Anthony",70,132,.530,2,5,.400,68,127,.535,47,76,.618,67,85,152,35,20,38,7,77,189,1994/1995
"Miller,Oliver",232,418,.555,3,13,.231,229,405,.565,78,124,.629,162,313,475,93,60,115,116,217,545,1994/1995
"Miller,Reggie",505,1092,.462,195,470,.415,310,622,.498,383,427,.897,30,180,210,242,98,151,16,157,1588,1994/1995
"Mills,Chris",359,855,.420,94,240,.392,265,615,.431,174,213,.817,99,267,366,154,59,120,35,242,986,1994/1995
"Mills,Terry",417,933,.447,109,285,.382,308,648,.475,175,219,.799,124,434,558,160,68,144,33,253,1118,1994/1995
"Miner,Harold",123,305,.403,14,49,.286,109,256,.426,69,95,.726,38,79,117,69,15,77,6,85,329,1994/1995
"Minor,Greg",155,301,.515,2,12,.167,153,289,.529,65,78,.833,49,88,137,66,32,44,16,89,377,1994/1995
"Mitchell,Sam",201,413,.487,1,10,.100,200,403,.496,126,174,.724,95,148,243,61,43,54,20,206,529,1994/1995
"Mobley,Eric",78,132,.591,2,2,1.000,76,130,.585,22,45,.489,55,98,153,21,8,24,27,63,180,1994/1995
"Montross,Eric",307,575,.534,0,1,.000,307,574,.535,167,263,.635,196,370,566,36,29,112,61,299,781,1994/1995
"Morris,Chris",351,856,.410,106,317,.334,245,539,.455,142,195,.728,181,221,402,147,86,117,51,155,950,1994/1995
"Morton,Dwayne",50,129,.388,9,25,.360,41,104,.394,58,85,.682,21,37,58,18,11,27,15,45,167,1994/1995
"Mourning,Alonzo",571,1101,.519,11,34,.324,560,1067,.525,490,644,.761,200,561,761,111,49,241,225,275,1643,1994/1995
"Mullin,Chris",170,348,.489,42,93,.452,128,255,.502,94,107,.879,25,90,115,125,38,93,19,53,476,1994/1995
"Murdock,Eric",338,814,.415,90,240,.375,248,574,.432,211,267,.790,48,166,214,482,113,194,12,139,977,1994/1995
"Mureșan,Gheorghe",303,541,.560,0,0,,303,541,.560,124,175,.709,179,309,488,38,48,115,127,259,730,1994/1995
"Murray,Lamond",439,1093,.402,65,218,.298,374,875,.427,199,264,.754,132,222,354,133,72,163,55,180,1142,1994/1995
"Murray,Tracy",95,233,.408,35,86,.407,60,147,.408,33,42,.786,20,39,59,19,14,35,4,73,258,1994/1995
"Murray,Tracy",63,153,.412,16,41,.390,47,112,.420,28,34,.824,18,19,37,14,7,20,1,42,170,1994/1995
"Murray,Tracy",32,80,.400,19,45,.422,13,35,.371,5,8,.625,2,20,22,5,7,15,3,31,88,1994/1995
"Mutombo,Dikembe",349,628,.556,0,0,,349,628,.556,248,379,.654,319,710,1029,113,40,192,321,284,946,1994/1995
"Myers,Pete",119,287,.415,10,39,.256,109,248,.440,70,114,.614,57,82,139,148,58,88,15,125,318,1994/1995
"Newbill,Ivano",16,45,.356,0,0,,16,45,.356,8,22,.364,40,41,81,17,12,12,11,60,40,1994/1995
"Newman,Johnny",226,488,.463,45,128,.352,181,360,.503,137,171,.801,72,101,173,91,69,86,13,234,634,1994/1995
"Norman,Ken",388,856,.453,98,285,.344,290,571,.508,64,140,.457,103,259,362,94,34,96,20,154,938,1994/1995
"Nwosu,Julius",9,28,.321,0,0,,9,28,.321,13,17,.765,11,13,24,3,0,9,3,20,31,1994/1995
"O'Neal,Shaquille",930,1594,.583,0,5,.000,930,1589,.585,455,854,.533,328,573,901,214,73,204,192,258,2315,1994/1995
"Oakley,Charles",192,393,.489,3,12,.250,189,381,.496,119,150,.793,155,290,445,126,60,103,7,179,506,1994/1995
"Olajuwon,Hakeem",798,1545,.517,3,16,.188,795,1529,.520,406,537,.756,172,603,775,255,133,237,242,250,2005,1994/1995
"Oliver,Brian",4,9,.444,0,0,,4,9,.444,6,8,.750,0,4,4,4,0,3,0,8,14,1994/1995
"Outlaw,Bo",170,325,.523,0,5,.000,170,320,.531,82,186,.441,121,192,313,84,90,78,151,227,422,1994/1995
"Overton,Doug",207,498,.416,53,125,.424,154,373,.413,109,125,.872,26,117,143,246,53,104,2,126,576,1994/1995
"Owens,Billy",403,820,.491,2,22,.091,401,798,.503,194,313,.620,203,299,502,246,80,204,30,205,1002,1994/1995
"Pack,Robert",170,395,.430,30,72,.417,140,323,.433,137,175,.783,19,94,113,290,61,134,6,101,507,1994/1995
"Parish,Robert",159,372,.427,0,0,,159,372,.427,71,101,.703,93,257,350,44,27,66,36,132,389,1994/1995
"Payton,Gary",685,1345,.509,70,232,.302,615,1113,.553,249,348,.716,108,173,281,583,204,201,13,206,1689,1994/1995
"Peeler,Anthony",285,659,.432,84,216,.389,201,443,.454,102,128,.797,62,106,168,122,52,82,13,143,756,1994/1995
"Peplowski,Mike",5,5,1.000,0,0,,5,5,1.000,1,2,.500,1,2,3,1,1,2,0,10,11,1994/1995
"Perdue,Will",254,459,.553,0,1,.000,254,458,.555,113,194,.582,211,311,522,90,26,116,56,220,621,1994/1995
"Perkins,Sam",346,742,.466,136,343,.397,210,399,.526,215,269,.799,96,302,398,135,72,77,45,186,1043,1994/1995
"Perry,Elliot",306,588,.520,25,60,.417,281,528,.532,158,195,.810,51,100,151,394,156,163,4,142,795,1994/1995
"Perry,Tim",27,78,.346,0,14,.000,27,64,.422,22,40,.550,38,51,89,12,10,21,15,51,76,1994/1995
"Person,Chuck",317,750,.423,172,445,.387,145,305,.475,66,102,.647,49,209,258,106,45,102,12,198,872,1994/1995
"Person,Wesley",309,638,.484,116,266,.436,193,372,.519,80,101,.792,67,134,201,105,48,79,24,149,814,1994/1995
"Phelps,Derrick",0,1,.000,0,0,,0,1,.000,0,2,.000,0,0,0,1,0,0,0,3,0,1994/1995
"Phills,Bobby",338,816,.414,19,55,.345,319,761,.419,183,235,.779,90,175,265,180,115,113,25,206,878,1994/1995
"Piatkowski,Eric",201,456,.441,74,198,.374,127,258,.492,90,115,.783,63,70,133,77,37,63,15,150,566,1994/1995
"Pierce,Ricky",111,254,.437,23,70,.329,88,184,.478,93,106,.877,12,52,64,40,22,24,2,38,338,1994/1995
"Pinckney,Ed",48,97,.495,0,0,,48,97,.495,44,62,.710,65,146,211,21,34,26,17,64,140,1994/1995
"Pippen,Scottie",634,1320,.480,109,316,.345,525,1004,.523,315,440,.716,175,464,639,409,232,271,89,238,1692,1994/1995
"Polynice,Olden",376,691,.544,1,1,1.000,375,690,.543,124,194,.639,277,448,725,62,48,113,52,238,877,1994/1995
"Porter,Terry",105,267,.393,44,114,.386,61,153,.399,58,82,.707,18,63,81,133,30,58,2,60,312,1994/1995
"Price,Mark",253,612,.413,103,253,.407,150,359,.418,148,162,.914,25,87,112,335,35,142,4,50,757,1994/1995
"Pritchard,Kevin",13,32,.406,2,8,.250,11,24,.458,16,21,.762,0,12,12,34,2,12,1,22,44,1994/1995
"Pritchard,Kevin",0,3,.000,0,3,.000,0,0,,1,4,.250,0,1,1,11,0,5,0,3,1,1994/1995
"Pritchard,Kevin",13,29,.448,2,5,.400,11,24,.458,15,17,.882,0,11,11,23,2,7,1,19,43,1994/1995
"Rambis,Kurt",18,35,.514,0,0,,18,35,.514,8,12,.667,10,24,34,16,3,8,9,35,44,1994/1995
"Randall,Mark",3,10,.300,0,1,.000,3,9,.333,0,0,,4,8,12,1,0,1,0,5,6,1994/1995
"Rađa,Dino",450,919,.490,0,1,.000,450,918,.490,233,307,.759,149,424,573,111,60,159,86,232,1133,1994/1995
"Recasner,Eldridge",1,6,.167,0,1,.000,1,5,.200,4,4,1.000,0,2,2,1,3,2,0,0,6,1994/1995
"Reeves,Khalid",206,465,.443,67,171,.392,139,294,.473,140,196,.714,52,134,186,288,77,132,10,139,619,1994/1995
"Reid,J.R.",201,396,.508,1,2,.500,200,394,.508,160,233,.687,120,273,393,55,60,113,32,230,563,1994/1995
"Rice,Glen",667,1403,.475,185,451,.410,482,952,.506,312,365,.855,99,279,378,192,112,153,14,203,1831,1994/1995
"Richardson,Pooh",353,897,.394,87,244,.357,266,653,.407,81,125,.648,38,223,261,632,129,171,12,218,874,1994/1995
"Richmond,Mitch",668,1497,.446,156,424,.368,512,1073,.477,375,445,.843,69,288,357,311,91,234,29,227,1867,1994/1995
"Rider,Isaiah",558,1249,.447,139,396,.351,419,853,.491,277,339,.817,90,159,249,245,69,232,23,194,1532,1994/1995
"Riley,Eric",65,145,.448,0,1,.000,65,144,.451,47,64,.734,45,67,112,11,17,31,35,78,177,1994/1995
"Rivers,Doc",108,302,.358,45,127,.354,63,175,.360,60,82,.732,15,94,109,162,65,60,21,150,321,1994/1995
"Rivers,Doc",4,13,.308,3,5,.600,1,8,.125,8,11,.727,2,7,9,8,4,4,0,8,19,1994/1995
"Rivers,Doc",104,289,.360,42,122,.344,62,167,.371,52,71,.732,13,87,100,154,61,56,21,142,302,1994/1995
"Roberts,Fred",28,72,.389,4,11,.364,24,61,.393,20,26,.769,13,21,34,8,6,7,3,26,80,1994/1995
"Robinson,Clifford",597,1320,.452,142,383,.371,455,937,.486,265,382,.694,152,271,423,198,79,158,82,240,1601,1994/1995
"Robinson,David",788,1487,.530,6,20,.300,782,1467,.533,656,847,.774,234,643,877,236,134,233,262,230,2238,1994/1995
"Robinson,Glenn",636,1410,.451,86,268,.321,550,1142,.482,397,499,.796,169,344,513,197,115,313,22,234,1755,1994/1995
"Robinson,James",255,624,.409,76,223,.341,179,401,.446,65,110,.591,42,90,132,180,48,127,13,142,651,1994/1995
"Rodman,Dennis",137,240,.571,0,2,.000,137,238,.576,75,111,.676,274,549,823,97,31,98,23,159,349,1994/1995
"Rogers,Carlos",180,340,.529,2,14,.143,178,326,.546,76,146,.521,108,170,278,37,22,84,52,124,438,1994/1995
"Rogers,Rodney",375,769,.488,50,148,.338,325,621,.523,179,275,.651,132,253,385,161,95,173,46,281,979,1994/1995
"Rollins,Tree",20,42,.476,0,0,,20,42,.476,21,31,.677,31,64,95,9,7,23,36,63,61,1994/1995
"Rooks,Sean",289,615,.470,0,5,.000,289,610,.474,290,381,.761,165,321,486,97,29,142,71,208,868,1994/1995
"Rose,Jalen",227,500,.454,36,114,.316,191,386,.495,173,234,.739,57,160,217,389,65,160,22,206,663,1994/1995
"Royal,Donald",206,434,.475,0,4,.000,206,430,.479,223,299,.746,83,196,279,198,45,125,16,156,635,1994/1995
"Rozier,Clifford",189,390,.485,2,7,.286,187,383,.488,68,152,.447,200,286,486,45,35,89,39,196,448,1994/1995
"Ruffin,Trevor",84,197,.426,38,99,.384,46,98,.469,27,38,.711,8,15,23,48,14,47,2,52,233,1994/1995
"Russell,Bryon",104,238,.437,13,44,.295,91,194,.469,62,93,.667,44,97,141,34,48,42,11,101,283,1994/1995
"Salley,John",197,395,.499,0,0,,197,395,.499,153,207,.739,110,226,336,123,47,97,85,279,547,1994/1995
"Schayes,Danny",126,248,.508,1,1,1.000,125,247,.506,50,69,.725,57,151,208,89,20,64,37,170,303,1994/1995
"Scheffler,Steve",12,23,.522,0,0,,12,23,.522,15,18,.833,8,15,23,4,2,3,2,9,39,1994/1995
"Schintzius,Dwayne",41,108,.380,0,0,,41,108,.380,6,11,.545,29,52,81,15,3,17,17,45,88,1994/1995
"Schrempf,Detlef",521,997,.523,93,181,.514,428,816,.525,437,521,.839,135,373,508,310,93,176,35,252,1572,1994/1995
"Scott,Byron",265,583,.455,79,203,.389,186,380,.489,193,227,.850,18,133,151,108,61,119,13,123,802,1994/1995
"Scott,Dennis",283,645,.439,150,352,.426,133,293,.454,86,114,.754,25,121,146,131,45,57,14,119,802,1994/1995
"Sealy,Malik",291,669,.435,22,73,.301,269,596,.451,174,223,.780,77,137,214,107,72,83,25,173,778,1994/1995
"Seikaly,Rony",162,314,.516,0,0,,162,314,.516,111,160,.694,77,189,266,45,20,104,37,122,435,1994/1995
"Shackleford,Charles",39,65,.600,0,0,,39,65,.600,16,20,.800,16,51,67,8,8,8,6,47,94,1994/1995
"Shaw,Brian",192,494,.389,48,184,.261,144,310,.465,70,95,.737,52,189,241,406,73,184,18,184,502,1994/1995
"Simmons,Lionel",131,312,.420,6,16,.375,125,296,.422,59,84,.702,61,135,196,89,28,70,23,118,327,1994/1995
"Simpkins,Dickey",78,184,.424,0,0,,78,184,.424,50,72,.694,60,91,151,37,10,45,7,72,206,1994/1995
"Skiles,Scott",265,583,.455,96,228,.421,169,355,.476,179,202,.886,26,133,159,452,70,172,6,135,805,1994/1995
"Slater,Reggie",40,81,.494,0,0,,40,81,.494,40,55,.727,21,36,57,12,7,26,3,47,120,1994/1995
"Smith,Charles",352,747,.471,7,31,.226,345,716,.482,255,322,.792,144,180,324,120,49,147,95,286,966,1994/1995
"Smith,Chris",116,264,.439,47,108,.435,69,156,.442,41,63,.651,14,59,73,146,32,50,22,119,320,1994/1995
"Smith,Doug",131,314,.417,1,12,.083,130,302,.430,57,75,.760,43,101,144,44,29,37,26,132,320,1994/1995
"Smith,Kenny",287,593,.484,142,331,.429,145,262,.553,126,148,.851,27,128,155,323,71,123,10,109,842,1994/1995
"Smith,Michael",63,134,.470,1,8,.125,62,126,.492,26,30,.867,13,43,56,20,6,18,2,41,153,1994/1995
"Smith,Michael",220,406,.542,0,2,.000,220,404,.545,127,262,.485,174,312,486,67,61,106,49,235,567,1994/1995
"Smith,Steve",428,1005,.426,137,416,.329,291,589,.494,312,371,.841,104,172,276,274,62,155,33,225,1305,1994/1995
"Smith,Steve",11,29,.379,2,12,.167,9,17,.529,17,22,.773,4,2,6,7,2,4,1,9,41,1994/1995
"Smith,Steve",417,976,.427,135,404,.334,282,572,.493,295,349,.845,100,170,270,267,60,151,32,216,1264,1994/1995
"Smith,Tony",132,309,.427,32,91,.352,100,218,.459,44,63,.698,43,64,107,102,46,50,7,111,340,1994/1995
"Smits,Rik",558,1060,.526,0,2,.000,558,1058,.527,284,377,.753,192,409,601,111,40,189,79,278,1400,1994/1995
"Spencer,Elmore",52,118,.441,0,1,.000,52,117,.444,28,50,.560,11,54,65,25,14,48,23,62,132,1994/1995
"Spencer,Felton",105,215,.488,0,0,,105,215,.488,107,135,.793,90,170,260,17,12,68,32,131,317,1994/1995
"Sprewell,Latrell",490,1171,.418,90,326,.276,400,845,.473,350,448,.781,58,198,256,279,112,230,46,108,1420,1994/1995
"Starks,John",419,1062,.395,217,611,.355,202,451,.448,168,228,.737,34,185,219,411,92,160,4,257,1223,1994/1995
"Stewart,Larry",41,89,.461,0,2,.000,41,87,.471,20,30,.667,28,39,67,18,16,16,9,52,102,1994/1995
"Stith,Bryant",312,661,.472,20,68,.294,292,593,.492,267,324,.824,95,173,268,153,91,110,18,142,911,1994/1995
"Stockton,John",429,791,.542,102,227,.449,327,564,.580,246,306,.804,57,194,251,1011,194,267,22,215,1206,1994/1995
"Strickland,Mark",1,3,.333,0,0,,1,3,.333,1,2,.500,2,2,4,0,0,1,1,0,3,1994/1995
"Strickland,Rod",441,946,.466,46,123,.374,395,823,.480,283,380,.745,73,244,317,562,123,209,9,118,1211,1994/1995
"Strong,Derek",149,329,.453,2,7,.286,147,322,.457,141,172,.820,136,239,375,44,24,79,13,143,441,1994/1995
"Sutton,Greg",94,230,.409,43,115,.374,51,115,.443,32,45,.711,8,48,56,91,33,51,2,114,263,1994/1995
"Swinson,Aaron",10,18,.556,0,0,,10,18,.556,4,5,.800,3,5,8,3,1,5,0,8,24,1994/1995
"Tabak,Žan",24,53,.453,0,1,.000,24,52,.462,27,44,.614,23,34,57,4,2,18,7,37,75,1994/1995
"Tarpley,Roy",292,610,.479,5,18,.278,287,592,.485,102,122,.836,142,307,449,58,45,109,55,155,691,1994/1995
"Thompson,Brooks",45,114,.395,18,58,.310,27,56,.482,8,12,.667,7,16,23,43,10,27,2,46,116,1994/1995
"Thompson,LaSalle",49,118,.415,0,0,,49,118,.415,14,16,.875,28,61,89,18,18,33,10,76,112,1994/1995
"Thorpe,Otis",385,681,.565,0,7,.000,385,674,.571,167,281,.594,202,356,558,112,41,132,28,224,937,1994/1995
"Thorpe,Otis",206,366,.563,0,3,.000,206,363,.567,67,127,.528,113,209,322,58,22,76,13,102,479,1994/1995
"Thorpe,Otis",179,315,.568,0,4,.000,179,311,.576,100,154,.649,89,147,236,54,19,56,15,122,458,1994/1995
"Threatt,Sedale",217,437,.497,36,95,.379,181,342,.529,88,111,.793,21,103,124,248,54,70,12,139,558,1994/1995
"Tisdale,Wayman",278,574,.484,0,0,,278,574,.484,94,122,.770,83,164,247,45,29,64,27,190,650,1994/1995
"Tolbert,Tom",6,18,.333,0,4,.000,6,14,.429,2,2,1.000,7,10,17,2,0,3,0,9,14,1994/1995
"Tower,Keith",0,2,.000,0,0,,0,2,.000,1,2,.500,1,2,3,0,0,1,0,1,1,1994/1995
"Tucker,Anthony",96,210,.457,0,1,.000,96,209,.459,51,83,.614,44,126,170,68,46,56,11,129,243,1994/1995
"Turner,Henry",23,57,.404,2,5,.400,21,52,.404,20,35,.571,17,11,28,7,8,12,1,20,68,1994/1995
"Turner,Jeff",73,178,.410,27,75,.360,46,103,.447,26,29,.897,23,74,97,38,12,22,3,102,199,1994/1995
"Tyler,B.J.",72,189,.381,16,51,.314,56,138,.406,35,50,.700,13,49,62,174,36,97,2,58,195,1994/1995
"Van Exel,Nick",465,1107,.420,183,511,.358,282,596,.473,235,300,.783,27,196,223,660,97,220,6,157,1348,1994/1995
"Vaught,Loy",609,1185,.514,7,33,.212,602,1152,.523,176,248,.710,261,511,772,139,104,166,29,243,1401,1994/1995
"Vinson,Fred",1,7,.143,1,6,.167,0,1,.000,1,1,1.000,0,0,0,1,0,2,0,4,4,1994/1995
"Walker,Kenny",18,42,.429,0,0,,18,42,.429,21,28,.750,19,28,47,7,5,15,5,42,57,1994/1995
"Walters,Rex",206,469,.439,71,196,.362,135,273,.495,40,52,.769,18,75,93,121,37,71,16,135,523,1994/1995
"Ward,Charlie",4,19,.211,1,10,.100,3,9,.333,7,10,.700,1,5,6,4,2,8,0,7,16,1994/1995
"Watson,Jamie",76,152,.500,5,19,.263,71,133,.534,38,56,.679,16,58,74,59,35,51,11,86,195,1994/1995
"Weatherspoon,Clarence",543,1238,.439,4,21,.190,539,1217,.443,283,377,.751,144,382,526,215,115,191,67,195,1373,1994/1995
"Webb,Spud",302,689,.438,48,145,.331,254,544,.467,226,242,.934,29,145,174,468,75,185,8,148,878,1994/1995
"Webber,Chris",464,938,.495,40,145,.276,424,793,.535,117,233,.502,200,318,518,256,83,167,85,186,1085,1994/1995
"Wennington,Bill",156,317,.492,0,4,.000,156,313,.498,51,63,.810,64,126,190,40,22,39,17,198,363,1994/1995
"Wesley,David",128,313,.409,51,119,.429,77,194,.397,71,94,.755,31,86,117,266,82,87,9,144,378,1994/1995
"West,Doug",351,762,.461,11,61,.180,340,701,.485,206,246,.837,60,167,227,185,65,126,24,250,919,1994/1995
"West,Mark",217,390,.556,0,0,,217,390,.556,66,138,.478,160,248,408,18,27,85,102,247,500,1994/1995
"Whatley,Ennis",24,53,.453,2,8,.250,22,45,.489,20,32,.625,9,21,30,54,19,19,0,37,70,1994/1995
"Whitney,Chris",14,47,.298,3,19,.158,11,28,.393,11,11,1.000,4,9,13,28,4,18,0,34,42,1994/1995
"Wiley,Morlon",50,117,.427,30,79,.380,20,38,.526,7,10,.700,6,37,43,75,22,23,2,44,137,1994/1995
"Wiley,Morlon",47,111,.423,29,75,.387,18,36,.500,7,10,.700,6,33,39,69,21,19,1,44,130,1994/1995
"Wiley,Morlon",3,6,.500,1,4,.250,2,2,1.000,0,0,,0,4,4,6,1,4,1,0,7,1994/1995
"Wilkins,Dominique",496,1169,.424,112,289,.388,384,880,.436,266,340,.782,157,244,401,166,61,173,14,130,1370,1994/1995
"Williams,Aaron",8,24,.333,0,1,.000,8,23,.348,8,12,.667,5,14,19,0,2,7,6,14,24,1994/1995
"Williams,Buck",309,604,.512,1,2,.500,308,602,.512,138,205,.673,251,418,669,78,67,119,69,254,757,1994/1995
"Williams,Herb",82,180,.456,0,0,,82,180,.456,23,37,.622,23,109,132,27,13,40,45,108,187,1994/1995
"Williams,Hot Rod",366,810,.452,1,5,.200,365,805,.453,196,286,.685,173,334,507,192,83,149,101,211,929,1994/1995
"Williams,Jayson",149,323,.461,0,5,.000,149,318,.469,65,122,.533,179,246,425,35,26,59,33,160,363,1994/1995
"Williams,John",41,115,.357,4,12,.333,37,103,.359,14,25,.560,23,39,62,27,10,35,2,48,100,1994/1995
"Williams,Lorenzo",145,304,.477,0,0,,145,304,.477,38,101,.376,291,399,690,124,52,105,148,306,328,1994/1995
"Williams,Micheal",1,4,.250,0,0,,1,4,.250,4,5,.800,0,1,1,3,2,3,0,3,6,1994/1995
"Williams,Monty",60,133,.451,0,8,.000,60,125,.480,17,38,.447,42,56,98,49,20,41,4,87,137,1994/1995
"Williams,Reggie",388,846,.459,85,266,.320,303,580,.522,132,174,.759,94,235,329,231,114,124,67,264,993,1994/1995
"Williams,Scott",206,434,.475,0,7,.000,206,427,.482,79,107,.738,173,312,485,59,71,84,40,237,491,1994/1995
"Williams,Walt",445,998,.446,103,296,.348,342,702,.487,266,364,.731,100,245,345,316,123,243,63,265,1259,1994/1995
"Willis,Kevin",473,1015,.466,3,15,.200,470,1000,.470,205,297,.690,227,505,732,86,60,162,36,215,1154,1994/1995
"Willis,Kevin",16,41,.390,0,1,.000,16,40,.400,10,15,.667,10,26,36,3,1,7,3,7,42,1994/1995
"Willis,Kevin",457,974,.469,3,14,.214,454,960,.473,195,282,.691,217,479,696,83,59,155,33,208,1112,1994/1995
"Wilson,Trevor",18,40,.450,0,0,,18,40,.450,11,14,.786,10,16,26,12,4,6,2,12,47,1994/1995
"Wingate,David",50,122,.410,4,22,.182,46,100,.460,18,24,.750,11,49,60,56,19,27,6,60,122,1994/1995
"Wingfield,Dontonio",18,51,.353,2,12,.167,16,39,.410,8,10,.800,11,19,30,3,5,8,3,15,46,1994/1995
"Wolf,Joe",38,81,.469,2,6,.333,36,75,.480,12,16,.750,34,95,129,37,9,22,6,101,90,1994/1995
"Wood,David",153,326,.469,31,91,.341,122,235,.519,91,117,.778,83,158,241,65,28,53,13,217,428,1994/1995
"Woods,Randy",37,117,.316,22,74,.297,15,43,.349,28,38,.737,10,34,44,134,41,55,0,87,124,1994/1995
"Workman,Haywoode",101,269,.375,35,98,.357,66,171,.386,55,74,.743,21,90,111,194,59,73,5,115,292,1994/1995
"Wright,Sharone",361,776,.465,0,8,.000,361,768,.470,182,282,.645,191,281,472,48,37,151,104,246,904,1994/1995
"Young,Danny",9,17,.529,5,12,.417,4,5,.800,1,1,1.000,1,4,5,12,4,4,0,8,24,1994/1995
"Abdul-Rauf,Mahmoud",414,955,.434,121,309,.392,293,646,.454,146,157,.930,26,112,138,389,64,115,3,117,1095,1995/1996
"Adams,Michael",37,83,.446,14,41,.341,23,42,.548,26,35,.743,5,17,22,67,21,25,4,25,114,1995/1996
"Addison,Rafael",77,165,.467,0,9,.000,77,156,.494,17,22,.773,25,65,90,30,9,27,9,74,171,1995/1996
"Alexander,Cory",63,155,.406,26,66,.394,37,89,.416,16,25,.640,9,33,42,121,27,68,2,94,168,1995/1996
"Allen,Jerome",36,105,.343,10,33,.303,26,72,.361,26,36,.722,5,20,25,49,21,34,5,42,108,1995/1996
"Alston,Derrick",198,387,.512,1,3,.333,197,384,.513,55,112,.491,127,175,302,61,56,59,52,191,452,1995/1996
"Amaechi,John",29,70,.414,0,0,,29,70,.414,19,33,.576,13,39,52,9,6,34,11,49,77,1995/1996
"Amaya,Ashraf",121,252,.480,0,1,.000,121,251,.482,97,149,.651,114,189,303,33,22,57,10,151,339,1995/1996
"Anderson,Greg",24,47,.511,0,1,.000,24,46,.522,6,25,.240,29,71,100,10,9,22,24,66,54,1995/1996
"Anderson,Kenny",349,834,.418,92,256,.359,257,578,.445,260,338,.769,63,140,203,575,111,146,14,178,1050,1995/1996
"Anderson,Kenny",143,380,.376,36,99,.364,107,281,.381,151,188,.803,37,64,101,247,52,58,8,73,473,1995/1996
"Anderson,Kenny",206,454,.454,56,157,.357,150,297,.505,109,150,.727,26,76,102,328,59,88,6,105,577,1995/1996
"Anderson,Nick",400,904,.442,168,430,.391,232,474,.489,166,240,.692,92,323,415,279,121,141,46,135,1134,1995/1996
"Anderson,Willie",288,660,.436,34,120,.283,254,540,.470,132,163,.810,48,198,246,197,75,143,59,230,742,1995/1996
"Anderson,Willie",232,527,.440,29,95,.305,203,432,.470,113,132,.856,35,151,186,149,58,119,51,171,606,1995/1996
"Anderson,Willie",56,133,.421,5,25,.200,51,108,.472,19,31,.613,13,47,60,48,17,24,8,59,136,1995/1996
"Anthony,Greg",324,781,.415,90,271,.332,234,510,.459,229,297,.771,29,145,174,476,116,160,11,137,967,1995/1996
"Armstrong,B.J.",340,727,.468,98,207,.473,242,520,.465,234,279,.839,22,162,184,401,68,128,6,147,1012,1995/1996
"Armstrong,Darrell",16,32,.500,6,12,.500,10,20,.500,4,4,1.000,0,2,2,5,6,6,0,4,42,1995/1996
"Askew,Vincent",215,436,.493,29,86,.337,186,350,.531,123,161,.764,65,153,218,163,47,96,15,178,582,1995/1996
"Askins,Keith",157,391,.402,99,237,.418,58,154,.377,45,57,.789,113,211,324,121,48,82,61,271,458,1995/1996
"Augmon,Stacey",362,738,.491,1,4,.250,361,734,.492,251,317,.792,137,167,304,137,106,138,31,188,976,1995/1996
"Avent,Anthony",179,466,.384,0,0,,179,466,.384,57,77,.740,108,247,355,69,30,107,42,202,415,1995/1996
"Baker,Vin",699,1429,.489,10,48,.208,689,1381,.499,321,479,.670,263,545,808,212,68,216,91,272,1729,1995/1996
"Bardo,Steve",9,23,.391,0,4,.000,9,19,.474,4,6,.667,2,20,22,15,4,5,1,17,22,1995/1996
"Barkley,Charles",580,1160,.500,49,175,.280,531,985,.539,440,566,.777,243,578,821,262,114,218,56,208,1649,1995/1996
"Barros,Dana",379,806,.470,150,368,.408,229,438,.523,130,147,.884,21,171,192,306,58,120,3,116,1038,1995/1996
"Barry,Brent",283,597,.474,123,296,.416,160,301,.532,111,137,.810,38,130,168,230,95,120,22,196,800,1995/1996
"Barry,Jon",91,185,.492,44,93,.473,47,92,.511,31,37,.838,17,46,63,85,33,42,11,51,257,1995/1996
"Beck,Corey",2,8,.250,0,0,,2,8,.250,1,2,.500,3,4,7,5,1,4,0,8,5,1995/1996
"Benjamin,Benoit",294,590,.498,0,3,.000,294,587,.501,140,194,.722,141,398,539,64,45,144,85,224,728,1995/1996
"Benjamin,Benoit",71,161,.441,0,0,,71,161,.441,39,56,.696,31,72,103,16,10,34,15,40,181,1995/1996
"Benjamin,Benoit",223,429,.520,0,3,.000,223,426,.523,101,138,.732,110,326,436,48,35,110,70,184,547,1995/1996
"Bennett,Elmer",4,17,.235,0,0,,4,17,.235,3,4,.750,1,4,5,8,1,7,1,6,11,1995/1996
"Bennett,Mario",29,64,.453,0,1,.000,29,63,.460,27,42,.643,21,28,49,6,11,11,11,46,85,1995/1996
"Benoit,David",255,581,.439,64,192,.333,191,389,.491,87,112,.777,90,293,383,82,43,71,49,166,661,1995/1996
"Best,Travis",69,163,.423,8,25,.320,61,138,.442,75,90,.833,11,33,44,97,20,63,3,80,221,1995/1996
"Blaylock,Mookie",455,1123,.405,231,623,.371,224,500,.448,127,170,.747,110,222,332,478,212,188,17,151,1268,1995/1996
"Blount,Corie",79,167,.473,0,2,.000,79,165,.479,25,44,.568,69,101,170,42,25,47,35,109,183,1995/1996
"Bogues,Muggsy",6,16,.375,0,1,.000,6,15,.400,2,2,1.000,6,1,7,19,2,6,0,4,14,1995/1996
"Bonner,Anthony",5,15,.333,0,0,,5,15,.333,3,7,.429,6,13,19,4,3,3,0,11,13,1995/1996
"Booker,Melvin",16,50,.320,3,19,.158,13,31,.419,9,11,.818,1,8,9,21,5,12,1,18,44,1995/1996
"Bowie,Anthony",128,272,.471,12,31,.387,116,241,.481,40,46,.870,40,83,123,105,34,55,10,112,308,1995/1996
"Boyce,Donnie",9,23,.391,4,8,.500,5,15,.333,2,4,.500,5,5,10,3,3,6,1,2,24,1995/1996
"Bradley,Shawn",387,873,.443,1,4,.250,386,869,.444,169,246,.687,221,417,638,63,49,179,288,286,944,1995/1996
"Bradley,Shawn",43,97,.443,0,0,,43,97,.443,19,25,.760,34,72,106,8,8,31,38,42,105,1995/1996
"Bradley,Shawn",344,776,.443,1,4,.250,343,772,.444,150,221,.679,187,345,532,55,41,148,250,244,839,1995/1996
"Bragg,Marques",54,120,.450,0,0,,54,120,.450,23,41,.561,38,41,79,8,17,26,8,71,131,1995/1996
"Brandon,Terrell",510,1096,.465,91,235,.387,419,861,.487,338,381,.887,47,201,248,487,132,142,33,146,1449,1995/1996
"Breaux,Tim",59,161,.366,15,46,.326,44,115,.383,28,45,.622,22,38,60,24,11,30,8,42,161,1995/1996
"Brickowski,Frank",123,252,.488,32,79,.405,91,173,.526,61,86,.709,26,125,151,58,26,78,8,185,339,1995/1996
"Brooks,Scott",134,293,.457,25,62,.403,109,231,.472,59,69,.855,11,30,41,100,42,43,3,53,352,1995/1996
"Brown,Chucky",300,555,.541,1,8,.125,299,547,.547,104,150,.693,134,307,441,89,47,94,38,163,705,1995/1996
"Brown,Dee",246,616,.399,68,220,.309,178,396,.449,135,158,.854,36,100,136,146,80,74,12,119,695,1995/1996
"Brown,Mike",9,16,.563,0,0,,9,16,.563,8,17,.471,14,23,37,3,3,6,2,24,26,1995/1996
"Brown,P.J.",354,798,.444,3,15,.200,351,783,.448,204,265,.770,215,345,560,165,79,133,100,249,915,1995/1996
"Brown,Randy",78,192,.406,1,11,.091,77,181,.425,28,46,.609,17,49,66,73,57,31,12,88,185,1995/1996
"Bryant,Mark",242,446,.543,0,2,.000,242,444,.545,127,177,.718,131,220,351,52,31,85,19,234,611,1995/1996
"Buechler,Jud",112,242,.463,40,90,.444,72,152,.474,14,22,.636,45,66,111,56,34,39,7,70,278,1995/1996
"Bullard,Matt",66,162,.407,26,72,.361,40,90,.444,16,20,.800,18,42,60,18,17,24,11,50,174,1995/1996
"Burrell,Scott",92,206,.447,37,98,.378,55,108,.509,42,56,.750,26,72,98,47,27,43,13,76,263,1995/1996
"Burrough,Junior",64,170,.376,0,0,,64,170,.376,61,93,.656,45,64,109,15,15,40,10,74,189,1995/1996
"Butler,Mitchell",88,229,.384,13,60,.217,75,169,.444,48,83,.578,29,89,118,67,41,67,12,104,237,1995/1996
"Caffey,Jason",71,162,.438,0,1,.000,71,161,.441,40,68,.588,51,60,111,24,12,48,7,91,182,1995/1996
"Cage,Michael",220,396,.556,0,1,.000,220,395,.557,50,92,.543,288,441,729,53,87,54,79,215,490,1995/1996
"Caldwell,Adrian",46,83,.554,0,0,,46,83,.554,18,36,.500,42,68,110,6,9,35,5,73,110,1995/1996
"Campbell,Elden",447,888,.503,0,5,.000,447,883,.506,249,349,.713,162,461,623,181,88,137,212,300,1143,1995/1996
"Carr,Antoine",233,510,.457,0,3,.000,233,507,.460,114,144,.792,71,129,200,74,28,78,65,254,580,1995/1996
"Carr,Chris",90,217,.415,11,42,.262,79,175,.451,49,60,.817,27,75,102,43,10,40,5,77,240,1995/1996
"Cassell,Sam",289,658,.439,73,210,.348,216,448,.482,235,285,.825,51,137,188,278,53,157,4,166,886,1995/1996
"Causwell,Duane",90,216,.417,0,1,.000,90,215,.419,70,96,.729,86,162,248,20,27,53,78,173,250,1995/1996
"Ceballos,Cedric",638,1203,.530,51,184,.277,587,1019,.576,329,409,.804,215,321,536,119,94,167,22,144,1656,1995/1996
"Chapman,Rex",289,679,.426,125,337,.371,164,342,.480,83,113,.735,22,123,145,166,45,79,10,117,786,1995/1996
"Cheaney,Calbert",426,905,.471,52,154,.338,374,751,.498,151,214,.706,67,172,239,154,67,129,18,205,1055,1995/1996
"Chilcutt,Pete",73,179,.408,37,98,.378,36,81,.444,17,26,.654,51,105,156,26,19,22,14,65,200,1995/1996
"Childress,Randolph",25,79,.316,13,47,.277,12,32,.375,22,27,.815,1,18,19,32,8,28,1,22,85,1995/1996
"Childs,Chris",324,778,.416,95,259,.367,229,519,.441,259,304,.852,51,194,245,548,111,230,8,246,1002,1995/1996
"Christie,Doug",150,337,.445,46,106,.434,104,231,.450,69,93,.742,34,120,154,117,70,95,19,141,415,1995/1996
"Christie,Doug",35,73,.479,10,19,.526,25,54,.463,13,22,.591,8,26,34,25,12,19,3,41,93,1995/1996
"Christie,Doug",115,264,.436,36,87,.414,79,177,.446,56,71,.789,26,94,120,92,58,76,16,100,322,1995/1996
"Churchwell,Robert",3,8,.375,0,0,,3,8,.375,0,0,,0,3,3,1,0,2,0,1,6,1995/1996
"Claxton,Charles",1,2,.500,0,0,,1,2,.500,0,2,.000,2,0,2,0,0,1,1,4,2,1995/1996
"Coker,John",4,5,.800,0,0,,4,5,.800,0,0,,2,0,2,1,0,0,1,1,8,1995/1996
"Coleman,Derrick",48,118,.407,7,21,.333,41,97,.423,20,32,.625,13,59,72,31,4,28,10,30,123,1995/1996
"Coles,Bimbo",318,777,.409,88,254,.346,230,523,.440,168,211,.796,49,211,260,422,94,171,17,253,892,1995/1996
"Coles,Bimbo",231,559,.413,63,172,.366,168,387,.434,139,173,.803,38,163,201,296,63,123,12,175,664,1995/1996
"Coles,Bimbo",87,218,.399,25,82,.305,62,136,.456,29,38,.763,11,48,59,126,31,48,5,78,228,1995/1996
"Conlon,Marty",153,327,.468,5,30,.167,148,297,.498,84,110,.764,58,119,177,68,20,79,11,126,395,1995/1996
"Cook,Anthony",7,16,.438,0,2,.000,7,14,.500,1,4,.250,5,7,12,2,0,1,1,8,15,1995/1996
"Corbin,Tyrone",155,351,.442,3,18,.167,152,333,.456,100,120,.833,81,163,244,84,63,67,20,147,413,1995/1996
"Corbin,Tyrone",117,259,.452,1,12,.083,116,247,.470,77,92,.837,55,124,179,61,47,50,17,96,312,1995/1996
"Corbin,Tyrone",38,92,.413,2,6,.333,36,86,.419,23,28,.821,26,39,65,23,16,17,3,51,101,1995/1996
"Courtney,Joe",15,35,.429,0,0,,15,35,.429,8,18,.444,24,25,49,9,5,17,6,35,38,1995/1996
"Crotty,John",51,114,.447,8,27,.296,43,87,.494,62,72,.861,20,34,54,102,22,51,6,60,172,1995/1996
"Cummings,Terry",270,584,.462,1,7,.143,269,577,.466,104,160,.650,162,283,445,89,56,69,30,263,645,1995/1996
"Curry,Dell",441,974,.453,164,406,.404,277,568,.488,146,171,.854,68,196,264,176,108,130,25,173,1192,1995/1996
"Curry,Michael",73,161,.453,20,53,.377,53,108,.491,45,62,.726,27,58,85,27,24,24,2,92,211,1995/1996
"Curry,Michael",3,10,.300,0,3,.000,3,7,.429,4,4,1.000,2,3,5,1,1,1,0,3,10,1995/1996
"Curry,Michael",70,151,.464,20,50,.400,50,101,.495,41,58,.707,25,55,80,26,23,23,2,89,201,1995/1996
"Cvetković,Rastko",5,16,.313,0,1,.000,5,15,.333,0,4,.000,4,7,11,3,2,3,1,11,10,1995/1996
"Danilović,Sasha",83,184,.451,34,78,.436,49,106,.462,55,72,.764,12,34,46,47,15,37,3,49,255,1995/1996
"Dare,Yinka",63,144,.438,0,0,,63,144,.438,38,62,.613,56,125,181,0,8,72,40,117,164,1995/1996
"Davis,Antonio",236,482,.490,1,2,.500,235,480,.490,246,345,.713,188,313,501,43,33,87,66,248,719,1995/1996
"Davis,Dale",334,599,.558,0,0,,334,599,.558,135,289,.467,252,457,709,76,56,119,112,238,803,1995/1996
"Davis,Hubert",275,566,.486,127,267,.476,148,299,.495,112,129,.868,35,88,123,103,31,63,8,120,789,1995/1996
"Davis,Mark",55,149,.369,4,13,.308,51,136,.375,74,116,.638,56,69,125,47,40,68,22,92,188,1995/1996
"Davis,Terry",55,108,.509,0,0,,55,108,.509,27,47,.574,43,74,117,21,10,25,4,66,137,1995/1996
"Day,Todd",299,817,.366,100,302,.331,199,515,.386,224,287,.780,70,154,224,107,81,109,51,225,922,1995/1996
"Day,Todd",22,71,.310,5,25,.200,17,46,.370,24,26,.923,8,14,22,5,4,11,3,27,73,1995/1996
"Day,Todd",277,746,.371,95,277,.343,182,469,.388,200,261,.766,62,140,202,102,77,98,48,198,849,1995/1996
"DeClercq,Andrew",24,50,.480,0,1,.000,24,49,.490,11,19,.579,18,21,39,9,7,4,5,30,59,1995/1996
"Dehere,Terry",315,686,.459,139,316,.440,176,370,.476,247,327,.755,41,102,143,350,54,191,16,239,1016,1995/1996
"Del Negro,Vinny",478,962,.497,57,150,.380,421,812,.518,178,214,.832,36,236,272,315,85,100,6,166,1191,1995/1996
"Dele,Bison",416,766,.543,1,6,.167,415,760,.546,196,267,.734,149,343,492,122,70,190,55,226,1029,1995/1996
"Demps,Dell",19,33,.576,1,2,.500,18,31,.581,14,17,.824,2,7,9,8,3,12,1,10,53,1995/1996
"Divac,Vlade",414,807,.513,3,18,.167,411,789,.521,189,295,.641,198,481,679,261,76,199,131,274,1020,1995/1996
"Douglas,Sherman",345,685,.504,40,110,.364,305,575,.530,160,219,.731,55,125,180,436,63,194,5,163,890,1995/1996
"Douglas,Sherman",36,84,.429,1,7,.143,35,77,.455,25,40,.625,6,17,23,39,2,29,0,16,98,1995/1996
"Douglas,Sherman",309,601,.514,39,103,.379,270,498,.542,135,179,.754,49,108,157,397,61,165,5,147,792,1995/1996
"Drexler,Clyde",331,764,.433,78,235,.332,253,529,.478,265,338,.784,97,276,373,302,105,134,24,153,1005,1995/1996
"Duckworth,Kevin",3,14,.214,0,0,,3,14,.214,3,6,.500,2,5,7,2,2,2,0,19,9,1995/1996
"Dudley,Chris",162,358,.453,0,1,.000,162,357,.454,80,157,.510,239,481,720,37,41,79,100,251,404,1995/1996
"Dumars,Joe",255,598,.426,121,298,.406,134,300,.447,162,197,.822,28,110,138,265,43,97,3,106,793,1995/1996
"Dumas,Richard",95,203,.468,2,9,.222,93,194,.479,49,70,.700,42,57,99,44,42,49,6,79,241,1995/1996
"Dumas,Tony",274,655,.418,74,207,.357,200,448,.446,154,257,.599,58,57,115,99,42,77,13,128,776,1995/1996
"Eackles,Ledell",161,377,.427,54,128,.422,107,249,.430,98,118,.831,44,104,148,86,28,57,3,84,474,1995/1996
"Earl,Acie",117,276,.424,0,3,.000,117,273,.429,82,114,.719,51,78,129,27,18,49,37,73,316,1995/1996
"Edney,Tyus",305,740,.412,53,144,.368,252,596,.423,197,252,.782,63,138,201,491,89,192,3,203,860,1995/1996
"Edwards,Blue",401,956,.419,84,245,.343,317,711,.446,157,208,.755,98,248,346,212,118,170,46,243,1043,1995/1996
"Edwards,Doug",32,91,.352,0,4,.000,32,87,.368,29,38,.763,35,52,87,39,10,29,18,51,93,1995/1996
"Edwards,James",41,110,.373,0,0,,41,110,.373,16,26,.615,15,25,40,11,1,21,8,61,98,1995/1996
"Edwards,Kevin",142,390,.364,42,104,.404,100,286,.350,68,84,.810,14,61,75,71,54,68,7,67,394,1995/1996
"Ehlo,Craig",253,591,.428,82,221,.371,171,370,.462,81,103,.786,65,191,256,138,85,104,9,138,669,1995/1996
"Eisley,Howard",104,242,.430,14,62,.226,90,180,.500,65,77,.844,22,56,78,146,29,77,3,130,287,1995/1996
"Elie,Mario",180,357,.504,41,127,.323,139,230,.604,98,115,.852,47,108,155,138,45,59,11,93,499,1995/1996
"Elliott,Sean",525,1127,.466,161,392,.411,364,735,.495,326,423,.771,69,327,396,211,69,198,33,178,1537,1995/1996
"Ellis,Dale",459,959,.479,150,364,.412,309,595,.519,136,179,.760,88,227,315,139,57,98,7,191,1204,1995/1996
"Ellis,LaPhonso",189,432,.438,4,22,.182,185,410,.451,89,148,.601,93,229,322,74,36,83,33,163,471,1995/1996
"Ellis,LeRon",5,22,.227,0,0,,5,22,.227,3,6,.500,5,3,8,4,2,3,3,11,13,1995/1996
"Ellison,Pervis",145,295,.492,0,0,,145,295,.492,75,117,.641,151,300,451,62,39,84,99,207,365,1995/1996
"Esposito,Vincenzo",36,100,.360,13,56,.232,23,44,.523,31,39,.795,4,12,16,23,7,39,0,27,116,1995/1996
"Ewing,Patrick",678,1456,.466,4,28,.143,674,1428,.472,351,461,.761,157,649,806,160,68,221,184,247,1711,1995/1996
"Ferrell,Duane",80,166,.482,0,8,.000,80,158,.506,42,57,.737,32,61,93,30,23,34,3,83,202,1995/1996
"Ferry,Danny",422,919,.459,143,363,.394,279,556,.502,103,134,.769,71,238,309,191,57,122,37,233,1090,1995/1996
"Finley,Michael",465,976,.476,61,186,.328,404,790,.511,242,323,.749,139,235,374,289,85,133,31,199,1233,1995/1996
"Fish,Matt",21,36,.583,0,0,,21,36,.583,10,19,.526,10,11,21,8,3,3,7,19,52,1995/1996
"Fish,Matt",6,10,.600,0,0,,6,10,.600,0,1,.000,3,0,3,1,0,0,1,3,12,1995/1996
"Fish,Matt",15,26,.577,0,0,,15,26,.577,10,18,.556,7,11,18,7,3,3,6,16,40,1995/1996
"Fleming,Vern",227,524,.433,3,28,.107,224,496,.452,133,177,.751,49,121,170,255,41,122,5,115,590,1995/1996
"Ford,Sherell",30,80,.375,4,25,.160,26,55,.473,26,34,.765,12,12,24,5,8,6,1,27,90,1995/1996
"Foster,Greg",107,244,.439,1,8,.125,106,236,.449,61,72,.847,53,125,178,25,7,58,22,120,276,1995/1996
"Fox,Rick",421,928,.454,99,272,.364,322,656,.491,196,254,.772,158,292,450,369,113,216,41,290,1137,1995/1996
"Gamble,Kevin",152,379,.401,44,114,.386,108,265,.408,38,48,.792,21,92,113,100,35,43,8,147,386,1995/1996
"Gamble,Kevin",117,297,.394,38,91,.418,79,206,.383,33,38,.868,14,72,86,82,31,32,5,119,305,1995/1996
"Gamble,Kevin",35,82,.427,6,23,.261,29,59,.492,5,10,.500,7,20,27,18,4,11,3,28,81,1995/1996
"Garnett,Kevin",361,735,.491,8,28,.286,353,707,.499,105,149,.705,175,326,501,145,86,110,131,189,835,1995/1996
"Gatling,Chris",326,567,.575,0,1,.000,326,566,.576,139,207,.671,129,288,417,43,36,95,40,217,791,1995/1996
"Gatling,Chris",171,308,.555,0,1,.000,171,307,.557,84,132,.636,78,164,242,26,19,60,29,135,426,1995/1996
"Gatling,Chris",155,259,.598,0,0,,155,259,.598,55,75,.733,51,124,175,17,17,35,11,82,365,1995/1996
"Gattison,Kenny",91,190,.479,0,0,,91,190,.479,47,78,.603,35,79,114,14,10,40,11,75,229,1995/1996
"Geiger,Matt",357,666,.536,3,8,.375,354,658,.538,149,205,.727,201,448,649,60,46,137,63,290,866,1995/1996
"Gill,Kendall",246,524,.469,26,79,.329,220,445,.494,138,176,.784,72,160,232,260,64,131,24,131,656,1995/1996
"Gill,Kendall",179,372,.481,17,54,.315,162,318,.509,89,117,.761,56,133,189,225,42,110,22,101,464,1995/1996
"Gill,Kendall",67,152,.441,9,25,.360,58,127,.457,49,59,.831,16,27,43,35,22,21,2,30,192,1995/1996
"Gilliam,Armen",576,1216,.474,0,1,.000,576,1215,.474,277,350,.791,241,472,713,140,73,177,53,180,1429,1995/1996
"Glass,Gerald",12,33,.364,1,6,.167,11,27,.407,1,1,1.000,6,2,8,4,3,0,1,10,26,1995/1996
"Glass,Gerald",10,28,.357,1,5,.200,9,23,.391,0,0,,5,1,6,4,2,0,1,5,21,1995/1996
"Glass,Gerald",2,5,.400,0,1,.000,2,4,.500,1,1,1.000,1,1,2,0,1,0,0,5,5,1995/1996
"Goldwire,Anthony",76,189,.402,33,83,.398,43,106,.406,46,60,.767,8,35,43,112,16,63,0,79,231,1995/1996
"Graham,Greg",78,193,.404,32,82,.390,46,111,.414,52,68,.765,17,40,57,52,25,46,1,64,240,1995/1996
"Graham,Greg",17,32,.531,7,14,.500,10,18,.556,15,17,.882,5,10,15,11,5,17,0,16,56,1995/1996
"Graham,Greg",61,161,.379,25,68,.368,36,93,.387,37,51,.725,12,30,42,41,20,29,1,48,184,1995/1996
"Grandison,Ron",22,58,.379,4,14,.286,18,44,.409,17,25,.680,20,35,55,13,12,12,2,31,65,1995/1996
"Grandison,Ron",13,39,.333,4,13,.308,9,26,.346,13,19,.684,14,22,36,10,8,11,1,27,43,1995/1996
"Grandison,Ron",2,4,.500,0,1,.000,2,3,.667,0,0,,1,5,6,1,0,0,0,0,4,1995/1996
"Grandison,Ron",7,15,.467,0,0,,7,15,.467,4,6,.667,5,8,13,2,4,1,1,4,18,1995/1996
"Grant,Brian",427,842,.507,4,17,.235,423,825,.513,262,358,.732,175,370,545,127,40,185,103,269,1120,1995/1996
"Grant,Gary",88,181,.486,8,24,.333,80,157,.510,48,58,.828,12,40,52,69,39,45,3,91,232,1995/1996
"Grant,Greg",35,99,.354,8,34,.235,27,65,.415,5,6,.833,7,27,34,97,22,30,2,43,83,1995/1996
"Grant,Greg",18,48,.375,4,18,.222,14,30,.467,5,6,.833,3,18,21,60,12,15,2,28,45,1995/1996
"Grant,Greg",11,28,.393,2,10,.200,9,18,.500,0,0,,1,5,6,23,8,10,0,8,24,1995/1996
"Grant,Greg",6,23,.261,2,6,.333,4,17,.235,0,0,,3,4,7,14,2,5,0,7,14,1995/1996
"Grant,Harvey",314,679,.462,21,67,.313,293,612,.479,60,110,.545,117,244,361,111,60,82,43,173,709,1995/1996
"Grant,Horace",347,677,.513,1,6,.167,346,671,.516,152,207,.734,178,402,580,170,62,64,74,144,847,1995/1996
"Green,A.C.",215,444,.484,14,52,.269,201,392,.513,168,237,.709,166,388,554,72,45,79,23,141,612,1995/1996
"Gugliotta,Tom",473,1004,.471,26,86,.302,447,918,.487,289,374,.773,176,514,690,238,139,234,96,265,1261,1995/1996
"Haley,Jack",2,6,.333,0,0,,2,6,.333,1,2,.500,1,1,2,0,0,1,0,2,5,1995/1996
"Hamilton,Thomas",9,31,.290,0,0,,9,31,.290,7,18,.389,10,12,22,1,0,9,9,12,25,1995/1996
"Hammink,Geert",2,4,.500,0,0,,2,4,.500,4,7,.571,2,2,4,0,0,2,0,2,8,1995/1996
"Hammink,Geert",1,2,.500,0,0,,1,2,.500,2,4,.500,2,1,3,0,0,2,0,1,4,1995/1996
"Hammink,Geert",1,2,.500,0,0,,1,2,.500,2,3,.667,0,1,1,0,0,0,0,1,4,1995/1996
"Hammonds,Tom",127,268,.474,0,0,,127,268,.474,88,115,.765,85,138,223,23,23,48,13,137,342,1995/1996
"Hancock,Darrin",112,214,.523,1,3,.333,111,211,.526,47,73,.644,40,58,98,47,28,56,5,94,272,1995/1996
"Hardaway,Anfernee",623,1215,.513,89,283,.314,534,932,.573,445,580,.767,129,225,354,582,166,229,41,160,1780,1995/1996
"Hardaway,Tim",419,992,.422,138,379,.364,281,613,.458,241,305,.790,35,194,229,640,132,235,17,201,1217,1995/1996
"Hardaway,Tim",255,606,.421,85,232,.366,170,374,.455,140,182,.769,22,109,131,360,74,125,11,131,735,1995/1996
"Hardaway,Tim",164,386,.425,53,147,.361,111,239,.464,101,123,.821,13,85,98,280,58,110,6,70,482,1995/1996
"Harper,Derek",436,939,.464,121,325,.372,315,614,.513,156,206,.757,32,170,202,352,131,178,5,201,1149,1995/1996
"Harper,Ron",234,501,.467,28,104,.269,206,397,.519,98,139,.705,74,139,213,208,105,73,32,137,594,1995/1996
"Harris,Lucious",183,397,.461,47,125,.376,136,272,.500,68,87,.782,41,81,122,79,35,46,3,56,481,1995/1996
"Harvey,Antonio",83,224,.371,0,2,.000,83,222,.374,38,83,.458,69,131,200,15,27,44,47,76,204,1995/1996
"Harvey,Antonio",39,95,.411,0,2,.000,39,93,.419,20,43,.465,27,67,94,9,14,18,21,38,98,1995/1996
"Harvey,Antonio",44,129,.341,0,0,,44,129,.341,18,40,.450,42,64,106,6,13,26,26,38,106,1995/1996
"Hawkins,Hersey",443,936,.473,146,380,.384,297,556,.534,249,285,.874,86,211,297,218,149,164,14,172,1281,1995/1996
"Heggs,Alvin",3,5,.600,0,0,,3,5,.600,2,3,.667,1,1,2,0,0,0,0,0,8,1995/1996
"Henderson,Alan",192,434,.442,0,3,.000,192,431,.445,119,200,.595,164,192,356,51,44,87,43,217,503,1995/1996
"Herrera,Carl",40,97,.412,0,1,.000,40,96,.417,5,17,.294,30,51,81,16,9,29,8,61,85,1995/1996
"Higgins,Sean",134,323,.415,48,129,.372,86,194,.443,35,37,.946,20,72,92,55,24,49,11,90,351,1995/1996
"Hill,Grant",564,1221,.462,5,26,.192,559,1195,.468,485,646,.751,127,656,783,548,100,263,48,242,1618,1995/1996
"Hill,Tyrone",130,254,.512,0,0,,130,254,.512,81,135,.600,94,150,244,33,31,64,20,144,341,1995/1996
"Hodge,Donald",9,24,.375,0,0,,9,24,.375,0,0,,9,14,23,4,1,2,8,26,18,1995/1996
"Hodge,Donald",9,24,.375,0,0,,9,24,.375,0,0,,9,13,22,4,1,2,8,26,18,1995/1996
"Hodge,Donald",0,0,,0,0,,0,0,,0,0,,0,1,1,0,0,0,0,0,0,1995/1996
"Hoiberg,Fred",8,19,.421,1,3,.333,7,16,.438,15,18,.833,4,5,9,8,6,7,1,12,32,1995/1996
"Hornacek,Jeff",442,880,.502,104,223,.466,338,657,.514,259,290,.893,62,147,209,340,106,127,20,171,1247,1995/1996
"Horry,Robert",300,732,.410,142,388,.366,158,344,.459,111,143,.776,97,315,412,281,116,160,109,197,853,1995/1996
"Houston,Allan",564,1244,.453,191,447,.427,373,797,.468,298,362,.823,54,246,300,250,61,233,16,233,1617,1995/1996
"Houston,Byron",32,64,.500,1,3,.333,31,61,.508,21,26,.808,31,53,84,7,13,17,7,59,86,1995/1996
"Howard,Juwan",733,1500,.489,4,13,.308,729,1487,.490,319,426,.749,188,472,660,360,67,303,39,269,1789,1995/1996
"Hunter,Lindsey",239,628,.381,117,289,.405,122,339,.360,84,120,.700,44,150,194,188,84,80,18,185,679,1995/1996
"Hurley,Bobby",65,230,.283,22,76,.289,43,154,.279,68,85,.800,12,63,75,216,28,86,3,121,220,1995/1996
"Jackson,Jaren",0,8,.000,0,5,.000,0,3,.000,8,10,.800,0,3,3,0,1,0,0,5,8,1995/1996
"Jackson,Jim",569,1308,.435,121,333,.363,448,975,.459,345,418,.825,173,237,410,235,47,191,22,165,1604,1995/1996
"Jackson,Mark",296,626,.473,64,149,.430,232,477,.486,150,191,.785,66,241,307,635,100,201,5,153,806,1995/1996
"James,Henry",10,24,.417,5,15,.333,5,9,.556,5,5,1.000,3,3,6,2,0,4,0,13,30,1995/1996
"Johnson,Avery",438,887,.494,6,31,.194,432,856,.505,189,262,.721,37,169,206,789,119,195,21,179,1071,1995/1996
"Johnson,Darryl",5,12,.417,0,1,.000,5,11,.455,2,2,1.000,2,0,2,1,0,1,0,3,12,1995/1996
"Johnson,Eddie",180,436,.413,45,128,.352,135,308,.438,70,79,.886,45,108,153,69,20,56,4,104,475,1995/1996
"Johnson,Ervin",180,352,.511,1,3,.333,179,349,.513,85,127,.669,129,304,433,48,40,98,129,245,446,1995/1996
"Johnson,Kevin",342,674,.507,21,57,.368,321,617,.520,342,398,.859,42,179,221,517,82,170,13,144,1047,1995/1996
"Johnson,Larry",583,1225,.476,67,183,.366,516,1042,.495,427,564,.757,249,434,683,355,55,182,43,173,1660,1995/1996
"Johnson,Magic",137,294,.466,22,58,.379,115,236,.487,172,201,.856,40,143,183,220,26,103,13,48,468,1995/1996
"Jones,Charles",6,19,.316,0,0,,6,19,.316,4,13,.308,28,46,74,12,5,3,24,44,16,1995/1996
"Jones,Eddie",337,685,.492,83,227,.366,254,458,.555,136,184,.739,45,188,233,246,129,99,45,162,893,1995/1996
"Jones,Popeye",327,733,.446,14,39,.359,313,694,.451,102,133,.767,260,477,737,132,54,109,27,262,770,1995/1996
"Jordan,Michael",916,1850,.495,111,260,.427,805,1590,.506,548,657,.834,148,395,543,352,180,197,42,195,2491,1995/1996
"Jordan,Reggie",36,71,.507,0,0,,36,71,.507,22,38,.579,23,29,52,29,12,19,7,30,94,1995/1996
"Keefe,Adam",180,346,.520,0,4,.000,180,342,.526,139,201,.692,176,279,455,64,51,88,41,174,499,1995/1996
"Kemp,Shawn",526,937,.561,5,12,.417,521,925,.563,493,664,.742,276,628,904,173,93,315,127,299,1550,1995/1996
"Kempton,Tim",0,0,,0,0,,0,0,,0,0,,0,2,2,1,0,1,0,5,0,1995/1996
"Kerr,Steve",244,482,.506,122,237,.515,122,245,.498,78,84,.929,25,85,110,192,63,42,2,109,688,1995/1996
"Kersey,Jerome",205,500,.410,3,17,.176,202,483,.418,97,147,.660,154,209,363,114,91,75,45,205,510,1995/1996
"Keys,Randolph",87,208,.418,22,71,.310,65,137,.474,36,43,.837,41,84,125,65,32,33,14,139,232,1995/1996
"Kidd,Jason",493,1293,.381,133,396,.336,360,897,.401,229,331,.692,203,350,553,783,175,328,26,155,1348,1995/1996
"King,Chris",250,585,.427,44,113,.389,206,472,.436,90,136,.662,102,183,285,104,68,103,33,163,634,1995/1996
"King,Frankie",3,11,.273,0,1,.000,3,10,.300,1,3,.333,1,1,2,2,2,2,0,4,7,1995/1996
"King,Jimmy",110,255,.431,5,34,.147,105,221,.475,54,77,.701,43,67,110,88,21,60,13,76,279,1995/1996
"King,Stacey",17,36,.472,0,0,,17,36,.472,4,8,.500,9,14,23,2,7,18,2,39,38,1995/1996
"Kleine,Joe",71,169,.420,2,7,.286,69,162,.426,20,25,.800,36,96,132,44,13,37,6,113,164,1995/1996
"Koncak,Jon",84,175,.480,3,9,.333,81,166,.488,32,57,.561,63,209,272,51,27,41,44,226,203,1995/1996
"Kukoč,Toni",386,787,.490,87,216,.403,299,571,.524,206,267,.772,115,208,323,287,64,114,28,150,1065,1995/1996
"Laettner,Christian",442,907,.487,9,39,.231,433,868,.499,324,396,.818,184,354,538,197,71,187,71,276,1217,1995/1996
"Laettner,Christian",283,582,.486,9,31,.290,274,551,.497,217,266,.816,98,204,302,129,40,112,43,157,792,1995/1996
"Laettner,Christian",159,325,.489,0,8,.000,159,317,.502,107,130,.823,86,150,236,68,31,75,28,119,425,1995/1996
"Lang,Andrew",353,790,.447,1,5,.200,352,785,.448,125,156,.801,153,302,455,65,42,124,126,241,832,1995/1996
"Lang,Andrew",281,619,.454,0,3,.000,281,616,.456,95,118,.805,111,223,334,62,35,94,85,178,657,1995/1996
"Lang,Andrew",72,171,.421,1,2,.500,71,169,.420,30,38,.789,42,79,121,3,7,30,41,63,175,1995/1996
"Lang,Antonio",41,77,.532,0,2,.000,41,75,.547,34,47,.723,17,36,53,12,14,24,12,61,116,1995/1996
"Leckner,Eric",18,29,.621,0,0,,18,29,.621,8,13,.615,8,26,34,1,2,11,4,30,44,1995/1996
"Legler,Tim",233,460,.507,128,245,.522,105,215,.488,132,153,.863,29,111,140,136,45,45,12,141,726,1995/1996
"Lenard,Voshon",53,141,.376,36,101,.356,17,40,.425,34,43,.791,12,40,52,31,6,23,1,31,176,1995/1996
"Lewis,Cedric",2,3,.667,0,0,,2,3,.667,0,0,,2,0,2,0,1,0,0,0,4,1995/1996
"Lewis,Martin",29,60,.483,2,7,.286,27,53,.509,15,25,.600,15,14,29,3,8,14,3,21,75,1995/1996
"Lister,Alton",51,105,.486,0,0,,51,105,.486,41,64,.641,67,213,280,19,6,48,42,136,143,1995/1996
"Lister,Alton",4,9,.444,0,0,,4,9,.444,2,2,1.000,7,22,29,4,0,4,3,15,10,1995/1996
"Lister,Alton",47,96,.490,0,0,,47,96,.490,39,62,.629,60,191,251,15,6,44,39,121,133,1995/1996
"Lohaus,Brad",71,175,.406,51,122,.418,20,53,.377,4,5,.800,7,57,64,44,10,20,17,70,197,1995/1996
"Lohaus,Brad",39,96,.406,27,65,.415,12,31,.387,2,3,.667,5,28,33,17,2,9,7,34,107,1995/1996
"Lohaus,Brad",32,79,.405,24,57,.421,8,22,.364,2,2,1.000,2,29,31,27,8,11,10,36,90,1995/1996
"Long,Grant",395,838,.471,31,86,.360,364,752,.484,257,337,.763,248,540,788,183,108,157,34,233,1078,1995/1996
"Longley,Luc",242,502,.482,0,0,,242,502,.482,80,103,.777,104,214,318,119,22,114,84,223,564,1995/1996
"Lynch,George",117,272,.430,4,13,.308,113,259,.436,53,80,.663,82,127,209,51,47,40,10,106,291,1995/1996
"Mack,Sam",121,287,.422,54,135,.400,67,152,.441,39,46,.848,18,80,98,79,22,28,9,75,335,1995/1996
"MacLean,Don",233,547,.426,14,49,.286,219,498,.440,145,198,.732,62,143,205,89,21,68,5,105,625,1995/1996
"Macon,Mark",29,67,.433,7,15,.467,22,52,.423,9,11,.818,10,12,22,16,15,9,0,34,74,1995/1996
"Mahorn,Rick",43,122,.352,0,1,.000,43,121,.355,34,47,.723,31,79,110,16,14,30,13,72,120,1995/1996
"Majerle,Dan",303,748,.405,146,414,.353,157,334,.470,120,169,.710,70,235,305,214,81,93,34,131,872,1995/1996
"Malone,Jeff",76,193,.394,5,16,.313,71,177,.401,29,32,.906,8,32,40,26,16,22,0,25,186,1995/1996
"Malone,Jeff",63,160,.394,5,16,.313,58,144,.403,24,26,.923,8,24,32,19,13,19,0,19,155,1995/1996
"Malone,Jeff",13,33,.394,0,0,,13,33,.394,5,6,.833,0,8,8,7,3,3,0,6,31,1995/1996
"Malone,Karl",789,1520,.519,16,40,.400,773,1480,.522,512,708,.723,175,629,804,345,138,199,56,245,2106,1995/1996
"Manning,Danny",178,388,.459,3,14,.214,175,374,.468,82,109,.752,30,113,143,65,38,77,24,121,441,1995/1996
"Manning,Rich",49,113,.434,0,1,.000,49,112,.438,9,14,.643,16,39,55,7,3,17,6,37,107,1995/1996
"Marčiulionis,Šarūnas",176,389,.452,64,157,.408,112,232,.483,155,200,.775,20,57,77,118,52,96,4,112,571,1995/1996
"Marshall,Donny",24,68,.353,7,30,.233,17,38,.447,22,35,.629,9,17,26,7,8,7,2,26,77,1995/1996
"Marshall,Donyell",125,314,.398,28,94,.298,97,220,.441,64,83,.771,65,148,213,49,22,48,31,83,342,1995/1996
"Martin,Cuonzo",3,5,.600,3,3,1.000,0,2,.000,0,2,.000,1,1,2,2,1,1,0,1,9,1995/1996
"Martin,Darrick",147,362,.406,20,69,.290,127,293,.433,101,120,.842,16,66,82,217,53,107,3,123,415,1995/1996
"Martin,Darrick",59,131,.450,5,22,.227,54,109,.495,38,46,.826,13,25,38,61,27,37,1,47,161,1995/1996
"Martin,Darrick",88,231,.381,15,47,.319,73,184,.397,63,74,.851,3,41,44,156,26,70,2,76,254,1995/1996
"Mashburn,Jamal",145,383,.379,35,102,.343,110,281,.391,97,133,.729,37,60,97,50,14,55,3,39,422,1995/1996
"Mason,Anthony",449,798,.563,0,0,,449,798,.563,298,414,.720,220,544,764,363,69,211,34,246,1196,1995/1996
"Massenburg,Tony",214,432,.495,0,3,.000,214,429,.499,111,157,.707,127,225,352,30,28,73,20,140,539,1995/1996
"Massenburg,Tony",100,196,.510,0,0,,100,196,.510,43,65,.662,52,114,166,18,13,35,9,67,243,1995/1996
"Massenburg,Tony",114,236,.483,0,3,.000,114,233,.489,68,92,.739,75,111,186,12,15,38,11,73,296,1995/1996
"Maxwell,Vernon",410,1052,.390,146,460,.317,264,592,.446,251,332,.756,39,190,229,330,96,215,12,182,1217,1995/1996
"Mayberry,Lee",153,364,.420,75,189,.397,78,175,.446,41,68,.603,21,69,90,302,64,89,10,144,422,1995/1996
"McCann,Bob",76,153,.497,1,2,.500,75,151,.497,35,74,.473,46,97,143,24,21,42,15,116,188,1995/1996
"McCloud,George",530,1281,.414,257,678,.379,273,603,.453,180,224,.804,116,263,379,212,113,166,38,212,1497,1995/1996
"McDaniel,Clint",8,23,.348,2,6,.333,6,17,.353,12,16,.750,3,7,10,7,5,2,0,10,30,1995/1996
"McDyess,Antonio",427,881,.485,0,4,.000,427,877,.487,166,243,.683,229,343,572,75,54,154,114,250,1020,1995/1996
"McIlvaine,Jim",62,145,.428,0,0,,62,145,.428,58,105,.552,66,164,230,11,21,36,166,171,182,1995/1996
"McKey,Derrick",346,712,.486,17,68,.250,329,644,.511,170,221,.769,123,238,361,262,83,143,44,246,879,1995/1996
"McKie,Aaron",337,722,.467,38,117,.325,299,605,.494,152,199,.764,86,218,304,205,92,135,21,205,864,1995/1996
"McMillan,Nate",100,238,.420,46,121,.380,54,117,.462,29,41,.707,41,169,210,197,95,75,18,143,275,1995/1996
"Meyer,Loren",145,330,.439,3,11,.273,142,319,.445,70,102,.686,114,205,319,57,20,67,32,224,363,1995/1996
"Miller,Anthony",15,35,.429,0,2,.000,15,33,.455,6,10,.600,11,14,25,4,4,8,1,19,36,1995/1996
"Miller,Oliver",418,795,.526,0,11,.000,418,784,.533,146,221,.661,177,385,562,219,108,202,143,277,982,1995/1996
"Miller,Reggie",504,1066,.473,168,410,.410,336,656,.512,430,498,.863,38,176,214,253,77,189,13,175,1606,1995/1996
"Mills,Chris",454,971,.468,79,210,.376,375,761,.493,218,263,.829,112,331,443,188,73,121,52,241,1205,1995/1996
"Mills,Terry",283,675,.419,82,207,.396,201,468,.429,121,157,.771,108,244,352,98,42,98,20,197,769,1995/1996
"Miner,Harold",23,52,.442,2,10,.200,21,42,.500,13,13,1.000,4,8,12,8,0,14,0,23,61,1995/1996
"Minor,Greg",320,640,.500,7,27,.259,313,613,.511,99,130,.762,93,164,257,146,36,78,11,161,746,1995/1996
"Mitchell,Sam",303,618,.490,1,18,.056,302,600,.503,237,291,.814,107,232,339,74,49,87,26,220,844,1995/1996
"Mobley,Eric",74,138,.536,1,2,.500,73,136,.537,39,87,.448,54,86,140,22,14,50,24,87,188,1995/1996
"Mobley,Eric",2,7,.286,0,0,,2,7,.286,2,4,.500,3,9,12,0,1,1,1,5,6,1995/1996
"Mobley,Eric",72,131,.550,1,2,.500,71,129,.550,37,83,.446,51,77,128,22,13,49,23,82,182,1995/1996
"Montross,Eric",196,346,.566,0,0,,196,346,.566,50,133,.376,119,233,352,43,19,83,29,181,442,1995/1996
"Moore,Tracy",30,76,.395,13,30,.433,17,46,.370,18,19,.947,10,12,22,6,2,8,0,16,91,1995/1996
"Morris,Chris",265,606,.437,63,197,.320,202,409,.494,98,127,.772,100,129,229,77,63,71,20,140,691,1995/1996
"Moten,Lawrence",112,247,.453,18,55,.327,94,192,.490,49,75,.653,36,25,61,50,29,44,8,54,291,1995/1996
"Mourning,Alonzo",563,1076,.523,9,30,.300,554,1046,.530,488,712,.685,218,509,727,159,70,262,189,245,1623,1995/1996
"Mullin,Chris",269,539,.499,59,150,.393,210,389,.540,137,160,.856,44,115,159,194,75,122,32,127,734,1995/1996
"Mundt,Todd",16,41,.390,0,0,,16,41,.390,5,8,.625,11,17,28,3,2,3,5,29,37,1995/1996
"Mundt,Todd",13,32,.406,0,0,,13,32,.406,5,8,.625,10,15,25,2,1,3,4,23,31,1995/1996
"Mundt,Todd",3,9,.333,0,0,,3,9,.333,0,0,,1,2,3,1,1,0,1,6,6,1995/1996
"Murdock,Eric",244,587,.416,45,145,.310,199,442,.450,114,143,.797,26,143,169,327,135,132,9,140,647,1995/1996
"Murdock,Eric",24,66,.364,6,23,.261,18,43,.419,8,12,.667,5,9,14,35,6,12,0,16,62,1995/1996
"Murdock,Eric",220,521,.422,39,122,.320,181,399,.454,106,131,.809,21,134,155,292,129,120,9,124,585,1995/1996
"Mureșan,Gheorghe",466,798,.584,0,1,.000,466,797,.585,172,278,.619,248,480,728,56,52,143,172,297,1104,1995/1996
"Murray,Lamond",257,575,.447,37,116,.319,220,459,.479,99,132,.750,89,157,246,84,61,108,25,151,650,1995/1996
"Murray,Tracy",496,1092,.454,151,358,.422,345,734,.470,182,219,.831,114,238,352,131,87,132,40,208,1325,1995/1996
"Mutombo,Dikembe",284,569,.499,0,1,.000,284,568,.500,246,354,.695,249,622,871,108,38,150,332,258,814,1995/1996
"Myers,Pete",91,247,.368,14,58,.241,77,189,.407,80,122,.656,35,105,140,145,34,81,17,132,276,1995/1996
"Myers,Pete",62,160,.388,11,42,.262,51,118,.432,49,76,.645,21,52,73,97,14,56,11,75,184,1995/1996
"Myers,Pete",29,87,.333,3,16,.188,26,71,.366,31,46,.674,14,53,67,48,20,25,6,57,92,1995/1996
"Nathan,Howard",5,9,.556,0,1,.000,5,8,.625,3,4,.750,0,0,0,2,3,8,0,2,13,1995/1996
"Newman,Johnny",321,649,.495,61,162,.377,260,487,.534,186,232,.802,66,134,200,154,90,108,15,257,889,1995/1996
"Norman,Ken",127,273,.465,33,84,.393,94,189,.497,17,48,.354,40,92,132,63,15,46,16,68,304,1995/1996
"O'Bannon,Ed",156,400,.390,10,56,.179,146,344,.424,77,108,.713,65,103,168,63,44,62,11,95,399,1995/1996
"O'Neal,Shaquille",592,1033,.573,1,2,.500,591,1031,.573,249,511,.487,182,414,596,155,34,155,115,193,1434,1995/1996
"O'Sullivan,Dan",13,35,.371,0,1,.000,13,34,.382,7,8,.875,13,19,32,2,2,5,4,13,33,1995/1996
"Oakley,Charles",211,448,.471,7,26,.269,204,422,.483,175,210,.833,162,298,460,137,58,104,14,195,604,1995/1996
"Olajuwon,Hakeem",768,1494,.514,3,14,.214,765,1480,.517,397,548,.724,176,608,784,257,113,247,207,242,1936,1995/1996
"Ostertag,Greg",86,182,.473,0,0,,86,182,.473,36,54,.667,57,118,175,5,5,25,63,91,208,1995/1996
"Outlaw,Bo",107,186,.575,0,3,.000,107,183,.585,72,162,.444,87,113,200,50,44,45,91,127,286,1995/1996
"Overton,Doug",67,178,.376,8,26,.308,59,152,.388,40,55,.727,8,55,63,106,13,40,5,49,182,1995/1996
"Owens,Billy",323,673,.480,5,18,.278,318,655,.485,157,247,.636,143,268,411,204,49,164,38,192,808,1995/1996
"Owens,Billy",239,473,.505,0,6,.000,239,467,.512,112,177,.633,94,192,286,134,30,113,22,132,590,1995/1996
"Owens,Billy",84,200,.420,5,12,.417,79,188,.420,45,70,.643,49,76,125,70,19,51,16,60,218,1995/1996
"Pack,Robert",190,444,.428,26,98,.265,164,346,.474,154,182,.846,29,103,132,242,62,114,1,68,560,1995/1996
"Parish,Robert",120,241,.498,0,0,,120,241,.498,50,71,.704,89,214,303,29,21,50,54,80,290,1995/1996
"Parks,Cherokee",101,247,.409,7,26,.269,94,221,.425,41,62,.661,66,150,216,29,25,31,32,100,250,1995/1996
"Payton,Gary",618,1276,.484,98,299,.328,520,977,.532,229,306,.748,104,235,339,608,231,260,19,221,1563,1995/1996
"Peeler,Anthony",272,602,.452,105,254,.413,167,348,.480,61,86,.709,45,92,137,118,59,56,10,139,710,1995/1996
"Peplowski,Mike",3,5,.600,0,0,,3,5,.600,1,3,.333,1,3,4,1,1,2,2,10,7,1995/1996
"Peplowski,Mike",0,0,,0,0,,0,0,,0,0,,0,0,0,0,0,0,0,4,0,1995/1996
"Peplowski,Mike",3,5,.600,0,0,,3,5,.600,1,3,.333,1,3,4,1,1,2,2,6,7,1995/1996
"Perdue,Will",173,331,.523,0,1,.000,173,330,.524,67,125,.536,175,310,485,33,28,86,75,183,413,1995/1996
"Perkins,Sam",325,797,.408,129,363,.355,196,434,.452,191,241,.793,101,266,367,120,83,82,48,174,970,1995/1996
"Perry,Elliot",261,549,.475,24,59,.407,237,490,.484,151,194,.778,34,102,136,353,87,146,5,140,697,1995/1996
"Perry,Tim",31,65,.477,4,8,.500,27,57,.474,5,9,.556,21,27,48,8,4,10,13,16,71,1995/1996
"Perry,Tim",8,18,.444,1,1,1.000,7,17,.412,2,3,.667,6,7,13,2,2,3,3,5,19,1995/1996
"Perry,Tim",23,47,.489,3,7,.429,20,40,.500,3,6,.500,15,20,35,6,2,7,10,11,52,1995/1996
"Person,Chuck",308,705,.437,190,463,.410,118,242,.488,67,104,.644,76,337,413,100,49,91,26,197,873,1995/1996
"Person,Wesley",390,877,.445,117,313,.374,273,564,.484,148,192,.771,56,265,321,138,55,89,22,148,1045,1995/1996
"Phills,Bobby",386,826,.467,93,211,.441,293,615,.476,186,240,.775,62,199,261,271,102,126,27,192,1051,1995/1996
"Piatkowski,Eric",98,242,.405,38,114,.333,60,128,.469,67,82,.817,40,63,103,48,24,45,10,83,301,1995/1996
"Pierce,Ricky",264,590,.447,35,104,.337,229,486,.471,174,205,.849,40,96,136,101,57,93,6,188,737,1995/1996
"Pinckney,Ed",171,335,.510,0,3,.000,171,332,.515,136,179,.760,189,269,458,72,64,77,28,156,478,1995/1996
"Pinckney,Ed",117,233,.502,0,3,.000,117,230,.509,94,124,.758,115,167,282,50,31,54,17,101,328,1995/1996
"Pinckney,Ed",54,102,.529,0,0,,54,102,.529,42,55,.764,74,102,176,22,33,23,11,55,150,1995/1996
"Pippen,Scottie",563,1216,.463,150,401,.374,413,815,.507,220,324,.679,152,344,496,452,133,207,57,198,1496,1995/1996
"Polynice,Olden",431,818,.527,1,3,.333,430,815,.528,122,203,.601,257,507,764,58,52,127,66,250,985,1995/1996
"Porter,Terry",269,608,.442,71,226,.314,198,382,.518,164,209,.785,36,176,212,452,89,173,15,154,773,1995/1996
"Price,Brent",252,534,.472,139,301,.462,113,233,.485,167,191,.874,38,190,228,416,78,153,4,184,810,1995/1996
"Price,Mark",18,60,.300,10,30,.333,8,30,.267,10,10,1.000,1,6,7,18,6,10,0,7,56,1995/1996
"Pritchard,Kevin",2,3,.667,1,1,1.000,1,2,.500,2,3,.667,0,2,2,7,2,0,0,3,7,1995/1996
"Ratliff,Theo",128,230,.557,0,1,.000,128,229,.559,85,120,.708,110,187,297,13,16,56,116,144,341,1995/1996
"Rađa,Dino",426,852,.500,0,0,,426,852,.500,191,275,.695,113,409,522,83,48,117,81,161,1043,1995/1996
"Recasner,Eldridge",149,359,.415,81,191,.424,68,168,.405,57,66,.864,31,113,144,170,23,61,5,111,436,1995/1996
"Reeves,Bryant",401,877,.457,0,3,.000,401,874,.459,219,299,.732,178,392,570,109,43,157,55,226,1021,1995/1996
"Reeves,Khalid",95,227,.419,28,91,.308,67,136,.493,61,82,.744,18,61,79,118,37,63,3,115,279,1995/1996
"Reeves,Khalid",54,118,.458,11,36,.306,43,82,.524,43,51,.843,11,29,40,72,16,30,1,46,162,1995/1996
"Reeves,Khalid",41,109,.376,17,55,.309,24,54,.444,18,31,.581,7,32,39,46,21,33,2,69,117,1995/1996
"Reid,Don",106,187,.567,0,0,,106,187,.567,51,77,.662,78,125,203,11,47,41,40,199,263,1995/1996
"Reid,J.R.",160,324,.494,0,1,.000,160,323,.495,107,142,.754,73,182,255,42,43,79,17,187,427,1995/1996
"Reid,J.R.",72,164,.439,0,1,.000,72,163,.442,64,87,.736,35,88,123,14,25,49,10,98,208,1995/1996
"Reid,J.R.",88,160,.550,0,0,,88,160,.550,43,55,.782,38,94,132,28,18,30,7,89,219,1995/1996
"Rencher,Terrence",33,100,.330,9,29,.310,24,71,.338,31,46,.674,9,35,44,54,16,43,2,37,106,1995/1996
"Rencher,Terrence",32,99,.323,9,29,.310,23,70,.329,30,43,.698,9,33,42,54,16,41,1,36,103,1995/1996
"Rencher,Terrence",1,1,1.000,0,0,,1,1,1.000,1,3,.333,0,2,2,0,0,2,1,1,3,1995/1996
"Respert,Shawn",113,292,.387,42,122,.344,71,170,.418,35,42,.833,28,46,74,68,32,42,4,67,303,1995/1996
"Reynolds,Jerry",21,53,.396,1,10,.100,20,43,.465,13,21,.619,13,20,33,12,15,16,6,20,56,1995/1996
"Rice,Glen",610,1296,.471,171,403,.424,439,893,.492,319,381,.837,86,292,378,232,91,163,19,217,1710,1995/1996
"Richardson,Pooh",281,664,.423,94,245,.384,187,419,.446,78,105,.743,35,123,158,340,77,95,13,134,734,1995/1996
"Richmond,Mitch",611,1368,.447,225,515,.437,386,853,.453,425,491,.866,54,215,269,255,125,220,19,233,1872,1995/1996
"Rider,Isaiah",560,1206,.464,102,275,.371,458,931,.492,248,296,.838,99,210,309,213,48,201,23,204,1470,1995/1996
"Riley,Eric",35,74,.473,0,1,.000,35,73,.479,22,28,.786,32,44,76,5,8,17,16,42,92,1995/1996
"Rivers,Doc",108,290,.372,47,137,.343,61,153,.399,48,64,.750,30,108,138,123,73,57,21,175,311,1995/1996
"Roberts,Fred",48,97,.495,4,14,.286,44,83,.530,22,28,.786,18,29,47,26,16,24,4,24,122,1995/1996
"Roberts,Stanley",141,304,.464,0,0,,141,304,.464,74,133,.556,42,120,162,41,15,48,39,153,356,1995/1996
"Robertson,Alvin",285,607,.470,41,151,.272,244,456,.535,107,158,.677,110,232,342,323,166,183,36,268,718,1995/1996
"Robinson,Clifford",553,1306,.423,178,471,.378,375,835,.449,360,542,.664,123,320,443,190,86,194,68,248,1644,1995/1996
"Robinson,David",711,1378,.516,3,9,.333,708,1369,.517,626,823,.761,319,681,1000,247,111,190,271,262,2051,1995/1996
"Robinson,Glenn",627,1382,.454,90,263,.342,537,1119,.480,316,389,.812,136,368,504,293,95,282,42,236,1660,1995/1996
"Robinson,James",229,574,.399,102,284,.359,127,290,.438,89,135,.659,44,113,157,150,34,111,16,146,649,1995/1996
"Robinson,Rumeal",92,221,.416,30,79,.380,62,142,.437,33,51,.647,19,59,78,142,26,72,5,79,247,1995/1996
"Rodman,Dennis",146,304,.480,3,27,.111,143,277,.516,56,106,.528,356,596,952,160,36,138,27,196,351,1995/1996
"Roe,Lou",32,90,.356,2,9,.222,30,81,.370,24,32,.750,30,48,78,15,10,17,8,42,90,1995/1996
"Rogers,Carlos",178,344,.517,3,21,.143,175,323,.542,71,130,.546,80,90,170,35,25,61,48,87,430,1995/1996
"Rogers,Rodney",306,641,.477,49,153,.320,257,488,.527,113,180,.628,113,173,286,167,75,144,35,216,774,1995/1996
"Rooks,Sean",144,285,.505,1,7,.143,143,278,.514,135,202,.668,81,174,255,47,23,80,42,141,424,1995/1996
"Rooks,Sean",112,227,.493,1,6,.167,111,221,.502,106,159,.667,60,144,204,38,19,49,28,106,331,1995/1996
"Rooks,Sean",32,58,.552,0,1,.000,32,57,.561,29,43,.674,21,30,51,9,4,31,14,35,93,1995/1996
"Rose,Jalen",290,604,.480,32,108,.296,258,496,.520,191,277,.690,46,214,260,495,53,234,39,229,803,1995/1996
"Royal,Donald",106,216,.491,0,2,.000,106,214,.495,125,164,.762,57,96,153,42,29,52,15,97,337,1995/1996
"Rozier,Clifford",79,135,.585,0,2,.000,79,133,.594,26,55,.473,71,100,171,22,19,40,30,135,184,1995/1996
"Ruffin,Trevor",263,648,.406,104,284,.366,159,364,.437,148,182,.813,21,111,132,269,43,149,2,132,778,1995/1996
"Rusconi,Stefano",3,9,.333,0,0,,3,9,.333,2,5,.400,3,3,6,3,0,3,2,10,8,1995/1996
"Russell,Bryon",56,142,.394,14,40,.350,42,102,.412,48,67,.716,28,62,90,29,29,36,8,66,174,1995/1996
"Sabonis,Arvydas",394,723,.545,39,104,.375,355,619,.574,231,305,.757,147,441,588,130,64,154,78,211,1058,1995/1996
"Salley,John",63,140,.450,0,0,,63,140,.450,59,85,.694,46,94,140,54,19,55,27,110,185,1995/1996
"Salley,John",51,105,.486,0,0,,51,105,.486,47,65,.723,26,71,97,39,11,39,12,72,149,1995/1996
"Salley,John",12,35,.343,0,0,,12,35,.343,12,20,.600,20,23,43,15,8,16,15,38,36,1995/1996
"Schayes,Danny",32,94,.340,0,0,,32,94,.340,37,46,.804,29,60,89,9,11,23,16,60,101,1995/1996
"Scheffler,Steve",24,45,.533,1,5,.200,23,40,.575,9,19,.474,15,18,33,2,6,8,2,25,58,1995/1996
"Schintzius,Dwayne",49,110,.445,0,0,,49,110,.445,13,21,.619,23,55,78,14,9,19,12,53,111,1995/1996
"Schrempf,Detlef",360,740,.486,73,179,.408,287,561,.512,287,370,.776,73,255,328,276,56,146,8,179,1080,1995/1996
"Scott,Byron",271,676,.401,74,221,.335,197,455,.433,203,243,.835,40,152,192,123,63,100,22,126,819,1995/1996
"Scott,Dennis",491,1117,.440,267,628,.425,224,489,.458,182,222,.820,63,246,309,243,90,122,29,169,1431,1995/1996
"Sealy,Malik",272,655,.415,21,100,.210,251,555,.452,147,184,.799,76,164,240,116,84,113,28,150,712,1995/1996
"Seikaly,Rony",285,568,.502,2,3,.667,283,565,.501,204,282,.723,166,333,499,71,40,180,69,219,776,1995/1996
"Shaw,Brian",182,486,.374,41,144,.285,141,342,.412,91,114,.798,58,166,224,336,58,173,11,160,496,1995/1996
"Simmons,Lionel",86,217,.396,19,51,.373,67,166,.404,55,75,.733,41,104,145,83,31,51,20,85,246,1995/1996
"Simpkins,Dickey",77,160,.481,1,1,1.000,76,159,.478,61,97,.629,66,90,156,38,9,56,8,78,216,1995/1996
"Skiles,Scott",20,57,.351,15,34,.441,5,23,.217,8,10,.800,1,15,16,38,7,16,0,21,63,1995/1996
"Slater,Reggie",14,27,.519,0,0,,14,27,.519,3,7,.429,4,11,15,2,2,9,3,11,31,1995/1996
"Slater,Reggie",3,5,.600,0,0,,3,5,.600,0,0,,0,3,3,0,1,3,2,1,6,1995/1996
"Slater,Reggie",6,11,.545,0,0,,6,11,.545,2,5,.400,3,4,7,2,1,3,1,4,14,1995/1996
"Slater,Reggie",5,11,.455,0,0,,5,11,.455,1,2,.500,1,4,5,0,0,3,0,6,11,1995/1996
"Smith,Charles",3,10,.300,0,3,.000,3,7,.429,0,2,.000,0,5,5,6,1,5,0,7,6,1995/1996
"Smith,Charles",244,578,.422,2,15,.133,242,563,.430,119,163,.730,133,229,362,65,50,106,80,224,609,1995/1996
"Smith,Charles",114,294,.388,2,15,.133,112,279,.401,73,103,.709,59,101,160,29,18,61,51,124,303,1995/1996
"Smith,Charles",130,284,.458,0,0,,130,284,.458,46,60,.767,74,128,202,36,32,45,29,100,306,1995/1996
"Smith,Doug",14,39,.359,0,0,,14,39,.359,5,8,.625,12,10,22,4,3,11,0,21,33,1995/1996
"Smith,Joe",469,1024,.458,10,28,.357,459,996,.461,303,392,.773,300,417,717,79,85,138,134,224,1251,1995/1996
"Smith,Kenny",201,464,.433,91,238,.382,110,226,.487,87,106,.821,21,75,96,245,47,100,3,116,580,1995/1996
"Smith,Michael",144,238,.605,1,1,1.000,143,237,.603,68,177,.384,143,246,389,110,47,72,46,166,357,1995/1996
"Smith,Steve",494,1143,.432,140,423,.331,354,720,.492,318,385,.826,124,202,326,224,68,151,17,207,1446,1995/1996
"Smith,Tony",116,274,.423,38,116,.328,78,158,.494,28,46,.609,30,65,95,154,37,66,10,106,298,1995/1996
"Smith,Tony",70,173,.405,25,77,.325,45,96,.469,24,37,.649,24,32,56,86,21,40,5,60,189,1995/1996
"Smith,Tony",46,101,.455,13,39,.333,33,62,.532,4,9,.444,6,33,39,68,16,26,5,46,109,1995/1996
"Smits,Rik",466,894,.521,1,5,.200,465,889,.523,231,293,.788,119,314,433,110,21,160,45,226,1164,1995/1996
"Snow,Eric",42,100,.420,2,10,.200,40,90,.444,29,49,.592,9,34,43,73,28,38,0,53,115,1995/1996
"Spencer,Elmore",5,13,.385,0,0,,5,13,.385,4,6,.667,3,10,13,1,0,6,2,12,14,1995/1996
"Spencer,Elmore",0,1,.000,0,0,,0,1,.000,0,0,,1,3,4,0,0,3,0,8,0,1995/1996
"Spencer,Elmore",5,12,.417,0,0,,5,12,.417,4,6,.667,2,7,9,1,0,3,2,4,14,1995/1996
"Spencer,Felton",146,281,.520,0,0,,146,281,.520,104,151,.689,100,206,306,11,20,77,54,240,396,1995/1996
"Sprewell,Latrell",515,1202,.428,91,282,.323,424,920,.461,352,446,.789,124,256,380,328,127,222,45,150,1473,1995/1996
"Stackhouse,Jerry",452,1091,.414,93,292,.318,359,799,.449,387,518,.747,90,175,265,278,76,252,79,179,1384,1995/1996
"Starks,John",375,846,.443,143,396,.361,232,450,.516,131,174,.753,31,206,237,315,103,156,11,226,1024,1995/1996
"Stith,Bryant",379,911,.416,41,148,.277,338,763,.443,320,379,.844,125,275,400,241,114,157,16,187,1119,1995/1996
"Stockton,John",440,818,.538,95,225,.422,345,593,.582,234,282,.830,54,172,226,916,140,246,15,207,1209,1995/1996
"Stoudamire,Damon",481,1129,.426,133,337,.395,348,792,.439,236,296,.797,59,222,281,653,98,267,19,166,1331,1995/1996
"Strickland,Rod",471,1023,.460,38,111,.342,433,912,.475,276,423,.652,89,208,297,640,97,255,16,135,1256,1995/1996
"Strong,Derek",72,169,.426,1,9,.111,71,160,.444,69,85,.812,60,118,178,32,18,20,12,80,214,1995/1996
"Sura,Bob",148,360,.411,27,78,.346,121,282,.429,99,141,.702,34,101,135,233,56,115,21,126,422,1995/1996
"Sutton,Greg",85,217,.392,47,117,.402,38,100,.380,35,46,.761,8,42,50,102,25,62,2,92,252,1995/1996
"Sutton,Greg",20,50,.400,7,21,.333,13,29,.448,15,19,.789,4,11,15,39,8,17,0,36,62,1995/1996
"Sutton,Greg",65,167,.389,40,96,.417,25,71,.352,20,27,.741,4,31,35,63,17,45,2,56,190,1995/1996
"Sykes,Larry",0,0,,0,0,,0,0,,0,0,,1,1,2,0,0,1,0,0,0,1995/1996
"Tabak,Žan",225,414,.543,0,1,.000,225,413,.545,64,114,.561,117,203,320,62,24,101,31,204,514,1995/1996
"Thomas,Kurt",274,547,.501,0,2,.000,274,545,.503,118,178,.663,122,317,439,46,47,98,36,271,666,1995/1996
"Thompson,Brooks",48,103,.466,25,64,.391,23,39,.590,19,27,.704,4,20,24,31,12,24,0,35,140,1995/1996
"Thompson,LaSalle",33,83,.398,0,0,,33,83,.398,19,24,.792,62,137,199,26,19,37,20,125,85,1995/1996
"Thornton,Bob",1,6,.167,0,0,,1,6,.167,1,2,.500,6,6,12,0,1,1,0,7,3,1995/1996
"Thorpe,Otis",452,853,.530,0,4,.000,452,849,.532,257,362,.710,211,477,688,158,53,195,39,300,1161,1995/1996
"Threatt,Sedale",241,526,.458,60,169,.355,181,357,.507,54,71,.761,20,75,95,269,68,74,11,178,596,1995/1996
"Tisdale,Wayman",279,564,.495,0,0,,279,564,.495,114,149,.765,55,159,214,58,15,63,36,188,672,1995/1996
"Toolson,Andy",8,22,.364,3,12,.250,5,10,.500,3,4,.750,0,6,6,1,0,2,0,12,22,1995/1996
"Tower,Keith",32,72,.444,0,1,.000,32,71,.451,18,26,.692,22,29,51,5,4,16,11,50,82,1995/1996
"Trent,Gary",220,429,.513,0,9,.000,220,420,.524,78,141,.553,84,154,238,50,25,92,11,116,518,1995/1996
"Turner,Jeff",18,51,.353,9,27,.333,9,24,.375,2,2,1.000,10,18,28,6,2,11,1,33,47,1995/1996
"Van Exel,Nick",396,950,.417,144,403,.357,252,547,.461,163,204,.799,29,152,181,509,70,156,10,115,1099,1995/1996
"Vander Velden,Logan",3,14,.214,0,5,.000,3,9,.333,3,4,.750,1,5,6,1,0,0,0,4,9,1995/1996
"Vaughn,David",27,80,.338,0,1,.000,27,79,.342,10,18,.556,33,47,80,8,6,18,15,68,64,1995/1996
"Vaught,Loy",571,1087,.525,7,19,.368,564,1068,.528,149,205,.727,204,604,808,112,87,158,40,241,1298,1995/1996
"Wallace,Rasheed",275,565,.487,27,82,.329,248,483,.513,78,120,.650,93,210,303,85,42,103,54,206,655,1995/1996
"Walters,Rex",61,148,.412,22,66,.333,39,82,.476,42,52,.808,13,42,55,106,25,41,4,53,186,1995/1996
"Walters,Rex",12,33,.364,3,12,.250,9,21,.429,6,6,1.000,2,5,7,11,3,7,0,4,33,1995/1996
"Walters,Rex",49,115,.426,19,54,.352,30,61,.492,36,46,.783,11,37,48,95,22,34,4,49,153,1995/1996
"Ward,Charlie",87,218,.399,33,99,.333,54,119,.454,37,54,.685,29,73,102,132,54,79,6,98,244,1995/1996
"Watson,Jamie",18,43,.419,3,7,.429,15,36,.417,9,13,.692,5,22,27,24,8,17,2,30,48,1995/1996
"Weatherspoon,Clarence",491,1015,.484,0,2,.000,491,1013,.485,318,426,.746,237,516,753,158,112,179,108,214,1300,1995/1996
"Webb,Spud",186,430,.433,47,129,.364,139,301,.462,125,145,.862,26,74,100,294,52,110,7,109,544,1995/1996
"Webb,Spud",104,222,.468,18,57,.316,86,165,.521,74,87,.851,19,41,60,140,27,51,2,68,300,1995/1996
"Webb,Spud",82,208,.394,29,72,.403,53,136,.390,51,58,.879,7,33,40,154,25,59,5,41,244,1995/1996
"Webber,Chris",150,276,.543,15,34,.441,135,242,.558,41,69,.594,37,77,114,75,27,49,9,51,356,1995/1996
"Webster,Jeff",8,23,.348,2,6,.333,6,17,.353,0,0,,2,5,7,3,4,3,0,7,18,1995/1996
"Wennington,Bill",169,343,.493,1,1,1.000,168,342,.491,37,43,.860,58,116,174,46,21,37,16,171,376,1995/1996
"Werdann,Robert",16,32,.500,0,0,,16,32,.500,7,13,.538,5,18,23,2,5,6,3,17,39,1995/1996
"Wesley,David",338,736,.459,116,272,.426,222,464,.478,217,288,.753,68,196,264,390,100,159,11,207,1009,1995/1996
"West,Doug",175,393,.445,1,13,.077,174,380,.458,114,144,.792,48,113,161,119,30,81,17,228,465,1995/1996
"West,Mark",61,126,.484,0,0,,61,126,.484,28,45,.622,49,84,133,6,6,35,37,135,150,1995/1996
"Whitfield,Dwayne",13,30,.433,0,0,,13,30,.433,14,22,.636,9,16,25,2,3,8,2,14,40,1995/1996
"Whitney,Chris",45,99,.455,19,44,.432,26,55,.473,41,44,.932,2,31,33,51,18,23,1,46,150,1995/1996
"Wilkins,Gerald",77,205,.376,14,64,.219,63,141,.447,20,23,.870,22,43,65,68,22,37,2,55,188,1995/1996
"Williams,Buck",192,384,.500,2,3,.667,190,381,.499,125,187,.668,159,245,404,42,40,90,47,187,511,1995/1996
"Williams,Eric",241,546,.441,3,10,.300,238,536,.444,200,298,.671,92,125,217,70,56,88,11,147,685,1995/1996
"Williams,Herb",62,152,.408,1,4,.250,61,148,.412,13,20,.650,15,75,90,27,14,22,33,79,138,1995/1996
"Williams,Herb",3,8,.375,0,0,,3,8,.375,0,0,,1,7,8,0,1,0,2,4,6,1995/1996
"Williams,Herb",59,144,.410,1,4,.250,58,140,.414,13,20,.650,14,68,82,27,13,22,31,75,132,1995/1996
"Williams,Hot Rod",180,397,.453,0,1,.000,180,396,.455,95,130,.731,129,243,372,62,46,62,90,170,455,1995/1996
"Williams,Jayson",279,660,.423,2,7,.286,277,653,.424,161,272,.592,342,461,803,47,35,106,57,238,721,1995/1996
"Williams,Lorenzo",87,214,.407,0,1,.000,87,213,.408,24,70,.343,234,287,521,85,48,78,122,226,198,1995/1996
"Williams,Micheal",13,40,.325,1,3,.333,12,37,.324,28,33,.848,3,20,23,31,5,23,3,37,55,1995/1996
"Williams,Monty",27,68,.397,0,1,.000,27,67,.403,14,20,.700,20,20,40,8,6,18,2,26,68,1995/1996
"Williams,Monty",7,22,.318,0,0,,7,22,.318,5,8,.625,9,8,17,4,2,5,0,9,19,1995/1996
"Williams,Monty",20,46,.435,0,1,.000,20,45,.444,9,12,.750,11,12,23,4,4,13,2,17,49,1995/1996
"Williams,Reggie",94,254,.370,20,89,.225,74,165,.448,33,39,.846,25,97,122,74,34,51,21,137,241,1995/1996
"Williams,Scott",15,29,.517,0,2,.000,15,27,.556,10,12,.833,13,33,46,5,6,8,7,27,40,1995/1996
"Williams,Walt",359,808,.444,114,293,.389,245,515,.476,163,232,.703,99,220,319,230,85,151,58,238,995,1995/1996
"Williams,Walt",235,540,.435,58,170,.341,177,370,.478,130,172,.756,62,145,207,165,53,103,42,151,658,1995/1996
"Williams,Walt",124,268,.463,56,123,.455,68,145,.469,33,60,.550,37,75,112,65,32,48,16,87,337,1995/1996
"Williamson,Corliss",125,268,.466,0,3,.000,125,265,.472,47,84,.560,56,58,114,23,11,76,9,115,297,1995/1996
"Willis,Kevin",325,712,.456,1,9,.111,324,703,.461,143,202,.708,208,430,638,53,32,161,41,253,794,1995/1996
"Willis,Kevin",195,412,.473,0,5,.000,195,407,.479,89,125,.712,134,286,420,34,19,99,25,158,479,1995/1996
"Willis,Kevin",130,300,.433,1,4,.250,129,296,.436,54,77,.701,74,144,218,19,13,62,16,95,315,1995/1996
"Wilson,Trevor",10,20,.500,0,0,,10,20,.500,3,4,.750,7,7,14,4,3,1,0,9,23,1995/1996
"Wingate,David",88,212,.415,15,34,.441,73,178,.410,32,41,.780,17,39,56,58,20,42,4,66,223,1995/1996
"Wingfield,Dontonio",60,157,.382,19,63,.302,41,94,.436,26,34,.765,45,59,104,28,20,31,6,73,165,1995/1996
"Wolf,Joe",135,263,.513,0,6,.000,135,257,.525,21,29,.724,49,138,187,63,15,42,5,163,291,1995/1996
"Wolf,Joe",0,1,.000,0,0,,0,1,.000,0,0,,0,2,2,0,2,2,0,2,0,1995/1996
"Wolf,Joe",135,262,.515,0,6,.000,135,256,.527,21,29,.724,49,136,185,63,13,40,5,161,291,1995/1996
"Wood,David",75,174,.431,20,62,.323,55,112,.491,38,50,.760,51,103,154,34,19,24,10,150,208,1995/1996
"Wood,David",7,14,.500,1,3,.333,6,11,.545,7,8,.875,7,9,16,5,2,3,1,23,22,1995/1996
"Wood,David",1,6,.167,0,0,,1,6,.167,2,2,1.000,2,3,5,2,1,2,0,9,4,1995/1996
"Wood,David",67,154,.435,19,59,.322,48,95,.505,29,40,.725,42,91,133,27,16,19,9,118,182,1995/1996
"Woods,Randy",6,22,.273,5,21,.238,1,1,1.000,2,2,1.000,3,3,6,12,6,5,1,13,19,1995/1996
"Workman,Haywoode",101,259,.390,23,71,.324,78,188,.415,54,73,.740,27,97,124,213,65,93,4,152,279,1995/1996
"Wright,Sharone",248,512,.484,1,3,.333,247,509,.485,167,259,.645,148,208,356,38,30,109,49,163,664,1995/1996
"Wright,Sharone",183,384,.477,0,0,,183,384,.477,117,186,.629,124,175,299,27,24,81,39,125,483,1995/1996
"Wright,Sharone",65,128,.508,1,3,.333,64,125,.512,50,73,.685,24,33,57,11,6,28,10,38,181,1995/1996
"Zídek,George",105,248,.423,0,0,,105,248,.423,71,93,.763,69,114,183,16,9,38,7,170,281,1995/1996
"Abdul-Rauf,Mahmoud",411,924,.445,94,246,.382,317,678,.468,115,136,.846,16,106,122,189,56,119,6,174,1031,1996/1997
"Abdur-Rahim,Shareef",550,1214,.453,7,27,.259,543,1187,.457,387,519,.746,216,339,555,175,79,225,79,199,1494,1996/1997
"Addison,Rafael",49,122,.402,8,20,.400,41,102,.402,22,28,.786,19,26,45,34,8,17,3,52,128,1996/1997
"Alexander,Cory",194,490,.396,94,252,.373,100,238,.420,95,129,.736,29,94,123,254,82,146,16,148,577,1996/1997
"Allen,Jerome",78,221,.353,30,93,.323,48,128,.375,42,72,.583,25,73,98,152,31,69,4,84,228,1996/1997
"Allen,Jerome",57,147,.388,23,59,.390,34,88,.386,27,47,.574,13,52,65,109,27,56,0,67,164,1996/1997
"Allen,Jerome",21,74,.284,7,34,.206,14,40,.350,15,25,.600,12,21,33,43,4,13,4,17,64,1996/1997
"Allen,Ray",390,908,.430,117,298,.393,273,610,.448,205,249,.823,97,229,326,210,75,149,10,218,1102,1996/1997
"Alston,Derrick",0,5,.000,0,0,,0,5,.000,0,2,.000,3,1,4,0,0,0,0,0,0,1996/1997
"Amaya,Ashraf",12,40,.300,1,1,1.000,11,39,.282,15,28,.536,19,33,52,3,7,10,3,29,40,1996/1997
"Anderson,Greg",130,262,.496,0,1,.000,130,261,.498,62,93,.667,157,291,448,34,63,73,67,225,322,1996/1997
"Anderson,Kenny",485,1137,.427,132,366,.361,353,771,.458,334,435,.768,91,272,363,584,162,193,15,222,1436,1996/1997
"Anderson,Nick",288,725,.397,143,405,.353,145,320,.453,38,94,.404,66,238,304,182,120,86,32,160,757,1996/1997
"Anderson,Shandon",147,318,.462,24,47,.511,123,271,.454,68,99,.687,52,127,179,49,27,73,8,113,386,1996/1997
"Anderson,Willie",29,64,.453,8,19,.421,21,45,.467,17,20,.850,15,27,42,34,14,19,4,36,83,1996/1997
"Anthony,Greg",199,507,.393,88,238,.370,111,269,.413,130,178,.730,25,159,184,407,129,129,4,122,616,1996/1997
"Armstrong,B.J.",148,327,.453,25,90,.278,123,237,.519,68,79,.861,7,67,74,126,25,53,2,56,389,1996/1997
"Armstrong,Darrell",132,345,.383,55,181,.304,77,164,.470,92,106,.868,35,41,76,175,61,99,9,114,411,1996/1997
"Askew,Vincent",81,186,.435,7,24,.292,74,162,.457,70,88,.795,25,73,98,90,17,46,6,123,239,1996/1997
"Askew,Vincent",0,0,,0,0,,0,0,,0,0,,0,0,0,0,0,0,0,1,0,1996/1997
"Askew,Vincent",79,183,.432,7,24,.292,72,159,.453,68,86,.791,25,73,98,90,17,42,6,122,233,1996/1997
"Askew,Vincent",2,3,.667,0,0,,2,3,.667,2,2,1.000,0,0,0,0,0,4,0,0,6,1996/1997
"Askins,Keith",138,319,.433,69,172,.401,69,147,.469,39,58,.672,86,185,271,75,53,59,19,196,384,1996/1997
"Augmon,Stacey",105,220,.477,0,0,,105,220,.477,69,97,.711,47,91,138,56,42,64,17,87,279,1996/1997
"Augmon,Stacey",31,77,.403,0,0,,31,77,.403,28,41,.683,14,35,49,15,10,27,10,29,90,1996/1997
"Augmon,Stacey",74,143,.517,0,0,,74,143,.517,41,56,.732,33,56,89,41,32,37,7,58,189,1996/1997
"Austin,Isaac",321,639,.502,0,3,.000,321,636,.505,150,226,.664,136,342,478,101,45,161,43,244,792,1996/1997
"Baker,Vin",632,1251,.505,15,54,.278,617,1197,.515,358,521,.687,267,537,804,211,81,245,112,275,1637,1996/1997
"Barkley,Charles",335,692,.484,58,205,.283,277,487,.569,288,415,.694,212,504,716,248,69,151,25,153,1016,1996/1997
"Barros,Dana",110,253,.435,43,105,.410,67,148,.453,37,43,.860,5,43,48,81,26,39,6,34,300,1996/1997
"Barry,Brent",155,379,.409,56,173,.324,99,206,.481,76,93,.817,30,80,110,154,51,76,15,88,442,1996/1997
"Barry,Jon",100,246,.407,48,124,.387,52,122,.426,37,46,.804,26,73,99,115,55,59,3,56,285,1996/1997
"Benjamin,Benoit",5,12,.417,0,0,,5,12,.417,3,4,.750,3,6,9,1,1,2,0,5,13,1996/1997
"Bennett,Elmer",6,19,.316,3,9,.333,3,10,.300,7,10,.700,0,4,4,11,4,10,0,7,22,1996/1997
"Bennett,Elmer",2,6,.333,1,3,.333,1,3,.333,5,6,.833,0,1,1,4,2,0,0,1,10,1996/1997
"Bennett,Elmer",4,13,.308,2,6,.333,2,7,.286,2,4,.500,0,3,3,7,2,10,0,6,12,1996/1997
"Best,Travis",274,620,.442,57,155,.368,217,465,.467,149,197,.756,36,130,166,318,98,153,5,221,754,1996/1997
"Blaylock,Mookie",501,1159,.432,221,604,.366,280,555,.505,131,174,.753,114,299,413,463,212,185,20,141,1354,1996/1997
"Blount,Corie",92,179,.514,1,3,.333,91,176,.517,56,83,.675,113,163,276,35,22,50,26,121,241,1996/1997
"Bogues,Muggsy",204,443,.460,60,144,.417,144,299,.482,54,64,.844,25,116,141,469,82,108,2,114,522,1996/1997
"Boney,Dexter",6,19,.316,1,6,.167,5,13,.385,6,8,.750,3,3,6,0,2,1,1,3,19,1996/1997
"Booker,Melvin",46,105,.438,12,37,.324,34,68,.500,18,20,.900,7,22,29,53,3,27,2,28,122,1996/1997
"Booker,Melvin",2,4,.500,1,2,.500,1,2,.500,0,0,,0,1,1,3,0,7,0,0,5,1996/1997
"Booker,Melvin",44,101,.436,11,35,.314,33,66,.500,18,20,.900,7,21,28,50,3,20,2,28,117,1996/1997
"Bowen,Bruce",0,0,,0,0,,0,0,,0,0,,0,0,0,0,0,0,1,0,0,1996/1997
"Boyce,Donnie",21,63,.333,2,16,.125,19,47,.404,11,22,.500,7,8,15,13,10,16,4,17,55,1996/1997
"Bradley,Shawn",406,905,.449,0,8,.000,406,897,.453,149,228,.654,221,390,611,52,40,134,248,237,961,1996/1997
"Bradley,Shawn",199,456,.436,0,5,.000,199,451,.441,81,122,.664,118,207,325,20,23,64,160,122,479,1996/1997
"Bradley,Shawn",207,449,.461,0,3,.000,207,446,.464,68,106,.642,103,183,286,32,17,70,88,115,482,1996/1997
"Bradtke,Mark",25,58,.431,0,0,,25,58,.431,9,13,.692,26,42,68,7,5,9,5,34,59,1996/1997
"Brandon,Terrell",575,1313,.438,101,271,.373,474,1042,.455,268,297,.902,48,253,301,490,138,178,30,177,1519,1996/1997
"Brickowski,Frank",32,73,.438,7,20,.350,25,53,.472,10,14,.714,6,28,34,15,5,19,4,42,81,1996/1997
"Brooks,Scott",19,39,.487,5,12,.417,14,27,.519,14,15,.933,6,12,18,29,21,17,0,35,57,1996/1997
"Brown,Chucky",78,154,.506,1,6,.167,77,148,.520,47,70,.671,41,107,148,28,9,19,22,100,204,1996/1997
"Brown,Chucky",13,26,.500,0,0,,13,26,.500,8,11,.727,3,13,16,4,0,4,2,14,34,1996/1997
"Brown,Chucky",65,128,.508,1,6,.167,64,122,.525,39,59,.661,38,94,132,24,9,15,20,86,170,1996/1997
"Brown,Dee",61,166,.367,20,65,.308,41,101,.406,18,22,.818,8,40,48,67,31,24,7,45,160,1996/1997
"Brown,Marcus",28,70,.400,13,32,.406,15,38,.395,13,19,.684,4,11,15,20,8,13,2,26,82,1996/1997
"Brown,Mike",5,12,.417,0,0,,5,12,.417,6,10,.600,9,16,25,5,1,2,1,9,16,1996/1997
"Brown,P.J.",300,656,.457,0,2,.000,300,654,.459,161,220,.732,239,431,670,92,85,113,98,283,761,1996/1997
"Brown,Randy",140,333,.420,4,22,.182,136,311,.437,57,84,.679,34,77,111,133,81,58,17,116,341,1996/1997
"Bryant,Kobe",176,422,.417,51,136,.375,125,286,.437,136,166,.819,47,85,132,91,49,112,23,102,539,1996/1997
"Bryant,Mark",152,275,.553,0,0,,152,275,.553,76,108,.704,67,145,212,47,22,46,5,136,380,1996/1997
"Buechler,Jud",58,158,.367,18,54,.333,40,104,.385,5,14,.357,45,81,126,60,23,27,21,50,139,1996/1997
"Bullard,Matt",114,284,.401,67,183,.366,47,101,.465,25,34,.735,13,104,117,67,21,38,18,68,320,1996/1997
"Burrell,Scott",98,271,.362,41,116,.353,57,155,.368,57,76,.750,49,109,158,74,28,53,19,120,294,1996/1997
"Burrell,Scott",45,131,.344,19,55,.345,26,76,.342,42,53,.792,24,55,79,39,14,25,11,60,151,1996/1997
"Burrell,Scott",53,140,.379,22,61,.361,31,79,.392,15,23,.652,25,54,79,35,14,28,8,60,143,1996/1997
"Burton,Willie",39,116,.336,13,46,.283,26,70,.371,57,68,.838,11,30,41,11,8,26,3,55,148,1996/1997
"Butler,Mitchell",52,125,.416,12,39,.308,40,86,.465,32,50,.640,19,34,53,30,13,27,2,55,148,1996/1997
"Caffey,Jason",205,385,.532,0,1,.000,205,384,.534,139,211,.659,135,166,301,89,25,97,9,149,549,1996/1997
"Cage,Michael",66,141,.468,0,0,,66,141,.468,19,41,.463,112,208,320,43,48,17,42,118,151,1996/1997
"Caldwell,Adrian",40,92,.435,0,2,.000,40,90,.444,21,50,.420,58,109,167,12,16,28,8,87,101,1996/1997
"Caldwell,Adrian",10,35,.286,0,2,.000,10,33,.303,9,17,.529,20,36,56,5,8,12,1,27,29,1996/1997
"Caldwell,Adrian",30,57,.526,0,0,,30,57,.526,12,33,.364,38,73,111,7,8,16,7,60,72,1996/1997
"Camby,Marcus",375,778,.482,2,14,.143,373,764,.488,183,264,.693,131,263,394,97,66,134,130,214,935,1996/1997
"Campbell,Elden",442,942,.469,1,4,.250,441,938,.470,263,370,.711,207,408,615,126,46,130,117,276,1148,1996/1997
"Carr,Antoine",252,522,.483,0,3,.000,252,519,.486,99,127,.780,60,135,195,74,24,75,63,214,603,1996/1997
"Carr,Chris",125,271,.461,31,88,.352,94,183,.514,56,73,.767,31,82,113,48,24,37,10,93,337,1996/1997
"Carruth,Jimmy",2,3,.667,0,0,,2,3,.667,1,1,1.000,0,4,4,0,0,1,2,4,5,1996/1997
"Cassell,Sam",337,783,.430,81,231,.351,256,552,.464,212,251,.845,47,135,182,305,77,168,19,200,967,1996/1997
"Cassell,Sam",100,241,.415,19,62,.306,81,179,.453,106,124,.855,12,38,50,99,23,60,6,66,325,1996/1997
"Cassell,Sam",70,165,.424,15,49,.306,55,116,.474,42,50,.840,14,36,50,57,17,41,6,48,197,1996/1997
"Cassell,Sam",167,377,.443,47,120,.392,120,257,.467,64,77,.831,21,61,82,149,37,67,7,86,445,1996/1997
"Causwell,Duane",48,94,.511,2,3,.667,46,91,.505,20,37,.541,57,70,127,20,15,34,38,131,118,1996/1997
"Ceballos,Cedric",282,617,.457,26,102,.255,256,515,.497,139,186,.747,102,228,330,64,33,85,23,113,729,1996/1997
"Ceballos,Cedric",34,83,.410,5,21,.238,29,62,.468,13,15,.867,11,42,53,15,5,17,6,19,86,1996/1997
"Ceballos,Cedric",248,534,.464,21,81,.259,227,453,.501,126,171,.737,91,186,277,49,28,68,17,94,643,1996/1997
"Chambers,Tom",7,31,.226,2,3,.667,5,28,.179,3,4,.750,3,11,14,4,1,9,0,14,19,1996/1997
"Chapman,Rex",332,749,.443,110,314,.350,222,435,.510,124,149,.832,25,156,181,182,52,96,7,108,898,1996/1997
"Cheaney,Calbert",369,730,.505,4,30,.133,365,700,.521,95,137,.693,70,198,268,114,77,94,18,226,837,1996/1997
"Chilcutt,Pete",72,165,.436,25,69,.362,47,96,.490,13,22,.591,67,89,156,47,26,28,17,52,182,1996/1997
"Childress,Randolph",14,40,.350,5,19,.263,9,21,.429,6,8,.750,1,5,6,17,9,18,0,16,39,1996/1997
"Childress,Randolph",10,30,.333,3,16,.188,7,14,.500,6,8,.750,1,4,5,15,7,13,0,11,29,1996/1997
"Childress,Randolph",4,10,.400,2,3,.667,2,7,.286,0,0,,0,1,1,2,2,5,0,5,10,1996/1997
"Childs,Chris",211,510,.414,70,181,.387,141,329,.429,113,149,.758,22,169,191,398,78,180,11,213,605,1996/1997
"Christie,Doug",396,949,.417,147,383,.384,249,566,.440,237,306,.775,85,347,432,315,201,200,45,245,1176,1996/1997
"Coleman,Derrick",364,836,.435,32,119,.269,332,717,.463,272,365,.745,157,416,573,193,50,184,75,164,1032,1996/1997
"Coles,Bimbo",122,314,.389,30,102,.294,92,212,.434,37,49,.755,39,79,118,149,35,59,7,96,311,1996/1997
"Conlon,Marty",214,454,.471,2,10,.200,212,444,.477,144,171,.842,128,195,323,104,46,109,18,154,574,1996/1997
"Corbin,Tyrone",253,600,.422,74,208,.356,179,392,.457,86,108,.796,76,218,294,124,90,85,7,176,666,1996/1997
"Courtney,Joe",11,30,.367,0,0,,11,30,.367,3,5,.600,9,7,16,0,0,3,0,14,25,1996/1997
"Courtney,Joe",6,14,.429,0,0,,6,14,.429,0,0,,5,4,9,0,0,1,0,8,12,1996/1997
"Courtney,Joe",5,16,.313,0,0,,5,16,.313,3,5,.600,4,3,7,0,0,2,0,6,13,1996/1997
"Crotty,John",79,154,.513,20,49,.408,59,105,.562,54,64,.844,15,32,47,102,18,42,0,79,232,1996/1997
"Cummings,Terry",155,319,.486,3,5,.600,152,314,.484,57,82,.695,70,113,183,39,33,45,7,113,370,1996/1997
"Cureton,Earl",3,8,.375,0,0,,3,8,.375,1,3,.333,4,5,9,4,0,1,0,10,7,1996/1997
"Curry,Dell",384,836,.459,126,296,.426,258,540,.478,114,142,.803,40,171,211,118,60,93,14,147,1008,1996/1997
"Curry,Michael",99,221,.448,23,77,.299,76,144,.528,97,108,.898,23,96,119,43,31,28,12,128,318,1996/1997
"Dampier,Erick",131,336,.390,1,1,1.000,130,335,.388,107,168,.637,96,198,294,43,19,84,73,153,370,1996/1997
"Daniels,Lloyd",36,119,.303,21,70,.300,15,49,.306,5,6,.833,19,24,43,26,10,14,3,33,98,1996/1997
"Daniels,Lloyd",2,16,.125,2,11,.182,0,5,.000,0,0,,1,3,4,1,1,3,0,4,6,1996/1997
"Daniels,Lloyd",34,103,.330,19,59,.322,15,44,.341,5,6,.833,18,21,39,25,9,11,3,29,92,1996/1997
"Danilović,Sasha",248,570,.435,85,236,.360,163,334,.488,121,151,.801,29,107,136,102,54,116,9,160,702,1996/1997
"Danilović,Sasha",175,396,.442,63,176,.358,112,220,.509,73,94,.777,21,81,102,77,39,94,8,123,486,1996/1997
"Danilović,Sasha",73,174,.420,22,60,.367,51,114,.447,48,57,.842,8,26,34,25,15,22,1,37,216,1996/1997
"Dare,Yinka",19,54,.352,0,0,,19,54,.352,19,37,.514,35,47,82,3,4,21,28,51,57,1996/1997
"Davis,Antonio",308,641,.480,1,14,.071,307,627,.490,241,362,.666,190,408,598,65,42,141,84,260,858,1996/1997
"Davis,Ben",10,26,.385,0,0,,10,26,.385,9,20,.450,12,15,27,0,4,3,1,16,29,1996/1997
"Davis,Dale",370,688,.538,0,0,,370,688,.538,92,215,.428,301,471,772,59,60,108,77,233,832,1996/1997
"Davis,Emanual",24,54,.444,12,27,.444,12,27,.444,5,8,.625,2,20,22,26,9,17,2,20,65,1996/1997
"Davis,Hubert",74,184,.402,16,70,.229,58,114,.509,17,23,.739,11,29,40,34,11,21,2,40,181,1996/1997
"Davis,Mark",251,535,.469,24,93,.258,227,442,.514,113,168,.673,138,185,323,135,85,118,31,230,639,1996/1997
"Day,Todd",398,999,.398,126,348,.362,272,651,.418,256,331,.773,109,221,330,117,108,127,48,208,1178,1996/1997
"DeClercq,Andrew",142,273,.520,0,0,,142,273,.520,91,151,.603,122,176,298,32,33,76,27,229,375,1996/1997
"Dehere,Terry",148,383,.386,52,160,.325,96,223,.430,122,148,.824,15,80,95,158,27,96,3,142,470,1996/1997
"Del Negro,Vinny",365,781,.467,44,140,.314,321,641,.501,112,129,.868,39,171,210,231,59,92,7,131,886,1996/1997
"Dele,Bison",26,63,.413,0,0,,26,63,.413,11,15,.733,14,19,33,12,3,11,5,20,63,1996/1997
"Delk,Tony",119,256,.465,52,112,.464,67,144,.465,42,51,.824,31,68,99,99,36,68,6,71,332,1996/1997
"Demps,Dell",0,3,.000,0,1,.000,0,2,.000,2,2,1.000,0,0,0,0,1,0,0,1,2,1996/1997
"Divac,Vlade",418,847,.494,11,47,.234,407,800,.509,177,259,.683,241,484,725,301,103,193,180,277,1024,1996/1997
"Douglas,Sherman",306,610,.502,38,114,.333,268,496,.540,114,171,.667,57,136,193,427,78,153,10,191,764,1996/1997
"Dreiling,Greg",34,74,.459,1,1,1.000,33,73,.452,11,27,.407,19,57,76,11,8,9,7,65,80,1996/1997
"Drexler,Clyde",397,899,.442,119,335,.355,278,564,.493,201,268,.750,118,255,373,354,119,156,36,151,1114,1996/1997
"Driggers,Nate",13,43,.302,0,9,.000,13,34,.382,10,14,.714,12,10,22,6,3,6,2,10,36,1996/1997
"Duckworth,Kevin",45,103,.437,3,4,.750,42,99,.424,11,16,.688,23,37,60,16,9,33,11,63,104,1996/1997
"Dudley,Chris",126,293,.430,0,0,,126,293,.430,65,137,.474,204,389,593,41,39,80,96,247,317,1996/1997
"Dumars,Joe",385,875,.440,166,384,.432,219,491,.446,222,256,.867,38,153,191,318,57,128,1,97,1158,1996/1997
"Dumas,Tony",33,96,.344,4,28,.143,29,68,.426,16,25,.640,3,13,16,25,10,16,2,45,86,1996/1997
"Dumas,Tony",27,77,.351,3,24,.125,24,53,.453,15,23,.652,3,11,14,22,10,15,1,36,72,1996/1997
"Dumas,Tony",6,19,.316,1,4,.250,5,15,.333,1,2,.500,0,2,2,3,0,1,1,9,14,1996/1997
"Earl,Acie",67,180,.372,0,5,.000,67,175,.383,54,84,.643,35,61,96,20,15,35,28,61,188,1996/1997
"Earl,Acie",59,157,.376,0,5,.000,59,152,.388,44,70,.629,33,52,85,18,12,33,27,54,162,1996/1997
"Earl,Acie",8,23,.348,0,0,,8,23,.348,10,14,.714,2,9,11,2,3,2,1,7,26,1996/1997
"Edney,Tyus",150,391,.384,8,42,.190,142,349,.407,177,215,.823,34,79,113,226,60,112,2,98,485,1996/1997
"Edwards,Blue",182,458,.397,25,89,.281,157,369,.425,89,109,.817,49,140,189,114,38,81,20,135,478,1996/1997
"Edwards,Kevin",69,183,.377,15,43,.349,54,140,.386,37,43,.860,9,34,43,57,17,49,4,34,190,1996/1997
"Ehlo,Craig",87,248,.351,27,95,.284,60,153,.392,13,26,.500,39,71,110,68,36,45,4,71,214,1996/1997
"Eisley,Howard",139,308,.451,20,72,.278,119,236,.504,70,89,.787,20,64,84,198,44,110,10,141,368,1996/1997
"Elie,Mario",291,585,.497,120,286,.420,171,299,.572,207,231,.896,60,175,235,310,92,135,12,200,909,1996/1997
"Elliott,Sean",196,464,.422,42,126,.333,154,338,.456,148,196,.755,48,142,190,124,24,89,24,105,582,1996/1997
"Ellis,Dale",477,1151,.414,192,528,.364,285,623,.457,215,263,.817,99,194,293,165,60,146,7,178,1361,1996/1997
"Ellis,LaPhonso",445,1014,.439,95,259,.367,350,755,.464,218,282,.773,107,279,386,131,44,117,41,181,1203,1996/1997
"Ellison,Pervis",6,16,.375,0,0,,6,16,.375,3,5,.600,9,17,26,4,5,7,9,21,15,1996/1997
"Evans,Brian",8,22,.364,4,8,.500,4,14,.286,0,0,,1,7,8,7,1,2,2,6,20,1996/1997
"Ewing,Patrick",655,1342,.488,2,9,.222,653,1333,.490,439,582,.754,175,659,834,156,69,269,189,250,1751,1996/1997
"Feick,Jamie",56,157,.357,5,14,.357,51,143,.357,34,67,.507,82,132,214,26,16,31,14,78,151,1996/1997
"Feick,Jamie",2,4,.500,1,1,1.000,1,3,.333,0,2,.000,1,2,3,0,0,0,1,3,5,1996/1997
"Feick,Jamie",54,153,.353,4,13,.308,50,140,.357,34,65,.523,81,130,211,26,16,31,13,75,146,1996/1997
"Ferrell,Duane",159,337,.472,18,44,.409,141,293,.481,58,94,.617,57,84,141,66,38,55,6,120,394,1996/1997
"Ferry,Danny",341,794,.429,114,284,.401,227,510,.445,74,87,.851,82,255,337,151,56,94,32,245,870,1996/1997
"Finley,Michael",475,1071,.444,101,280,.361,374,791,.473,198,245,.808,88,284,372,224,68,164,24,138,1249,1996/1997
"Finley,Michael",141,297,.475,14,55,.255,127,242,.525,56,69,.812,34,86,120,68,18,44,4,42,352,1996/1997
"Finley,Michael",334,774,.432,87,225,.387,247,549,.450,142,176,.807,54,198,252,156,50,120,20,96,897,1996/1997
"Fish,Matt",1,3,.333,0,0,,1,3,.333,0,0,,1,4,5,0,0,2,0,2,2,1996/1997
"Fish,Matt",1,3,.333,0,0,,1,3,.333,0,0,,1,4,5,0,0,2,0,2,2,1996/1997
"Fish,Matt",0,0,,0,0,,0,0,,0,0,,0,0,0,0,0,0,0,0,0,1996/1997
"Fisher,Derek",104,262,.397,22,73,.301,82,189,.434,79,120,.658,25,72,97,119,41,71,5,87,309,1996/1997
"Foster,Greg",111,245,.453,2,3,.667,109,242,.450,54,65,.831,56,131,187,31,10,54,20,145,278,1996/1997
"Fox,Rick",433,950,.456,101,278,.363,332,672,.494,207,263,.787,114,280,394,286,167,178,40,279,1174,1996/1997
"Fuller,Todd",114,266,.429,0,0,,114,266,.429,76,110,.691,108,141,249,24,10,52,20,146,304,1996/1997
"Gamble,Kevin",123,286,.430,54,112,.482,69,174,.397,7,10,.700,13,94,107,77,21,27,17,76,307,1996/1997
"Garnett,Kevin",549,1100,.499,6,21,.286,543,1079,.503,205,272,.754,190,428,618,236,105,175,163,199,1309,1996/1997
"Garrett,Dean",223,389,.573,0,0,,223,389,.573,96,138,.696,149,346,495,38,40,34,95,158,542,1996/1997
"Gatling,Chris",327,623,.525,1,6,.167,326,617,.528,236,329,.717,134,236,370,28,39,120,31,138,891,1996/1997
"Gatling,Chris",309,580,.533,1,6,.167,308,574,.537,221,313,.706,126,222,348,25,35,114,31,125,840,1996/1997
"Gatling,Chris",18,43,.419,0,0,,18,43,.419,15,16,.938,8,14,22,3,4,6,0,13,51,1996/1997
"Geary,Reggie",22,58,.379,8,21,.381,14,37,.378,5,11,.455,4,11,15,36,13,15,2,36,57,1996/1997
"Geiger,Matt",171,350,.489,6,20,.300,165,330,.500,89,127,.701,100,158,258,38,20,67,27,153,437,1996/1997
"Gill,Kendall",644,1453,.443,74,220,.336,570,1233,.462,427,536,.797,183,316,499,326,154,218,46,225,1789,1996/1997
"Gilliam,Armen",246,522,.471,0,0,,246,522,.471,199,259,.768,136,361,497,53,61,105,40,206,691,1996/1997
"Goldwire,Anthony",131,330,.397,64,153,.418,67,177,.379,61,78,.782,12,72,84,219,33,76,2,104,387,1996/1997
"Goldwire,Anthony",62,154,.403,36,82,.439,26,72,.361,30,40,.750,3,35,38,94,19,41,1,58,190,1996/1997
"Goldwire,Anthony",69,176,.392,28,71,.394,41,105,.390,31,38,.816,9,37,46,125,14,35,1,46,197,1996/1997
"Graham,Greg",29,80,.363,9,31,.290,20,49,.408,26,40,.650,2,11,13,11,12,10,1,12,93,1996/1997
"Grant,Brian",91,207,.440,0,0,,91,207,.440,70,90,.778,49,93,142,28,19,44,25,75,252,1996/1997
"Grant,Gary",39,110,.355,14,46,.304,25,64,.391,18,22,.818,8,30,38,45,16,27,0,39,110,1996/1997
"Grant,Harvey",129,314,.411,28,89,.315,101,225,.449,30,39,.769,63,193,256,68,46,30,48,167,316,1996/1997
"Grant,Horace",358,695,.515,1,6,.167,357,689,.518,128,179,.715,206,394,600,163,101,99,65,157,845,1996/1997
"Gray,Devin",8,26,.308,0,0,,8,26,.308,2,5,.400,6,8,14,2,4,5,0,11,18,1996/1997
"Gray,Devin",3,11,.273,0,0,,3,11,.273,2,4,.500,3,6,9,2,3,0,0,3,8,1996/1997
"Gray,Devin",5,15,.333,0,0,,5,15,.333,0,1,.000,3,2,5,0,1,5,0,8,10,1996/1997
"Gray,Evric",4,15,.267,1,4,.250,3,11,.273,4,4,1.000,1,2,3,2,1,3,0,5,13,1996/1997
"Grayer,Jeff",38,83,.458,4,11,.364,34,72,.472,11,20,.550,21,17,38,25,8,15,7,42,91,1996/1997
"Green,A.C.",234,484,.483,1,20,.050,233,464,.502,128,197,.650,222,434,656,69,70,74,16,145,597,1996/1997
"Green,A.C.",61,128,.477,0,3,.000,61,125,.488,31,48,.646,33,105,138,17,18,20,1,34,153,1996/1997
"Green,A.C.",173,356,.486,1,17,.059,172,339,.507,97,149,.651,189,329,518,52,52,54,15,111,444,1996/1997
"Green,Litterial",30,64,.469,0,10,.000,30,54,.556,30,47,.638,6,16,22,41,16,15,1,27,90,1996/1997
"Gugliotta,Tom",592,1339,.442,24,93,.258,568,1246,.456,464,566,.820,187,515,702,335,130,293,89,237,1672,1996/1997
"Haley,Jack",13,37,.351,0,0,,13,37,.351,14,19,.737,13,19,32,5,1,2,1,14,40,1996/1997
"Ham,Darvin",33,62,.532,0,0,,33,62,.532,17,35,.486,29,27,56,14,9,22,8,57,83,1996/1997
"Ham,Darvin",32,61,.525,0,0,,32,61,.525,16,33,.485,29,27,56,14,8,21,8,57,80,1996/1997
"Ham,Darvin",1,1,1.000,0,0,,1,1,1.000,1,2,.500,0,0,0,0,1,1,0,0,3,1996/1997
"Hamer,Steve",30,57,.526,0,2,.000,30,55,.545,16,29,.552,17,43,60,7,2,13,4,39,76,1996/1997
"Hammonds,Tom",191,398,.480,0,2,.000,191,396,.482,124,172,.721,135,266,401,64,16,88,24,205,506,1996/1997
"Hancock,Darrin",16,35,.457,0,0,,16,35,.457,10,14,.714,4,14,18,12,9,11,1,15,42,1996/1997
"Hancock,Darrin",2,6,.333,0,0,,2,6,.333,0,0,,1,4,5,4,2,4,0,7,4,1996/1997
"Hancock,Darrin",13,27,.481,0,0,,13,27,.481,8,12,.667,3,10,13,7,7,7,1,6,34,1996/1997
"Hancock,Darrin",1,2,.500,0,0,,1,2,.500,2,2,1.000,0,0,0,1,0,0,0,2,4,1996/1997
"Hardaway,Anfernee",421,941,.447,85,267,.318,336,674,.499,283,345,.820,82,181,263,332,93,145,35,123,1210,1996/1997
"Hardaway,Tim",575,1384,.415,203,590,.344,372,794,.469,291,364,.799,49,228,277,695,151,230,9,165,1644,1996/1997
"Harper,Derek",299,674,.444,60,176,.341,239,498,.480,95,128,.742,30,107,137,321,92,132,12,144,753,1996/1997
"Harper,Ron",177,406,.436,68,188,.362,109,218,.500,58,82,.707,46,147,193,191,86,50,38,138,480,1996/1997
"Harrington,Othella",112,204,.549,0,3,.000,112,201,.557,49,81,.605,75,123,198,18,12,57,22,112,273,1996/1997
"Harris,Lucious",112,294,.381,36,99,.364,76,195,.390,33,47,.702,27,44,71,50,41,34,3,45,293,1996/1997
"Harvey,Antonio",5,11,.455,0,0,,5,11,.455,5,6,.833,2,8,10,1,0,1,4,8,15,1996/1997
"Hawkins,Hersey",369,795,.464,143,355,.403,226,440,.514,258,295,.875,92,228,320,250,159,130,12,146,1139,1996/1997
"Hawkins,Michael",29,68,.426,10,31,.323,19,37,.514,12,15,.800,9,22,31,64,16,28,1,40,80,1996/1997
"Heal,Shane",26,97,.268,20,65,.308,6,32,.188,3,5,.600,2,16,18,33,3,17,3,20,75,1996/1997
"Henderson,Alan",77,162,.475,0,0,,77,162,.475,45,75,.600,47,69,116,23,21,29,6,73,199,1996/1997
"Hendrickson,Mark",32,77,.416,3,12,.250,29,65,.446,18,26,.692,35,57,92,3,10,14,4,32,85,1996/1997
"Herrera,Carl",257,593,.433,2,6,.333,255,587,.434,81,118,.686,118,222,340,50,62,95,53,217,597,1996/1997
"Hill,Grant",625,1259,.496,10,33,.303,615,1226,.502,450,633,.711,123,598,721,583,144,259,48,186,1710,1996/1997
"Hill,Tyrone",357,595,.600,0,1,.000,357,594,.601,241,381,.633,259,477,736,92,63,147,30,268,955,1996/1997
"Hoiberg,Fred",67,156,.429,29,70,.414,38,86,.442,61,77,.792,13,68,81,41,27,22,6,51,224,1996/1997
"Hornacek,Jeff",413,856,.482,72,195,.369,341,661,.516,293,326,.899,60,181,241,361,124,134,26,188,1191,1996/1997
"Horry,Robert",157,360,.436,49,154,.318,108,206,.524,60,90,.667,68,169,237,110,66,72,55,153,423,1996/1997
"Horry,Robert",82,195,.421,24,78,.308,58,117,.496,32,50,.640,40,79,119,54,28,46,26,81,220,1996/1997
"Horry,Robert",75,165,.455,25,76,.329,50,89,.562,28,40,.700,28,90,118,56,38,26,29,72,203,1996/1997
"Houston,Allan",437,1032,.423,148,384,.385,289,648,.446,175,218,.803,43,197,240,179,41,167,18,233,1197,1996/1997
"Howard,Juwan",638,1313,.486,0,2,.000,638,1311,.487,294,389,.756,202,450,652,311,93,246,23,259,1570,1996/1997
"Howard,Stephen",62,108,.574,0,0,,62,108,.574,52,81,.642,29,56,85,11,19,25,12,62,176,1996/1997
"Howard,Stephen",7,12,.583,0,0,,7,12,.583,12,14,.857,4,5,9,1,8,5,2,7,26,1996/1997
"Howard,Stephen",55,96,.573,0,0,,55,96,.573,40,67,.597,25,51,76,10,11,20,10,55,150,1996/1997
"Hunter,Lindsey",421,1042,.404,166,468,.355,255,574,.444,158,203,.778,59,174,233,154,129,96,24,206,1166,1996/1997
"Hurley,Bobby",46,125,.368,14,45,.311,32,80,.400,37,53,.698,9,29,38,146,27,55,3,53,143,1996/1997
"Iverson,Allen",625,1504,.416,155,455,.341,470,1049,.448,382,544,.702,115,197,312,567,157,337,24,233,1787,1996/1997
"Jackson,Jaren",134,329,.407,53,158,.335,81,171,.474,53,69,.768,31,101,132,65,45,60,16,131,374,1996/1997
"Jackson,Jim",444,1029,.431,86,247,.348,358,782,.458,252,310,.813,132,279,411,316,86,208,32,194,1226,1996/1997
"Jackson,Jim",260,588,.442,46,139,.331,214,449,.477,148,188,.787,81,146,227,156,57,107,15,113,714,1996/1997
"Jackson,Jim",184,441,.417,40,108,.370,144,333,.432,104,122,.852,51,133,184,160,29,101,17,81,512,1996/1997
"Jackson,Mark",289,679,.426,66,178,.371,223,501,.445,168,213,.789,91,304,395,935,97,274,12,161,812,1996/1997
"Jackson,Mark",192,452,.425,48,121,.397,144,331,.435,109,136,.801,71,200,271,641,51,172,9,104,541,1996/1997
"Jackson,Mark",97,227,.427,18,57,.316,79,170,.465,59,77,.766,20,104,124,294,46,102,3,57,271,1996/1997
"James,Henry",125,306,.408,76,181,.420,49,125,.392,30,36,.833,27,54,81,21,11,29,1,98,356,1996/1997
"Jent,Chris",2,6,.333,2,3,.667,0,3,.000,0,0,,1,0,1,1,0,0,0,2,6,1996/1997
"Johnson,Avery",327,685,.477,6,26,.231,321,659,.487,140,203,.690,32,115,147,513,96,146,15,158,800,1996/1997
"Johnson,Eddie",160,362,.442,49,131,.374,111,231,.481,55,68,.809,27,111,138,52,15,47,2,81,424,1996/1997
"Johnson,Eddie",59,136,.434,9,28,.321,50,108,.463,20,27,.741,3,37,40,17,5,17,1,33,147,1996/1997
"Johnson,Eddie",101,226,.447,40,103,.388,61,123,.496,35,41,.854,24,74,98,35,10,30,1,48,277,1996/1997
"Johnson,Ervin",243,467,.520,0,2,.000,243,465,.523,96,156,.615,231,682,913,71,65,118,227,288,582,1996/1997
"Johnson,Kevin",441,890,.496,89,202,.441,352,688,.512,439,515,.852,54,199,253,653,102,217,12,141,1410,1996/1997
"Johnson,Larry",376,735,.512,34,105,.324,342,630,.543,190,274,.693,165,228,393,174,64,136,36,249,976,1996/1997
"Jones,Charles",2,5,.400,0,0,,2,5,.400,0,0,,5,8,13,3,2,0,4,8,4,1996/1997
"Jones,Eddie",473,1081,.438,152,389,.391,321,692,.464,276,337,.819,90,236,326,270,189,169,49,226,1374,1996/1997
"Jones,Popeye",258,537,.480,1,13,.077,257,524,.490,99,121,.818,270,410,680,84,58,116,39,269,616,1996/1997
"Jordan,Michael",920,1892,.486,111,297,.374,809,1595,.507,480,576,.833,113,369,482,352,140,166,44,156,2431,1996/1997
"Jordan,Reggie",16,26,.615,0,0,,16,26,.615,8,17,.471,11,16,27,12,7,8,3,15,40,1996/1997
"Jordan,Reggie",8,16,.500,0,0,,8,16,.500,4,10,.400,11,12,23,11,5,6,3,13,20,1996/1997
"Jordan,Reggie",8,10,.800,0,0,,8,10,.800,4,7,.571,0,4,4,1,2,2,0,2,20,1996/1997
"Keefe,Adam",82,160,.513,0,1,.000,82,159,.516,71,103,.689,75,141,216,32,30,45,13,97,235,1996/1997
"Kemp,Shawn",526,1032,.510,12,33,.364,514,999,.515,452,609,.742,275,532,807,156,125,280,81,320,1516,1996/1997
"Kempton,Tim",1,5,.200,0,0,,1,5,.200,2,2,1.000,3,5,8,2,1,7,1,4,4,1996/1997
"Kerr,Steve",249,467,.533,110,237,.464,139,230,.604,54,67,.806,29,101,130,175,67,43,3,98,662,1996/1997
"Kersey,Jerome",194,449,.432,17,65,.262,177,384,.461,71,118,.602,112,251,363,89,119,74,49,219,476,1996/1997
"Kidd,Jason",213,529,.403,61,165,.370,152,364,.418,112,165,.679,64,185,249,496,124,142,20,114,599,1996/1997
"Kidd,Jason",75,203,.369,21,65,.323,54,138,.391,46,69,.667,30,60,90,200,45,66,8,42,217,1996/1997
"Kidd,Jason",138,326,.423,40,100,.400,98,226,.434,66,96,.688,34,125,159,296,79,76,12,72,382,1996/1997
"King,Frankie",7,17,.412,1,2,.500,6,15,.400,5,5,1.000,4,10,14,5,4,3,0,7,20,1996/1997
"King,Jimmy",2,6,.333,0,0,,2,6,.333,2,4,.500,2,0,2,2,3,1,0,2,6,1996/1997
"King,Stacey",11,22,.500,0,0,,11,22,.500,2,7,.286,11,16,27,1,2,6,1,14,24,1996/1997
"King,Stacey",5,7,.714,0,0,,5,7,.714,2,3,.667,1,8,9,1,0,1,1,3,12,1996/1997
"King,Stacey",6,15,.400,0,0,,6,15,.400,0,4,.000,10,8,18,0,2,5,0,11,12,1996/1997
"Kittles,Kerry",507,1189,.426,158,419,.377,349,770,.453,175,227,.771,106,213,319,249,157,127,35,165,1347,1996/1997
"Kleine,Joe",69,170,.406,2,3,.667,67,167,.401,28,38,.737,62,141,203,35,17,41,18,110,168,1996/1997
"Kleine,Joe",32,80,.400,1,1,1.000,31,79,.392,13,18,.722,21,59,80,12,9,20,6,47,78,1996/1997
"Kleine,Joe",2,8,.250,0,0,,2,8,.250,2,2,1.000,2,7,9,0,0,0,0,6,6,1996/1997
"Kleine,Joe",35,82,.427,1,2,.500,34,80,.425,13,18,.722,39,75,114,23,8,21,12,57,84,1996/1997
"Knight,Travis",140,275,.509,0,0,,140,275,.509,62,100,.620,130,189,319,39,31,49,58,170,342,1996/1997
"Krystkowiak,Larry",1,2,.500,0,0,,1,2,.500,1,2,.500,2,3,5,3,2,1,0,3,3,1996/1997
"Kukoč,Toni",285,605,.471,50,151,.331,235,454,.518,134,174,.770,94,167,261,256,60,91,29,97,754,1996/1997
"Laettner,Christian",548,1128,.486,31,88,.352,517,1040,.497,359,440,.816,212,508,720,223,102,218,64,277,1486,1996/1997
"Lang,Andrew",115,248,.464,0,0,,115,248,.464,44,61,.721,94,184,278,25,26,39,47,140,274,1996/1997
"Lang,Antonio",68,162,.420,0,6,.000,68,156,.436,35,48,.729,52,75,127,33,33,50,30,111,171,1996/1997
"Lauderdale,Priest",49,89,.551,0,1,.000,49,88,.557,13,23,.565,16,27,43,12,1,37,9,39,111,1996/1997
"Leckner,Eric",14,33,.424,0,0,,14,33,.424,6,12,.500,5,31,36,5,3,10,2,35,34,1996/1997
"Leckner,Eric",0,3,.000,0,0,,0,3,.000,0,0,,0,1,1,1,0,0,0,3,0,1996/1997
"Leckner,Eric",14,30,.467,0,0,,14,30,.467,6,12,.500,5,30,35,4,3,10,2,32,34,1996/1997
"Legler,Tim",15,48,.313,8,29,.276,7,19,.368,6,7,.857,0,21,21,7,3,9,5,21,44,1996/1997
"Lenard,Voshon",314,684,.459,183,442,.414,131,242,.541,86,105,.819,38,179,217,161,50,109,18,168,897,1996/1997
"Lewis,Martin",6,14,.429,1,3,.333,5,11,.455,1,2,.500,4,2,6,4,1,1,2,8,14,1996/1997
"Lister,Alton",32,77,.416,0,0,,32,77,.416,23,31,.742,66,102,168,13,8,30,14,95,87,1996/1997
"Livingston,Randy",100,229,.437,9,22,.409,91,207,.440,42,65,.646,32,62,94,155,39,102,12,107,251,1996/1997
"Llamas Grey,Horacio",15,28,.536,0,0,,15,28,.536,4,8,.500,4,14,18,4,10,11,5,25,34,1996/1997
"Lohaus,Brad",4,15,.267,2,7,.286,2,8,.250,0,0,,1,6,7,1,1,1,0,6,10,1996/1997
"Long,Grant",123,275,.447,17,47,.362,106,228,.465,63,84,.750,88,134,222,39,43,48,6,106,326,1996/1997
"Long,John",46,117,.393,12,34,.353,34,83,.410,25,28,.893,6,34,40,21,9,24,2,28,129,1996/1997
"Longley,Luc",221,485,.456,0,2,.000,221,483,.458,95,120,.792,121,211,332,141,23,111,66,191,537,1996/1997
"Lynch,George",137,291,.471,8,31,.258,129,260,.496,60,97,.619,98,163,261,76,63,64,17,97,342,1996/1997
"Mack,Sam",105,262,.401,47,142,.331,58,120,.483,35,42,.833,20,86,106,58,29,42,6,67,292,1996/1997
"MacLean,Don",163,365,.447,12,38,.316,151,327,.462,64,97,.660,41,99,140,37,12,47,10,71,402,1996/1997
"Mahorn,Rick",20,54,.370,0,1,.000,20,53,.377,16,22,.727,19,34,53,6,4,10,3,34,56,1996/1997
"Majerle,Dan",141,347,.406,68,201,.338,73,146,.500,40,59,.678,45,117,162,116,54,50,14,75,390,1996/1997
"Malone,Karl",864,1571,.550,0,13,.000,864,1558,.555,521,690,.755,193,616,809,368,113,233,48,217,2249,1996/1997
"Maloney,Matt",271,615,.441,154,381,.404,117,234,.500,71,93,.763,19,141,160,303,82,122,1,125,767,1996/1997
"Manning,Danny",426,795,.536,7,36,.194,419,759,.552,181,251,.721,137,332,469,173,81,161,74,268,1040,1996/1997
"Manning,Rich",32,82,.390,2,4,.500,30,78,.385,9,14,.643,16,23,39,3,4,7,2,29,75,1996/1997
"Manning,Rich",18,48,.375,2,3,.667,16,45,.356,6,8,.750,8,15,23,2,3,5,1,18,44,1996/1997
"Manning,Rich",14,34,.412,0,1,.000,14,33,.424,3,6,.500,8,8,16,1,1,2,1,11,31,1996/1997
"Marbury,Stephon",355,871,.408,102,288,.354,253,583,.434,245,337,.727,54,130,184,522,67,210,19,159,1057,1996/1997
"Marčiulionis,Šarūnas",38,101,.376,11,30,.367,27,71,.380,29,36,.806,12,18,30,25,12,40,1,38,116,1996/1997
"Marshall,Donny",52,160,.325,33,87,.379,19,73,.260,38,54,.704,22,48,70,24,24,32,3,60,175,1996/1997
"Marshall,Donyell",174,421,.413,35,111,.315,139,310,.448,61,98,.622,92,184,276,54,25,55,46,96,444,1996/1997
"Martin,Cuonzo",0,7,.000,0,2,.000,0,5,.000,0,0,,1,0,1,1,0,1,0,1,0,1996/1997
"Martin,Darrick",292,718,.407,91,234,.389,201,484,.415,218,250,.872,26,87,113,339,57,127,2,165,893,1996/1997
"Mashburn,Jamal",286,743,.385,90,277,.325,196,466,.421,160,228,.702,69,225,294,204,78,114,12,186,822,1996/1997
"Mashburn,Jamal",140,376,.372,42,131,.321,98,245,.400,72,111,.649,28,87,115,93,35,57,5,69,394,1996/1997
"Mashburn,Jamal",146,367,.398,48,146,.329,98,221,.443,88,117,.752,41,138,179,111,43,57,7,117,428,1996/1997
"Mason,Anthony",433,825,.525,1,3,.333,432,822,.526,319,428,.745,186,643,829,414,76,165,33,202,1186,1996/1997
"Massenburg,Tony",219,452,.485,0,1,.000,219,451,.486,130,206,.631,222,295,517,23,38,91,50,217,568,1996/1997
"Maxwell,Vernon",340,906,.375,115,372,.309,225,534,.421,134,180,.744,27,132,159,153,87,121,19,168,929,1996/1997
"Mayberry,Lee",149,370,.403,83,221,.376,66,149,.443,29,46,.630,29,105,134,329,60,90,8,159,410,1996/1997
"McCarty,Walter",26,68,.382,4,14,.286,22,54,.407,8,14,.571,8,15,23,13,7,17,9,38,64,1996/1997
"McCaskill,Amal",10,32,.313,0,2,.000,10,30,.333,8,12,.667,4,18,22,7,3,11,5,7,28,1996/1997
"McCloud,George",238,578,.412,99,254,.390,139,324,.429,83,101,.822,36,143,179,109,61,61,8,126,658,1996/1997
"McCloud,George",204,482,.423,78,205,.380,126,277,.455,77,92,.837,29,114,143,92,52,52,8,106,563,1996/1997
"McCloud,George",34,96,.354,21,49,.429,13,47,.277,6,9,.667,7,29,36,17,9,9,0,20,95,1996/1997
"McDaniel,Xavier",138,355,.389,5,25,.200,133,330,.403,65,89,.730,124,194,318,65,36,70,17,144,346,1996/1997
"McDyess,Antonio",536,1157,.463,6,35,.171,530,1122,.472,274,387,.708,155,382,537,106,62,199,126,276,1352,1996/1997
"McIlvaine,Jim",130,276,.471,1,7,.143,129,269,.480,53,107,.495,132,198,330,23,39,62,164,247,314,1996/1997
"McInnis,Jeff",23,49,.469,12,26,.462,11,23,.478,7,10,.700,2,4,6,18,2,13,1,16,65,1996/1997
"McKey,Derrick",148,379,.391,15,58,.259,133,321,.414,89,123,.724,80,161,241,135,47,83,30,141,400,1996/1997
"McKie,Aaron",150,365,.411,41,103,.398,109,262,.416,92,110,.836,40,181,221,161,77,90,22,130,433,1996/1997
"McKie,Aaron",53,156,.340,23,55,.418,30,101,.297,41,49,.837,13,80,93,84,34,48,15,61,170,1996/1997
"McKie,Aaron",97,209,.464,18,48,.375,79,161,.491,51,61,.836,27,101,128,77,43,42,7,69,263,1996/1997
"McMillan,Nate",61,149,.409,28,84,.333,33,65,.508,19,29,.655,15,103,118,140,58,32,6,78,169,1996/1997
"Meyer,Loren",108,244,.443,4,7,.571,104,237,.439,46,64,.719,53,92,145,19,11,62,15,125,266,1996/1997
"Meyer,Loren",34,78,.436,1,2,.500,33,76,.434,9,12,.750,14,35,49,7,6,27,3,52,78,1996/1997
"Meyer,Loren",74,166,.446,3,5,.600,71,161,.441,37,52,.712,39,57,96,12,5,35,12,73,188,1996/1997
"Miller,Anthony",0,5,.000,0,0,,0,5,.000,0,0,,2,5,7,0,0,0,0,2,0,1996/1997
"Miller,Oliver",123,238,.517,0,2,.000,123,236,.521,48,79,.608,105,201,306,87,47,90,63,181,294,1996/1997
"Miller,Oliver",76,154,.494,0,1,.000,76,153,.497,28,53,.528,82,151,233,58,34,70,50,133,180,1996/1997
"Miller,Oliver",47,84,.560,0,1,.000,47,83,.566,20,26,.769,23,50,73,29,13,20,13,48,114,1996/1997
"Miller,Reggie",552,1244,.444,229,536,.427,323,708,.456,418,475,.880,53,233,286,273,75,166,25,172,1751,1996/1997
"Mills,Chris",405,894,.453,86,220,.391,319,674,.473,176,209,.842,118,379,497,198,86,120,41,222,1072,1996/1997
"Mills,Terry",312,702,.444,175,415,.422,137,287,.477,58,70,.829,68,309,377,99,35,85,27,161,857,1996/1997
"Minor,Greg",94,196,.480,1,8,.125,93,188,.495,31,36,.861,30,50,80,34,15,22,2,45,220,1996/1997
"Mitchell,Sam",269,603,.446,4,25,.160,265,578,.458,224,295,.759,112,214,326,79,51,93,20,232,766,1996/1997
"Mobley,Eric",28,63,.444,0,0,,28,63,.444,16,30,.533,30,28,58,14,5,29,10,44,72,1996/1997
"Montross,Eric",159,349,.456,0,0,,159,349,.456,21,62,.339,181,337,518,61,20,77,73,268,339,1996/1997
"Montross,Eric",86,187,.460,0,0,,86,187,.460,10,34,.294,66,170,236,32,9,51,34,150,182,1996/1997
"Montross,Eric",73,162,.451,0,0,,73,162,.451,11,28,.393,115,167,282,29,11,26,39,118,157,1996/1997
"Moore,Tracy",33,85,.388,11,43,.256,22,42,.524,22,31,.710,11,15,26,20,5,14,0,19,99,1996/1997
"Morris,Chris",122,299,.408,31,113,.274,91,186,.489,39,54,.722,37,125,162,43,29,45,24,121,314,1996/1997
"Moten,Lawrence",171,441,.388,41,141,.291,130,300,.433,64,99,.646,43,76,119,129,48,81,24,83,447,1996/1997
"Mourning,Alonzo",473,885,.534,1,9,.111,472,876,.539,363,565,.642,189,467,656,104,56,226,189,272,1310,1996/1997
"Mullin,Chris",438,792,.553,83,202,.411,355,590,.602,184,213,.864,75,242,317,322,130,192,33,155,1143,1996/1997
"Murdock,Eric",15,33,.455,4,10,.400,11,23,.478,11,12,.917,1,10,11,24,9,11,2,9,45,1996/1997
"Mureșan,Gheorghe",327,541,.604,0,0,,327,541,.604,123,199,.618,141,340,481,29,43,117,96,230,777,1996/1997
"Murray,Lamond",181,435,.416,31,91,.341,150,344,.436,156,211,.739,85,148,233,57,53,86,29,113,549,1996/1997
"Murray,Tracy",288,678,.425,106,300,.353,182,378,.481,135,161,.839,84,169,253,78,69,86,19,150,817,1996/1997
"Mutombo,Dikembe",380,721,.527,0,0,,380,721,.527,306,434,.705,268,661,929,110,49,186,264,249,1066,1996/1997
"Müürsepp,Martin",54,131,.412,4,24,.167,50,107,.467,44,70,.629,35,32,67,20,12,18,11,58,156,1996/1997
"Müürsepp,Martin",5,14,.357,1,4,.250,4,10,.400,6,14,.429,2,3,5,3,0,3,1,3,17,1996/1997
"Müürsepp,Martin",49,117,.419,3,20,.150,46,97,.474,38,56,.679,33,29,62,17,12,15,10,55,139,1996/1997
"Nash,Steve",74,175,.423,23,55,.418,51,120,.425,42,51,.824,16,47,63,138,20,63,0,92,213,1996/1997
"Nembhard,Ruben",16,37,.432,0,6,.000,16,31,.516,8,10,.800,3,5,8,17,9,8,0,12,40,1996/1997
"Nembhard,Ruben",12,29,.414,0,4,.000,12,25,.480,8,10,.800,3,5,8,12,6,3,0,9,32,1996/1997
"Nembhard,Ruben",4,8,.500,0,2,.000,4,6,.667,0,0,,0,0,0,5,3,5,0,3,8,1996/1997
"Newbill,Ivano",40,91,.440,0,0,,40,91,.440,20,52,.385,76,128,204,24,28,42,15,115,100,1996/1997
"Newman,Johnny",246,547,.450,34,98,.347,212,449,.472,189,247,.765,66,120,186,116,73,115,17,257,715,1996/1997
"Nickerson,Gaylon",4,12,.333,0,2,.000,4,10,.400,7,7,1.000,1,4,5,1,1,1,1,1,15,1996/1997
"Nickerson,Gaylon",3,9,.333,0,1,.000,3,8,.375,7,7,1.000,1,3,4,1,0,0,1,1,13,1996/1997
"Nickerson,Gaylon",1,3,.333,0,1,.000,1,2,.500,0,0,,0,1,1,0,1,1,0,0,2,1996/1997
"Norman,Ken",27,94,.287,6,38,.158,21,56,.375,4,12,.333,8,31,39,12,7,18,3,17,64,1996/1997
"Norris,Moochie",4,22,.182,2,10,.200,2,12,.167,2,5,.400,3,9,12,23,4,5,0,5,12,1996/1997
"O'Bannon,Ed",93,279,.333,18,70,.257,75,209,.359,31,35,.886,50,98,148,39,29,20,12,97,235,1996/1997
"O'Bannon,Ed",76,207,.367,17,60,.283,59,147,.401,20,23,.870,41,71,112,28,24,14,10,78,189,1996/1997
"O'Bannon,Ed",17,72,.236,1,10,.100,16,62,.258,11,12,.917,9,27,36,11,5,6,2,19,46,1996/1997
"O'Neal,Jermaine",69,153,.451,0,1,.000,69,152,.454,47,78,.603,39,85,124,8,2,27,26,46,185,1996/1997
"O'Neal,Shaquille",552,991,.557,0,4,.000,552,987,.559,232,479,.484,195,445,640,159,46,146,147,180,1336,1996/1997
"Oakley,Charles",339,694,.488,5,19,.263,334,675,.495,181,224,.808,246,535,781,221,111,171,21,305,864,1996/1997
"Olajuwon,Hakeem",727,1426,.510,5,16,.313,722,1410,.512,351,446,.787,173,543,716,236,117,281,173,249,1810,1996/1997
"Oliver,Jimmy",4,13,.308,1,6,.167,3,7,.429,2,2,1.000,1,4,5,1,2,3,0,2,11,1996/1997
"Ostertag,Greg",210,408,.515,0,4,.000,210,404,.520,139,205,.678,180,385,565,27,24,74,152,233,559,1996/1997
"Outlaw,Bo",254,417,.609,0,8,.000,254,409,.621,117,232,.504,174,280,454,157,94,107,142,227,625,1996/1997
"Overton,Doug",81,190,.426,10,40,.250,71,150,.473,45,48,.938,18,50,68,101,24,39,0,44,217,1996/1997
"Owens,Billy",299,640,.467,25,72,.347,274,568,.482,101,145,.697,134,258,392,187,62,133,25,187,724,1996/1997
"Owes,Ray",75,180,.417,1,5,.200,74,175,.423,26,46,.565,64,99,163,15,15,23,20,86,177,1996/1997
"Pack,Robert",272,693,.392,31,112,.277,241,581,.415,196,243,.807,28,118,146,452,94,217,6,139,771,1996/1997
"Pack,Robert",193,474,.407,22,74,.297,171,400,.428,134,170,.788,15,71,86,325,59,150,3,83,542,1996/1997
"Pack,Robert",79,219,.361,9,38,.237,70,181,.387,62,73,.849,13,47,60,127,35,67,3,56,229,1996/1997
"Parish,Robert",70,143,.490,0,0,,70,143,.490,21,31,.677,42,47,89,22,6,28,19,40,161,1996/1997
"Parks,Cherokee",103,202,.510,0,1,.000,103,201,.512,46,76,.605,83,112,195,34,41,32,48,150,252,1996/1997
"Payton,Gary",706,1482,.476,119,380,.313,587,1102,.533,254,355,.715,106,272,378,583,197,215,13,208,1785,1996/1997
"Peeler,Anthony",402,1011,.398,128,343,.373,274,668,.410,109,133,.820,54,193,247,256,105,157,17,168,1041,1996/1997
"Perdue,Will",233,410,.568,0,0,,233,410,.568,99,171,.579,251,387,638,38,32,87,102,184,565,1996/1997
"Perkins,Sam",290,661,.439,122,309,.395,168,352,.477,187,229,.817,74,226,300,103,69,77,49,134,889,1996/1997
"Perry,Elliot",217,458,.474,49,137,.358,168,321,.523,79,106,.745,24,100,124,247,98,111,3,117,562,1996/1997
"Person,Wesley",409,903,.453,171,414,.413,238,489,.487,91,114,.798,68,224,292,123,86,76,20,102,1080,1996/1997
"Phills,Bobby",328,766,.428,85,216,.394,243,550,.442,125,174,.718,63,182,245,233,113,135,21,174,866,1996/1997
"Piatkowski,Eric",134,298,.450,51,120,.425,83,178,.466,69,84,.821,49,56,105,52,33,46,10,85,388,1996/1997
"Pierce,Ricky",239,497,.481,42,95,.442,197,402,.490,139,155,.897,36,85,121,80,28,68,9,97,659,1996/1997
"Pierce,Ricky",120,260,.462,12,39,.308,108,221,.489,83,92,.902,17,36,53,31,14,38,5,49,335,1996/1997
"Pierce,Ricky",119,237,.502,30,56,.536,89,181,.492,56,63,.889,19,49,68,49,14,30,4,48,324,1996/1997
"Pinckney,Ed",23,43,.535,0,0,,23,43,.535,20,25,.800,25,40,65,6,8,19,9,30,66,1996/1997
"Pippen,Scottie",648,1366,.474,156,424,.368,492,942,.522,204,291,.701,160,371,531,467,154,214,45,213,1656,1996/1997
"Polynice,Olden",442,967,.457,0,6,.000,442,961,.460,141,251,.562,272,500,772,178,46,166,80,298,1025,1996/1997
"Porter,Terry",187,449,.416,67,200,.335,120,249,.482,127,166,.765,31,145,176,295,54,128,11,104,568,1996/1997
"Potapenko,Vitaly",186,423,.440,1,2,.500,185,421,.439,92,125,.736,105,112,217,40,26,109,34,216,465,1996/1997
"Price,Brent",44,105,.419,17,53,.321,27,52,.519,21,21,1.000,10,19,29,65,17,32,0,34,126,1996/1997
"Price,Mark",263,589,.447,112,283,.396,151,306,.493,155,171,.906,36,143,179,342,67,161,3,100,793,1996/1997
"Ratliff,Theo",179,337,.531,0,0,,179,337,.531,81,116,.698,109,147,256,13,29,56,111,181,439,1996/1997
"Rađa,Dino",149,339,.440,0,1,.000,149,338,.441,51,71,.718,44,167,211,48,23,70,48,76,349,1996/1997
"Recasner,Eldridge",148,350,.423,58,140,.414,90,210,.429,51,58,.879,35,80,115,94,38,65,4,97,405,1996/1997
"Reeves,Bryant",498,1025,.486,1,11,.091,497,1014,.490,216,307,.704,174,436,610,160,29,175,67,270,1213,1996/1997
"Reeves,Khalid",184,470,.391,83,227,.366,101,243,.416,65,87,.747,34,85,119,226,34,108,9,159,516,1996/1997
"Reeves,Khalid",141,359,.393,76,192,.396,65,167,.389,56,75,.747,22,66,88,170,23,82,7,119,414,1996/1997
"Reeves,Khalid",43,111,.387,7,35,.200,36,76,.474,9,12,.750,12,19,31,56,11,26,2,40,102,1996/1997
"Reid,Don",54,112,.482,0,1,.000,54,111,.486,24,32,.750,36,65,101,14,16,23,15,105,132,1996/1997
"Respert,Shawn",59,139,.424,20,57,.351,39,82,.476,34,39,.872,14,25,39,40,20,30,2,40,172,1996/1997
"Respert,Shawn",6,19,.316,1,9,.111,5,10,.500,7,7,1.000,3,4,7,8,0,8,0,5,20,1996/1997
"Respert,Shawn",53,120,.442,19,48,.396,34,72,.472,27,32,.844,11,21,32,32,20,22,2,35,152,1996/1997
"Rice,Glen",722,1513,.477,207,440,.470,515,1073,.480,464,535,.867,67,251,318,160,72,177,26,190,2115,1996/1997
"Richardson,Pooh",131,344,.381,42,128,.328,89,216,.412,26,43,.605,25,73,98,169,54,62,5,82,330,1996/1997
"Richmond,Mitch",717,1578,.454,204,477,.428,513,1101,.466,457,531,.861,59,260,319,338,118,237,24,211,2095,1996/1997
"Rider,Isaiah",456,983,.464,99,257,.385,357,726,.492,212,261,.812,94,210,304,198,45,212,19,199,1223,1996/1997
"Roberts,Fred",6,15,.400,0,0,,6,15,.400,10,14,.714,2,8,10,0,0,5,1,2,22,1996/1997
"Roberts,Stanley",63,148,.426,0,0,,63,148,.426,45,64,.703,24,67,91,9,8,23,23,57,171,1996/1997
"Robinson,Chris",69,182,.379,34,89,.382,35,93,.376,16,26,.615,23,48,71,65,28,34,9,85,188,1996/1997
"Robinson,Clifford",444,1043,.426,121,350,.346,323,693,.466,215,309,.696,90,231,321,261,99,172,66,251,1224,1996/1997
"Robinson,David",36,72,.500,0,0,,36,72,.500,34,52,.654,19,32,51,8,6,8,6,9,106,1996/1997
"Robinson,Glenn",669,1438,.465,63,180,.350,606,1258,.482,288,364,.791,130,372,502,248,103,269,68,225,1689,1996/1997
"Robinson,James",196,482,.407,102,267,.382,94,215,.437,78,114,.684,24,88,112,126,30,69,8,125,572,1996/1997
"Robinson,Rumeal",66,164,.402,18,56,.321,48,108,.444,26,35,.743,6,41,47,73,24,43,2,60,176,1996/1997
"Robinson,Rumeal",17,48,.354,6,23,.261,11,25,.440,5,8,.625,2,8,10,13,5,11,2,12,45,1996/1997
"Robinson,Rumeal",16,34,.471,3,10,.300,13,24,.542,1,4,.250,1,6,7,8,1,5,0,8,36,1996/1997
"Robinson,Rumeal",33,82,.402,9,23,.391,24,59,.407,20,23,.870,3,27,30,52,18,27,0,40,95,1996/1997
"Rodman,Dennis",128,286,.448,5,19,.263,123,267,.461,50,88,.568,320,563,883,170,32,111,19,172,311,1996/1997
"Roe,Lou",14,48,.292,3,11,.273,11,37,.297,9,19,.474,7,7,14,6,3,11,1,10,40,1996/1997
"Rogers,Carlos",212,404,.525,25,66,.379,187,338,.553,102,170,.600,120,184,304,37,42,53,69,140,551,1996/1997
"Rogers,Rodney",408,884,.462,65,180,.361,343,704,.487,191,288,.663,137,274,411,222,88,221,61,272,1072,1996/1997
"Rogers,Roy",244,483,.505,1,1,1.000,243,482,.504,54,94,.574,139,247,386,46,21,86,163,214,543,1996/1997
"Rooks,Sean",87,185,.470,0,1,.000,87,184,.473,91,130,.700,56,107,163,42,17,51,38,123,265,1996/1997
"Rose,Jalen",172,377,.456,21,72,.292,151,305,.495,117,156,.750,27,94,121,155,57,107,18,136,482,1996/1997
"Rose,Malik",61,128,.477,0,2,.000,61,126,.484,38,62,.613,70,94,164,32,28,41,17,114,160,1996/1997
"Royal,Donald",62,146,.425,0,2,.000,62,144,.431,94,117,.803,52,102,154,25,23,47,11,100,218,1996/1997
"Royal,Donald",4,10,.400,0,0,,4,10,.400,4,4,1.000,1,0,1,1,0,3,0,3,12,1996/1997
"Royal,Donald",37,96,.385,0,2,.000,37,94,.394,62,78,.795,33,62,95,14,11,22,9,55,136,1996/1997
"Royal,Donald",21,40,.525,0,0,,21,40,.525,28,35,.800,18,40,58,10,12,22,2,42,70,1996/1997
"Rozier,Clifford",79,174,.454,0,2,.000,79,172,.459,31,61,.508,102,132,234,31,24,29,44,97,189,1996/1997
"Rozier,Clifford",0,1,.000,0,0,,0,1,.000,0,0,,0,0,0,0,0,0,0,0,0,1996/1997
"Rozier,Clifford",79,173,.457,0,2,.000,79,171,.462,31,61,.508,102,132,234,31,24,29,44,97,189,1996/1997
"Russell,Bryon",297,620,.479,108,264,.409,189,356,.531,171,244,.701,79,252,331,123,129,94,27,237,873,1996/1997
"Sabonis,Arvydas",328,658,.498,49,132,.371,279,526,.530,223,287,.777,114,433,547,146,63,151,84,203,928,1996/1997
"Salvadori,Kevin",12,33,.364,0,0,,12,33,.364,13,18,.722,6,19,25,10,2,12,13,17,37,1996/1997
"Sasser,Jason",9,23,.391,1,3,.333,8,20,.400,0,0,,1,7,8,2,3,2,0,11,19,1996/1997
"Sasser,Jason",8,19,.421,1,2,.500,7,17,.412,0,0,,0,7,7,1,2,2,0,11,17,1996/1997
"Sasser,Jason",1,4,.250,0,1,.000,1,3,.333,0,0,,1,0,1,1,1,0,0,0,2,1996/1997
"Schayes,Danny",47,120,.392,0,1,.000,47,119,.395,39,52,.750,41,84,125,14,15,27,16,74,133,1996/1997
"Scheffler,Steve",6,7,.857,0,0,,6,7,.857,1,2,.500,1,2,3,0,0,5,0,5,13,1996/1997
"Schintzius,Dwayne",13,36,.361,1,2,.500,12,34,.353,7,8,.875,9,13,22,4,1,7,9,22,34,1996/1997
"Schrempf,Detlef",356,724,.492,57,161,.354,299,563,.531,253,316,.801,87,307,394,266,63,150,16,151,1022,1996/1997
"Scott,Brent",8,17,.471,0,0,,8,17,.471,3,6,.500,3,6,9,3,1,4,1,14,19,1996/1997
"Scott,Byron",163,379,.430,73,188,.388,90,191,.471,127,151,.841,21,97,118,99,46,53,16,72,526,1996/1997
"Scott,Dennis",298,749,.398,147,373,.394,151,376,.402,80,101,.792,40,163,203,139,74,81,19,138,823,1996/1997
"Scott,James",0,8,.000,0,4,.000,0,4,.000,1,2,.500,1,5,6,3,2,2,0,5,1,1996/1997
"Scott,Shawnelle",8,16,.500,0,0,,8,16,.500,4,11,.364,8,8,16,0,0,0,3,6,20,1996/1997
"Sealy,Malik",373,942,.396,79,222,.356,294,720,.408,254,290,.876,59,179,238,165,124,154,45,185,1079,1996/1997
"Seikaly,Rony",460,907,.507,0,3,.000,460,904,.509,357,500,.714,274,427,701,92,49,218,107,275,1277,1996/1997
"Shaw,Brian",189,516,.366,63,194,.325,126,322,.391,111,140,.793,47,147,194,319,67,170,26,197,552,1996/1997
"Simmons,Lionel",45,136,.331,7,30,.233,38,106,.358,42,48,.875,30,74,104,57,8,34,13,63,139,1996/1997
"Simpkins,Dickey",31,93,.333,1,4,.250,30,89,.337,28,40,.700,36,56,92,31,5,35,5,44,91,1996/1997
"Slater,Reggie",82,149,.550,0,2,.000,82,147,.558,39,75,.520,40,55,95,21,9,29,6,34,203,1996/1997
"Smith,Charles",34,84,.405,0,1,.000,34,83,.410,20,26,.769,18,47,65,14,13,22,22,44,88,1996/1997
"Smith,Joe",587,1293,.454,12,46,.261,575,1247,.461,307,377,.814,261,418,679,125,74,192,86,244,1493,1996/1997
"Smith,Kenny",101,239,.423,59,135,.437,42,104,.404,39,45,.867,4,40,44,116,19,71,0,30,300,1996/1997
"Smith,Kenny",8,20,.400,5,10,.500,3,10,.300,2,2,1.000,0,5,5,10,1,3,0,2,23,1996/1997
"Smith,Kenny",6,13,.462,3,5,.600,3,8,.375,2,2,1.000,1,1,2,4,0,6,0,3,17,1996/1997
"Smith,Kenny",87,206,.422,51,120,.425,36,86,.419,35,41,.854,3,34,37,102,18,62,0,25,260,1996/1997
"Smith,Michael",202,375,.539,0,0,,202,375,.539,128,258,.496,257,512,769,191,82,130,60,251,532,1996/1997
"Smith,Steve",491,1145,.429,130,388,.335,361,757,.477,333,393,.847,90,148,238,305,62,176,23,173,1445,1996/1997
"Smith,Stevin",6,18,.333,1,6,.167,5,12,.417,1,1,1.000,2,8,10,4,1,4,0,9,14,1996/1997
"Smith,Tony",138,337,.409,32,99,.323,106,238,.445,38,59,.644,38,56,94,150,48,73,19,110,346,1996/1997
"Smits,Rik",356,733,.486,2,8,.250,354,725,.488,173,217,.797,105,256,361,67,22,126,59,175,887,1996/1997
"Snow,Eric",74,164,.451,4,15,.267,70,149,.470,47,66,.712,17,53,70,159,37,48,3,94,199,1996/1997
"Spencer,Elmore",0,1,.000,0,0,,0,1,.000,0,0,,0,0,0,0,1,1,0,0,0,1996/1997
"Spencer,Felton",139,284,.489,0,0,,139,284,.489,94,161,.584,157,259,416,22,34,88,50,275,372,1996/1997
"Spencer,Felton",2,2,1.000,0,0,,2,2,1.000,0,0,,5,1,6,1,0,1,0,2,4,1996/1997
"Spencer,Felton",137,282,.486,0,0,,137,282,.486,94,161,.584,152,258,410,21,34,87,50,273,368,1996/1997
"Sprewell,Latrell",649,1444,.449,147,415,.354,502,1029,.488,493,585,.843,58,308,366,507,132,322,45,153,1938,1996/1997
"Stackhouse,Jerry",533,1308,.407,102,342,.298,431,966,.446,511,667,.766,156,182,338,253,93,316,63,219,1679,1996/1997
"Starks,John",369,856,.431,150,407,.369,219,449,.488,173,225,.769,36,169,205,217,90,158,11,196,1061,1996/1997
"Steigenga,Matt",1,4,.250,0,2,.000,1,2,.500,1,2,.500,0,3,3,2,1,2,1,1,3,1996/1997
"Stephens,Joe",1,5,.200,1,3,.333,0,2,.000,0,0,,2,1,3,0,3,3,0,3,3,1996/1997
"Stewart,Larry",112,252,.444,9,37,.243,103,215,.479,67,93,.720,75,96,171,52,31,63,23,108,300,1996/1997
"Stith,Bryant",251,603,.416,70,182,.385,181,421,.430,202,234,.863,74,143,217,133,60,101,20,119,774,1996/1997
"Stockton,John",416,759,.548,76,180,.422,340,579,.587,275,325,.846,45,183,228,860,166,248,15,194,1183,1996/1997
"Stoudamire,Damon",564,1407,.401,176,496,.355,388,911,.426,330,401,.823,86,244,330,709,123,288,13,162,1634,1996/1997
"Strickland,Erick",102,256,.398,28,92,.304,74,164,.451,65,80,.813,21,69,90,68,27,66,5,75,297,1996/1997
"Strickland,Mark",25,60,.417,0,1,.000,25,59,.424,12,21,.571,16,21,37,1,4,15,10,17,62,1996/1997
"Strickland,Rod",515,1105,.466,13,77,.169,502,1028,.488,367,497,.738,95,240,335,727,143,270,14,166,1410,1996/1997
"Strong,Derek",262,586,.447,0,13,.000,262,573,.457,175,218,.803,174,345,519,73,47,102,20,196,699,1996/1997
"Sura,Bob",253,587,.431,53,164,.323,200,423,.473,196,319,.614,76,232,308,390,90,181,33,218,755,1996/1997
"Szabo,Brett",54,121,.446,0,1,.000,54,120,.450,45,61,.738,56,109,165,17,16,41,32,119,153,1996/1997
"Tabak,Žan",32,71,.451,0,0,,32,71,.451,20,29,.690,20,29,49,14,6,21,11,35,84,1996/1997
"Thomas,Carl",9,24,.375,2,12,.167,7,12,.583,1,1,1.000,3,10,13,8,2,6,1,7,21,1996/1997
"Thomas,Kurt",39,105,.371,0,1,.000,39,104,.375,35,46,.761,31,76,107,9,12,25,9,67,113,1996/1997
"Thompson,Brooks",162,406,.399,97,244,.398,65,162,.401,24,38,.632,18,78,96,180,55,87,2,126,445,1996/1997
"Thompson,Brooks",0,1,.000,0,0,,0,1,.000,0,0,,0,0,0,1,0,1,0,1,0,1996/1997
"Thompson,Brooks",162,405,.400,97,244,.398,65,161,.404,24,38,.632,18,78,96,179,55,86,2,125,445,1996/1997
"Thompson,LaSalle",3,19,.158,0,0,,3,19,.158,4,6,.667,7,27,34,2,3,9,6,33,10,1996/1997
"Thompson,LaSalle",3,16,.188,0,0,,3,16,.188,1,2,.500,5,21,26,0,3,7,6,26,7,1996/1997
"Thompson,LaSalle",0,3,.000,0,0,,0,3,.000,3,4,.750,2,6,8,2,0,2,0,7,3,1996/1997
"Thorpe,Otis",419,787,.532,0,2,.000,419,785,.534,198,303,.653,226,396,622,133,59,145,17,298,1036,1996/1997
"Threatt,Sedale",28,74,.378,8,20,.400,20,54,.370,6,8,.750,5,19,24,40,15,13,3,29,70,1996/1997
"Tisdale,Wayman",158,371,.426,0,0,,158,371,.426,30,48,.625,35,85,120,20,8,36,21,111,346,1996/1997
"Tower,Keith",3,8,.375,0,0,,3,8,.375,1,8,.125,2,7,9,1,2,2,1,12,7,1996/1997
"Trent,Gary",361,674,.536,0,11,.000,361,663,.544,160,229,.699,156,272,428,87,48,129,35,186,882,1996/1997
"Van Exel,Nick",432,1075,.402,177,468,.378,255,607,.420,165,200,.825,44,182,226,672,75,212,10,110,1206,1996/1997
"Vaughn,David",31,72,.431,0,0,,31,72,.431,19,30,.633,35,60,95,7,8,29,15,43,81,1996/1997
"Vaught,Loy",542,1084,.500,2,12,.167,540,1072,.504,134,191,.702,222,595,817,110,85,137,25,241,1220,1996/1997
"Vranković,Stojko",78,139,.561,0,0,,78,139,.561,25,37,.676,57,111,168,14,10,52,67,121,181,1996/1997
"Walker,Antoine",576,1354,.425,52,159,.327,524,1195,.438,231,366,.631,288,453,741,262,105,230,53,271,1435,1996/1997
"Walker,Samaki",83,187,.444,0,1,.000,83,186,.446,48,74,.649,47,100,147,17,15,39,22,71,214,1996/1997
"Wallace,Ben",16,46,.348,0,0,,16,46,.348,6,20,.300,25,33,58,2,8,18,11,27,38,1996/1997
"Wallace,John",122,236,.517,2,4,.500,120,232,.517,79,110,.718,51,104,155,37,21,76,25,102,325,1996/1997
"Wallace,Rasheed",380,681,.558,9,33,.273,371,648,.573,169,265,.638,122,297,419,74,48,114,59,198,938,1996/1997
"Walters,Rex",148,325,.455,57,148,.385,91,177,.514,49,62,.790,21,86,107,113,28,61,3,75,402,1996/1997
"Ward,Charlie",133,337,.395,48,154,.312,85,183,.464,95,125,.760,45,175,220,326,83,147,15,188,409,1996/1997
"Watson,Jamie",31,72,.431,4,12,.333,27,60,.450,12,16,.750,18,29,47,33,22,24,4,34,78,1996/1997
"Watson,Jamie",11,25,.440,1,3,.333,10,22,.455,10,12,.833,4,14,18,10,11,9,2,16,33,1996/1997
"Watson,Jamie",20,47,.426,3,9,.333,17,38,.447,2,4,.500,14,15,29,23,11,15,2,18,45,1996/1997
"Weatherspoon,Clarence",398,811,.491,1,6,.167,397,805,.493,206,279,.738,219,460,679,140,74,137,86,187,1003,1996/1997
"Webber,Chris",604,1167,.518,60,151,.397,544,1016,.535,177,313,.565,238,505,743,331,122,230,137,258,1445,1996/1997
"Wennington,Bill",118,237,.498,0,2,.000,118,235,.502,44,53,.830,46,83,129,41,10,31,11,132,280,1996/1997
"Werdann,Robert",3,7,.429,0,0,,3,7,.429,3,3,1.000,3,3,6,0,2,2,1,10,9,1996/1997
"Wesley,David",456,974,.468,103,286,.360,353,688,.513,225,288,.781,67,197,264,537,162,211,13,221,1240,1996/1997
"West,Doug",226,484,.467,15,45,.333,211,439,.481,64,94,.681,37,111,148,113,61,66,24,218,531,1996/1997
"West,Mark",100,180,.556,0,0,,100,180,.556,27,56,.482,69,117,186,19,11,52,55,142,227,1996/1997
"Whatley,Ennis",2,4,.500,0,0,,2,4,.500,0,0,,0,3,3,3,0,1,0,5,4,1996/1997
"Whiteside,Donald",18,55,.327,12,36,.333,6,19,.316,11,15,.733,2,10,12,36,11,17,0,23,59,1996/1997
"Whitney,Chris",139,330,.421,58,163,.356,81,167,.485,94,113,.832,13,91,104,182,49,68,4,100,430,1996/1997
"Wilkins,Dominique",397,953,.417,70,239,.293,327,714,.458,281,350,.803,169,233,402,119,39,135,31,100,1145,1996/1997
"Wilkins,Gerald",323,759,.426,66,203,.325,257,556,.462,136,190,.716,59,114,173,173,54,123,12,144,848,1996/1997
"Williams,Aaron",85,148,.574,0,1,.000,85,147,.578,33,49,.673,62,81,143,15,16,32,29,72,203,1996/1997
"Williams,Aaron",3,5,.600,0,0,,3,5,.600,0,0,,2,3,5,0,0,4,3,0,6,1996/1997
"Williams,Aaron",82,143,.573,0,1,.000,82,142,.577,33,49,.673,60,78,138,15,16,28,26,72,197,1996/1997
"Williams,Buck",175,326,.537,0,1,.000,175,325,.538,115,179,.642,166,231,397,53,40,79,38,204,465,1996/1997
"Williams,Eric",374,820,.456,2,8,.250,372,812,.458,328,436,.752,126,203,329,129,72,139,13,213,1078,1996/1997
"Williams,Herb",18,46,.391,0,1,.000,18,45,.400,3,4,.750,9,22,31,5,4,5,5,18,39,1996/1997
"Williams,Hot Rod",204,416,.490,0,2,.000,204,414,.493,133,198,.672,178,384,562,100,67,66,88,176,541,1996/1997
"Williams,Jayson",221,540,.409,0,4,.000,221,536,.412,108,183,.590,242,311,553,51,24,82,36,158,550,1996/1997
"Williams,Jerome",20,51,.392,0,0,,20,51,.392,9,17,.529,22,28,50,7,13,13,1,18,49,1996/1997
"Williams,Lorenzo",20,31,.645,0,0,,20,31,.645,5,7,.714,28,41,69,4,6,18,8,49,45,1996/1997
"Williams,Monty",234,460,.509,0,1,.000,234,459,.510,120,186,.645,98,108,206,91,55,116,52,161,588,1996/1997
"Williams,Reggie",29,76,.382,9,34,.265,20,42,.476,9,12,.750,5,26,31,10,8,12,4,33,76,1996/1997
"Williams,Reggie",2,9,.222,0,1,.000,2,8,.250,1,2,.500,1,6,7,2,0,2,0,5,5,1996/1997
"Williams,Reggie",27,67,.403,9,33,.273,18,34,.529,8,10,.800,4,20,24,8,8,10,4,28,71,1996/1997
"Williams,Scott",162,318,.509,0,2,.000,162,316,.513,38,55,.691,155,242,397,41,44,50,41,206,362,1996/1997
"Williams,Walt",419,982,.427,175,437,.400,244,545,.448,186,243,.765,103,264,367,197,97,174,62,282,1199,1996/1997
"Williamson,Corliss",371,745,.498,0,3,.000,371,742,.500,173,251,.689,139,187,326,124,60,157,49,263,915,1996/1997
"Willis,Kevin",350,728,.481,2,14,.143,348,714,.487,140,202,.693,146,415,561,71,42,119,32,216,842,1996/1997
"Wingate,David",89,214,.416,25,71,.352,64,143,.448,33,40,.825,23,51,74,80,44,37,5,108,236,1996/1997
"Wingfield,Dontonio",79,193,.409,26,77,.338,53,116,.457,27,40,.675,63,74,137,45,14,49,6,101,211,1996/1997
"Wolf,Joe",40,89,.449,1,7,.143,39,82,.476,14,19,.737,32,80,112,20,14,14,11,105,95,1996/1997
"Wood,David",20,38,.526,5,15,.333,15,23,.652,12,18,.667,5,22,27,13,7,6,6,36,57,1996/1997
"Workman,Haywoode",11,20,.550,0,3,.000,11,17,.647,0,1,.000,4,3,7,11,3,5,0,10,22,1996/1997
"Wright,Lorenzen",236,491,.481,1,4,.250,235,487,.483,88,150,.587,206,265,471,49,48,79,60,211,561,1996/1997
"Wright,Sharone",161,403,.400,0,1,.000,161,402,.400,68,133,.511,79,107,186,28,15,93,50,146,390,1996/1997
"Zídek,George",49,118,.415,0,2,.000,49,116,.422,45,57,.789,35,51,86,14,5,27,3,61,143,1996/1997
"Zídek,George",33,85,.388,0,2,.000,33,83,.398,25,32,.781,25,38,63,9,4,23,3,44,91,1996/1997
"Zídek,George",16,33,.485,0,0,,16,33,.485,20,25,.800,10,13,23,5,1,4,0,17,52,1996/1997
"Đorđević,Aleksandar",8,16,.500,5,7,.714,3,9,.333,4,5,.800,1,4,5,5,0,5,0,3,25,1996/1997
"Abdul-Rauf,Mahmoud",103,273,.377,5,31,.161,98,242,.405,16,16,1.000,6,31,37,58,16,19,1,31,227,1997/1998
"Abdul-Wahad,Tariq",144,357,.403,4,19,.211,140,338,.414,84,125,.672,44,72,116,51,35,65,13,81,376,1997/1998
"Abdur-Rahim,Shareef",653,1347,.485,21,51,.412,632,1296,.488,502,640,.784,227,354,581,213,89,257,76,201,1829,1997/1998
"Alexander,Cory",171,400,.428,66,176,.375,105,224,.469,80,102,.784,17,129,146,209,70,112,11,98,488,1997/1998
"Alexander,Cory",60,145,.414,20,64,.313,40,81,.494,25,37,.676,7,40,47,71,25,47,5,53,165,1997/1998
"Alexander,Cory",111,255,.435,46,112,.411,65,143,.455,55,65,.846,10,89,99,138,45,65,6,45,323,1997/1998
"Allen,Ray",563,1315,.428,134,368,.364,429,947,.453,342,391,.875,127,278,405,356,111,263,12,244,1602,1997/1998
"Anderson,Derek",239,586,.408,17,84,.202,222,502,.442,275,315,.873,55,132,187,227,86,128,13,136,770,1997/1998
"Anderson,Greg",36,81,.444,0,5,.000,36,76,.474,16,41,.390,39,79,118,15,19,17,10,85,88,1997/1998
"Anderson,Kenny",268,674,.398,57,160,.356,211,514,.411,153,194,.789,39,134,173,345,87,143,1,135,746,1997/1998
"Anderson,Kenny",204,527,.387,47,133,.353,157,394,.398,112,145,.772,36,98,134,245,61,114,1,99,567,1997/1998
"Anderson,Kenny",64,147,.435,10,27,.370,54,120,.450,41,49,.837,3,36,39,100,26,29,0,36,179,1997/1998
"Anderson,Nick",343,754,.455,77,214,.360,266,540,.493,127,199,.638,98,199,297,119,72,85,23,98,890,1997/1998
"Anderson,Shandon",269,500,.538,7,32,.219,262,468,.560,136,185,.735,86,141,227,89,66,91,18,145,681,1997/1998
"Anstey,Chris",92,231,.398,3,16,.188,89,215,.414,53,74,.716,53,104,157,35,31,41,27,95,240,1997/1998
"Anthony,Greg",150,349,.430,66,159,.415,84,190,.442,53,80,.663,18,93,111,205,64,91,3,97,419,1997/1998
"Armstrong,B.J.",105,213,.493,9,35,.257,96,178,.539,42,50,.840,16,60,76,150,29,42,0,74,261,1997/1998
"Armstrong,B.J.",6,19,.316,0,1,.000,6,18,.333,5,7,.714,4,3,7,6,4,7,0,6,17,1997/1998
"Armstrong,B.J.",99,194,.510,9,34,.265,90,160,.563,37,43,.860,12,57,69,144,25,35,0,68,244,1997/1998
"Armstrong,Darrell",156,380,.411,25,68,.368,131,312,.420,105,123,.854,65,94,159,236,58,112,5,96,442,1997/1998
"Askew,Vincent",19,54,.352,0,2,.000,19,52,.365,28,39,.718,21,47,68,38,19,35,5,39,66,1997/1998
"Askins,Keith",39,122,.320,21,74,.284,18,48,.375,12,19,.632,28,73,101,29,27,26,12,107,111,1997/1998
"Augmon,Stacey",154,372,.414,1,7,.143,153,365,.419,94,156,.603,104,131,235,88,57,81,32,144,403,1997/1998
"Austin,Isaac",406,871,.466,0,8,.000,406,863,.470,243,363,.669,199,358,557,175,61,206,56,231,1055,1997/1998
"Austin,Isaac",252,532,.474,0,3,.000,252,529,.476,155,228,.680,119,211,330,87,43,117,34,162,659,1997/1998
"Austin,Isaac",154,339,.454,0,5,.000,154,334,.461,88,135,.652,80,147,227,88,18,89,22,69,396,1997/1998
"Baker,Vin",631,1164,.542,1,7,.143,630,1157,.545,311,526,.591,286,370,656,152,91,174,86,278,1574,1997/1998
"Barkley,Charles",361,744,.485,18,84,.214,343,660,.520,296,397,.746,241,553,794,217,71,147,28,187,1036,1997/1998
"Barros,Dana",281,609,.461,100,246,.407,181,363,.499,122,144,.847,28,125,153,286,83,107,6,124,784,1997/1998
"Barry,Brent",213,506,.421,90,229,.393,123,277,.444,115,134,.858,29,142,171,153,64,104,27,118,631,1997/1998
"Barry,Brent",190,444,.428,78,195,.400,112,249,.450,103,122,.844,27,116,143,132,50,95,23,88,561,1997/1998
"Barry,Brent",23,62,.371,12,34,.353,11,28,.393,12,12,1.000,2,26,28,21,14,9,4,30,70,1997/1998
"Barry,Drew",18,38,.474,9,21,.429,9,17,.529,11,13,.846,5,30,35,49,10,30,1,28,56,1997/1998
"Barry,Jon",38,104,.365,18,61,.295,20,43,.465,27,29,.931,8,29,37,51,24,22,3,33,121,1997/1998
"Battie,Tony",234,525,.446,3,14,.214,231,511,.452,73,104,.702,138,213,351,60,54,98,69,199,544,1997/1998
"Beck,Corey",73,159,.459,2,4,.500,71,155,.458,43,59,.729,27,63,90,98,33,70,7,100,191,1997/1998
"Benjamin,Benoit",22,41,.537,0,0,,22,41,.537,19,30,.633,18,35,53,3,4,12,4,26,63,1997/1998
"Bennett,Mario",80,135,.593,1,2,.500,79,133,.594,16,44,.364,60,66,126,18,19,21,11,61,177,1997/1998
"Benoit,David",152,408,.373,55,170,.324,97,238,.408,61,74,.824,60,143,203,25,35,52,20,157,420,1997/1998
"Benoit,David",102,269,.379,41,119,.345,61,150,.407,37,44,.841,42,99,141,17,26,39,16,120,282,1997/1998
"Benoit,David",50,139,.360,14,51,.275,36,88,.409,24,30,.800,18,44,62,8,9,13,4,37,138,1997/1998
"Best,Travis",201,480,.419,21,70,.300,180,410,.439,112,131,.855,28,94,122,281,85,111,5,193,535,1997/1998
"Billups,Chauncey",280,749,.374,107,325,.329,173,424,.408,226,266,.850,62,128,190,314,107,174,4,172,893,1997/1998
"Billups,Chauncey",177,454,.390,64,189,.339,113,265,.426,147,180,.817,40,73,113,217,77,118,2,118,565,1997/1998
"Billups,Chauncey",103,295,.349,43,136,.316,60,159,.377,79,86,.919,22,55,77,97,30,56,2,54,328,1997/1998
"Blaylock,Mookie",368,938,.392,90,334,.269,278,604,.460,95,134,.709,81,260,341,469,183,176,21,122,921,1997/1998
"Blount,Corie",107,187,.572,0,4,.000,107,183,.585,39,78,.500,114,184,298,37,29,51,25,157,253,1997/1998
"Bogues,Muggsy",141,323,.437,4,16,.250,137,307,.446,61,68,.897,30,102,132,331,67,105,3,58,347,1997/1998
"Bogues,Muggsy",2,5,.400,0,0,,2,5,.400,2,2,1.000,0,1,1,4,2,1,0,2,6,1997/1998
"Bogues,Muggsy",139,318,.437,4,16,.250,135,302,.447,59,66,.894,30,101,131,327,65,104,3,56,341,1997/1998
"Bohannon,Etdrick",0,4,.000,0,0,,0,4,.000,0,0,,2,4,6,1,0,3,2,3,0,1997/1998
"Booth,Keith",2,6,.333,0,1,.000,2,5,.400,6,6,1.000,2,2,4,1,0,3,0,3,10,1997/1998
"Bowen,Bruce",122,298,.409,20,59,.339,102,239,.427,76,122,.623,79,95,174,81,87,52,29,174,340,1997/1998
"Bowie,Anthony",32,59,.542,3,4,.750,29,55,.527,8,9,.889,9,17,26,11,6,7,2,25,75,1997/1998
"Bradley,Shawn",300,711,.422,1,3,.333,299,708,.422,130,180,.722,164,354,518,60,51,96,214,214,731,1997/1998
"Brandon,Terrell",339,731,.464,31,93,.333,308,638,.483,132,156,.846,23,153,176,387,111,145,17,120,841,1997/1998
"Breaux,Tim",4,11,.364,1,3,.333,3,8,.375,1,2,.500,0,2,2,2,2,1,1,1,10,1997/1998
"Brooks,Scott",28,66,.424,5,11,.455,23,55,.418,18,20,.900,6,24,30,49,18,12,3,25,79,1997/1998
"Brown,Chucky",161,372,.433,2,8,.250,159,364,.437,63,87,.724,57,126,183,55,23,51,13,100,387,1997/1998
"Brown,Dee",246,562,.438,108,271,.399,138,291,.474,58,71,.817,24,128,152,154,82,73,23,123,658,1997/1998
"Brown,Dee",109,255,.427,43,113,.381,66,142,.465,19,28,.679,10,52,62,53,44,32,6,76,280,1997/1998
"Brown,Dee",137,307,.446,65,158,.411,72,149,.483,39,43,.907,14,76,90,101,38,41,17,47,378,1997/1998
"Brown,P.J.",278,590,.471,0,0,,278,590,.471,151,197,.766,235,400,635,103,66,97,98,264,707,1997/1998
"Brown,Randy",116,302,.384,0,5,.000,116,297,.391,56,78,.718,34,60,94,151,71,63,12,118,288,1997/1998
"Brunson,Rick",49,141,.348,22,61,.361,27,80,.338,42,62,.677,14,42,56,100,25,52,3,55,162,1997/1998
"Bryant,Kobe",391,913,.428,75,220,.341,316,693,.456,363,457,.794,79,163,242,199,74,157,40,180,1220,1997/1998
"Bryant,Mark",109,225,.484,0,1,.000,109,224,.487,73,95,.768,92,152,244,46,36,58,15,180,291,1997/1998
"Buechler,Jud",85,176,.483,25,65,.385,60,111,.541,3,6,.500,24,53,77,49,22,21,15,47,198,1997/1998
"Bullard,Matt",175,389,.450,96,231,.416,79,158,.500,20,27,.741,25,121,146,60,31,39,24,104,466,1997/1998
"Burrell,Scott",159,375,.424,51,144,.354,108,231,.468,47,64,.734,80,118,198,65,64,50,37,131,416,1997/1998
"Burton,Willie",8,21,.381,3,9,.333,5,12,.417,8,12,.667,3,6,9,1,2,1,2,7,27,1997/1998
"Butler,Mitchell",15,47,.319,1,6,.167,14,41,.341,6,10,.600,6,16,22,18,8,8,0,26,37,1997/1998
"Caffey,Jason",226,466,.485,0,2,.000,226,464,.487,131,200,.655,160,184,344,67,25,105,20,181,583,1997/1998
"Caffey,Jason",100,199,.503,0,1,.000,100,198,.505,68,103,.660,76,97,173,36,13,48,17,92,268,1997/1998
"Caffey,Jason",126,267,.472,0,1,.000,126,266,.474,63,97,.649,84,87,171,31,12,57,3,89,315,1997/1998
"Cage,Michael",43,84,.512,0,1,.000,43,83,.518,20,36,.556,115,193,308,32,45,23,44,105,106,1997/1998
"Caldwell,Adrian",0,0,,0,0,,0,0,,0,0,,0,0,0,0,0,0,0,0,0,1997/1998
"Camby,Marcus",308,747,.412,0,2,.000,308,745,.413,149,244,.611,203,263,466,111,68,134,230,200,765,1997/1998
"Campbell,Elden",289,624,.463,1,2,.500,288,622,.463,237,342,.693,143,312,455,78,35,115,102,209,816,1997/1998
"Carr,Antoine",151,325,.465,0,0,,151,325,.465,76,98,.776,42,89,131,48,11,48,53,195,378,1997/1998
"Carr,Chris",190,452,.420,40,127,.315,150,325,.462,84,99,.848,43,112,155,85,17,69,11,129,504,1997/1998
"Cassell,Sam",510,1156,.441,15,80,.188,495,1076,.460,436,507,.860,73,155,228,603,121,269,20,262,1471,1997/1998
"Cato,Kelvin",98,229,.428,0,3,.000,98,226,.434,86,125,.688,91,161,252,23,29,44,94,164,282,1997/1998
"Causwell,Duane",37,89,.416,0,0,,37,89,.416,15,26,.577,29,70,99,5,7,18,27,73,89,1997/1998
"Ceballos,Cedric",204,415,.492,21,70,.300,183,345,.530,107,145,.738,75,146,221,60,33,72,16,88,536,1997/1998
"Ceballos,Cedric",129,258,.500,15,50,.300,114,208,.548,60,84,.714,51,98,149,35,22,39,8,59,333,1997/1998
"Ceballos,Cedric",75,157,.478,6,20,.300,69,137,.504,47,61,.770,24,48,72,25,11,33,8,29,203,1997/1998
"Chambers,Tom",2,2,1.000,0,0,,2,2,1.000,2,2,1.000,0,2,2,0,2,1,0,2,6,1997/1998
"Chapman,Rex",408,956,.427,120,311,.386,288,645,.447,146,187,.781,30,143,173,203,71,116,14,102,1082,1997/1998
"Cheaney,Calbert",448,981,.457,15,53,.283,433,928,.467,139,215,.647,82,242,324,173,96,104,36,264,1050,1997/1998
"Chilcutt,Pete",156,359,.435,54,130,.415,102,229,.445,39,59,.661,77,229,306,104,53,62,37,158,405,1997/1998
"Childs,Chris",149,354,.421,27,87,.310,122,267,.457,104,126,.825,29,133,162,268,56,103,6,179,429,1997/1998
"Christie,Doug",458,1071,.428,100,307,.326,358,764,.469,271,327,.829,94,310,404,282,190,228,57,198,1287,1997/1998
"Closs,Keith",93,207,.449,0,0,,93,207,.449,46,77,.597,63,105,168,19,12,38,81,73,232,1997/1998
"Coleman,Derrick",356,867,.411,26,98,.265,330,769,.429,302,391,.772,149,438,587,145,46,157,68,144,1040,1997/1998
"Coles,Bimbo",166,438,.379,13,57,.228,153,381,.402,78,88,.886,17,106,123,248,51,89,13,135,423,1997/1998
"Collins,James",21,55,.382,9,20,.450,12,35,.343,8,14,.571,7,7,14,3,6,8,3,12,59,1997/1998
"Conlon,Marty",28,62,.452,0,0,,28,62,.452,32,44,.727,16,30,46,12,9,11,5,27,88,1997/1998
"Corbin,Tyrone",328,747,.439,49,141,.348,279,606,.460,101,128,.789,78,284,362,173,105,86,7,197,806,1997/1998
"Cotton,James",8,21,.381,0,4,.000,8,17,.471,8,9,.889,2,4,6,0,1,6,1,3,24,1997/1998
"Crawford,Chris",46,110,.418,1,3,.333,45,107,.421,57,68,.838,20,21,41,9,12,18,7,27,150,1997/1998
"Croshere,Austin",32,86,.372,4,13,.308,28,73,.384,8,14,.571,10,35,45,8,9,13,5,32,76,1997/1998
"Crotty,John",29,90,.322,6,20,.300,23,70,.329,32,34,.941,4,28,32,63,10,42,1,28,96,1997/1998
"Cummings,Terry",200,428,.467,0,1,.000,200,427,.468,67,98,.684,97,186,283,47,38,51,10,181,467,1997/1998
"Cummings,Terry",97,212,.458,0,1,.000,97,211,.460,39,58,.672,55,93,148,21,22,17,5,102,233,1997/1998
"Cummings,Terry",103,216,.477,0,0,,103,216,.477,28,40,.700,42,93,135,26,16,34,5,79,234,1997/1998
"Cunningham,William",4,9,.444,0,0,,4,9,.444,0,0,,4,6,10,1,2,0,0,10,8,1997/1998
"Cunningham,William",4,9,.444,0,0,,4,9,.444,0,0,,4,4,8,1,2,0,0,10,8,1997/1998
"Cunningham,William",0,0,,0,0,,0,0,,0,0,,0,2,2,0,0,0,0,0,0,1997/1998
"Curley,Bill",16,33,.485,0,1,.000,16,32,.500,2,3,.667,11,17,28,4,3,3,1,28,34,1997/1998
"Curry,Dell",194,434,.447,61,145,.421,133,289,.460,41,52,.788,26,75,101,69,31,54,4,85,490,1997/1998
"Curry,Michael",196,418,.469,4,9,.444,192,409,.469,147,176,.835,26,72,98,137,56,77,14,218,543,1997/1998
"Dampier,Erick",352,791,.445,0,2,.000,352,789,.446,267,399,.669,272,443,715,94,39,175,139,281,971,1997/1998
"Daniels,Antonio",228,548,.416,11,52,.212,217,496,.438,112,170,.659,22,121,143,334,55,164,10,88,579,1997/1998
"Daniels,Lloyd",12,29,.414,2,9,.222,10,20,.500,8,10,.800,4,3,7,4,3,4,2,4,34,1997/1998
"Dare,Yinka",4,18,.222,0,0,,4,18,.222,4,8,.500,10,7,17,1,0,2,2,9,12,1997/1998
"Davis,Antonio",254,528,.481,0,3,.000,254,525,.484,277,398,.696,192,368,560,61,45,103,72,234,785,1997/1998
"Davis,Ben",2,10,.200,0,0,,2,10,.200,0,0,,6,0,6,0,1,0,0,3,4,1997/1998
"Davis,Dale",273,498,.548,0,0,,273,498,.548,80,172,.465,233,378,611,70,51,73,87,209,626,1997/1998
"Davis,Emanual",63,142,.444,27,72,.375,36,70,.514,31,37,.838,10,37,47,59,17,52,3,55,184,1997/1998
"Davis,Hubert",350,767,.456,101,230,.439,249,537,.464,97,116,.836,34,135,169,157,43,88,5,117,898,1997/1998
"Davis,Mark",109,244,.447,0,6,.000,109,238,.458,64,101,.634,64,94,158,73,49,91,18,95,282,1997/1998
"Davis,Terry",127,256,.496,0,1,.000,127,255,.498,69,119,.580,209,271,480,30,41,56,24,193,323,1997/1998
"Day,Todd",11,31,.355,2,12,.167,9,19,.474,6,9,.667,4,2,6,7,7,3,0,10,30,1997/1998
"DeClercq,Andrew",169,340,.497,0,1,.000,169,339,.499,101,168,.601,180,212,392,59,85,84,49,277,439,1997/1998
"Dehere,Terry",180,451,.399,50,132,.379,130,319,.408,79,99,.798,21,85,106,196,52,96,4,150,489,1997/1998
"Del Negro,Vinny",211,479,.441,17,39,.436,194,440,.441,74,93,.796,13,139,152,183,39,53,6,113,513,1997/1998
"Dele,Bison",531,1040,.511,1,3,.333,530,1037,.511,198,280,.707,223,472,695,94,67,181,55,252,1261,1997/1998
"Delk,Tony",314,798,.393,42,157,.268,272,641,.424,111,151,.735,38,134,172,172,73,109,12,96,781,1997/1998
"Delk,Tony",3,4,.750,1,1,1.000,2,3,.667,1,2,.500,0,2,2,3,0,4,0,8,8,1997/1998
"Delk,Tony",311,794,.392,41,156,.263,270,638,.423,110,149,.738,38,132,170,169,73,105,12,88,773,1997/1998
"Divac,Vlade",267,536,.498,3,14,.214,264,522,.506,130,188,.691,183,335,518,172,83,114,94,179,667,1997/1998
"Douglas,Sherman",255,515,.495,14,46,.304,241,469,.514,115,172,.669,52,83,135,319,55,110,7,156,639,1997/1998
"Drexler,Clyde",452,1059,.427,106,334,.317,346,725,.477,277,346,.801,105,241,346,382,126,189,42,193,1287,1997/1998
"Dudley,Chris",58,143,.406,0,0,,58,143,.406,41,92,.446,108,167,275,21,13,44,51,139,157,1997/1998
"Dumars,Joe",329,791,.416,158,426,.371,171,365,.468,127,154,.825,14,90,104,253,44,84,2,99,943,1997/1998
"Dumas,Tony",6,12,.500,2,4,.500,4,8,.500,0,3,.000,1,4,5,5,0,5,0,5,14,1997/1998
"Duncan,Tim",706,1287,.549,0,10,.000,706,1277,.553,319,482,.662,274,703,977,224,55,279,206,254,1731,1997/1998
"Eackles,Ledell",75,175,.429,16,46,.348,59,129,.457,52,59,.881,25,50,75,16,17,29,0,43,218,1997/1998
"Edney,Tyus",93,216,.431,3,10,.300,90,206,.437,88,111,.793,20,35,55,139,51,66,1,69,277,1997/1998
"Edwards,Blue",326,742,.439,40,120,.333,286,622,.460,180,215,.837,61,156,217,201,86,134,27,183,872,1997/1998
"Edwards,Kevin",57,165,.345,6,15,.400,51,150,.340,30,35,.857,20,34,54,39,26,30,1,28,150,1997/1998
"Edwards,Kevin",37,106,.349,4,11,.364,33,95,.347,13,15,.867,11,23,34,26,21,20,0,20,91,1997/1998
"Edwards,Kevin",20,59,.339,2,4,.500,18,55,.327,17,20,.850,9,11,20,13,5,10,1,8,59,1997/1998
"Eisley,Howard",229,519,.441,48,118,.407,181,401,.451,127,149,.852,25,141,166,346,54,160,13,182,633,1997/1998
"Elie,Mario",206,456,.452,55,189,.291,151,267,.566,145,174,.833,39,117,156,221,81,100,8,115,612,1997/1998
"Elliott,Sean",122,303,.403,34,90,.378,88,213,.413,56,78,.718,16,108,124,62,24,57,14,92,334,1997/1998
"Ellis,Dale",348,700,.497,127,274,.464,221,426,.519,111,142,.782,51,133,184,89,60,74,5,128,934,1997/1998
"Ellis,Harold",62,111,.559,0,4,.000,62,107,.579,40,63,.635,27,23,50,18,19,19,4,53,164,1997/1998
"Ellis,LaPhonso",410,1007,.407,57,201,.284,353,806,.438,206,256,.805,146,398,544,213,65,173,49,226,1083,1997/1998
"Ellison,Pervis",40,70,.571,0,0,,40,70,.571,20,34,.588,52,57,109,31,20,28,31,90,100,1997/1998
"Evans,Brian",123,312,.394,29,87,.333,94,225,.418,46,57,.807,49,88,137,55,29,38,13,101,321,1997/1998
"Evans,Brian",77,206,.374,12,45,.267,65,161,.404,40,48,.833,31,54,85,31,22,24,8,57,206,1997/1998
"Evans,Brian",46,106,.434,17,42,.405,29,64,.453,6,9,.667,18,34,52,24,7,14,5,44,115,1997/1998
"Ewing,Patrick",203,403,.504,0,2,.000,203,401,.506,134,186,.720,59,206,265,28,16,77,58,74,540,1997/1998
"Farmer,Tony",17,53,.321,2,9,.222,15,44,.341,31,39,.795,16,16,32,5,10,9,4,23,67,1997/1998
"Feick,Jamie",39,90,.433,4,13,.308,35,77,.455,20,41,.488,45,79,124,16,25,21,17,67,102,1997/1998
"Ferrell,Duane",41,111,.369,0,6,.000,41,105,.390,12,22,.545,25,22,47,26,21,18,6,50,94,1997/1998
"Ferry,Danny",113,286,.395,33,99,.333,80,187,.428,32,40,.800,23,91,114,59,26,53,17,118,291,1997/1998
"Finley,Michael",675,1505,.449,87,244,.357,588,1261,.466,326,416,.784,150,288,438,405,132,219,30,163,1763,1997/1998
"Fisher,Derek",164,378,.434,31,81,.383,133,297,.448,115,152,.757,38,155,193,333,75,119,5,126,474,1997/1998
"Fortson,Danny",276,611,.452,1,3,.333,275,608,.452,263,339,.776,182,266,448,76,44,157,30,314,816,1997/1998
"Foster,Greg",186,418,.445,2,9,.222,184,409,.450,67,87,.770,85,188,273,51,15,68,28,187,441,1997/1998
"Fox,Rick",363,771,.471,86,265,.325,277,506,.547,171,230,.743,78,280,358,276,100,201,48,309,983,1997/1998
"Foyle,Adonal",69,170,.406,0,1,.000,69,169,.408,27,62,.435,73,111,184,14,13,50,52,94,165,1997/1998
"Fuller,Todd",86,205,.420,0,4,.000,86,201,.428,55,80,.688,61,135,196,10,6,37,16,89,227,1997/1998
"Funderburke,Lawrence",191,390,.490,1,7,.143,190,383,.496,110,162,.679,80,154,234,63,19,62,15,56,493,1997/1998
"Garner,Chris",23,70,.329,4,14,.286,19,56,.339,3,7,.429,7,17,24,45,21,25,4,50,53,1997/1998
"Garnett,Kevin",635,1293,.491,3,16,.188,632,1277,.495,245,332,.738,222,564,786,348,139,192,150,224,1518,1997/1998
"Garrett,Dean",242,565,.428,0,0,,242,565,.428,114,176,.648,227,417,644,90,57,84,133,197,598,1997/1998
"Garris,Kiwane",22,65,.338,5,14,.357,17,51,.333,19,25,.760,3,16,19,28,7,15,1,22,68,1997/1998
"Gatling,Chris",248,545,.455,1,4,.250,247,541,.457,159,265,.600,118,216,334,53,52,99,29,152,656,1997/1998
"Geary,Reggie",56,169,.331,12,40,.300,44,129,.341,28,56,.500,19,48,67,74,37,42,12,95,152,1997/1998
"Geiger,Matt",358,709,.505,1,11,.091,357,698,.511,168,236,.712,196,325,521,78,68,111,87,191,885,1997/1998
"Gill,Kendall",418,974,.429,26,101,.257,392,873,.449,225,327,.688,112,279,391,200,156,124,64,268,1087,1997/1998
"Gilliam,Armen",327,676,.484,0,4,.000,327,672,.487,267,333,.802,146,293,439,104,65,148,37,177,921,1997/1998
"Goldwire,Anthony",269,636,.423,63,164,.384,206,472,.436,150,186,.806,40,107,147,277,86,85,7,149,751,1997/1998
"Graham,Greg",7,12,.583,0,3,.000,7,9,.778,2,2,1.000,0,1,1,6,1,10,0,7,16,1997/1998
"Grant,Brian",283,557,.508,0,1,.000,283,556,.509,171,228,.750,197,358,555,86,44,110,45,184,737,1997/1998
"Grant,Gary",43,93,.462,7,19,.368,36,74,.486,12,14,.857,8,40,48,84,17,24,2,30,105,1997/1998
"Grant,Harvey",75,196,.383,1,6,.167,74,190,.389,19,30,.633,60,108,168,39,23,26,15,94,170,1997/1998
"Grant,Horace",393,857,.459,0,7,.000,393,850,.462,135,199,.678,228,390,618,172,81,88,79,180,921,1997/1998
"Gray,Ed",77,202,.381,18,46,.391,59,156,.378,55,65,.846,9,36,45,34,15,30,11,73,227,1997/1998
"Grayer,Jeff",4,11,.364,2,6,.333,2,5,.400,0,0,,0,4,4,2,2,4,0,7,10,1997/1998
"Grayer,Jeff",0,4,.000,0,3,.000,0,1,.000,0,0,,0,0,0,1,0,2,0,0,0,1997/1998
"Grayer,Jeff",4,7,.571,2,3,.667,2,4,.500,0,0,,0,4,4,1,2,2,0,7,10,1997/1998
"Green,A.C.",242,534,.453,0,4,.000,242,530,.457,116,162,.716,219,449,668,123,78,68,27,157,600,1997/1998
"Green,Litterial",5,23,.217,0,2,.000,5,21,.238,15,20,.750,1,6,7,16,4,8,0,11,25,1997/1998
"Grimm,Derek",4,14,.286,4,12,.333,0,2,.000,2,2,1.000,0,4,4,0,3,3,1,6,14,1997/1998
"Gugliotta,Tom",319,635,.502,2,17,.118,317,618,.513,183,223,.821,106,250,356,167,61,109,22,102,823,1997/1998
"Haley,Jack",5,18,.278,0,1,.000,5,17,.294,12,21,.571,5,10,15,0,0,4,1,9,22,1997/1998
"Ham,Darvin",55,104,.529,0,0,,55,104,.529,35,74,.473,72,59,131,16,21,37,25,118,145,1997/1998
"Hammonds,Tom",127,246,.516,0,1,.000,127,245,.518,92,132,.697,100,171,271,36,15,48,17,127,346,1997/1998
"Hanson,Reggie",3,6,.500,0,0,,3,6,.500,0,0,,3,3,6,1,2,3,1,8,6,1997/1998
"Hardaway,Anfernee",103,273,.377,15,50,.300,88,223,.395,90,118,.763,8,68,76,68,28,46,15,45,311,1997/1998
"Hardaway,Tim",558,1296,.431,155,442,.351,403,854,.472,257,329,.781,48,251,299,672,136,224,16,200,1528,1997/1998
"Harper,Derek",226,542,.417,59,164,.360,167,378,.442,55,79,.696,23,80,103,233,72,101,10,140,566,1997/1998
"Harper,Ron",293,665,.441,16,84,.190,277,581,.477,162,216,.750,107,183,290,241,108,91,48,181,764,1997/1998
"Harrington,Othella",129,266,.485,0,1,.000,129,265,.487,92,122,.754,73,134,207,24,10,47,27,112,350,1997/1998
"Harris,Lucious",69,177,.390,12,39,.308,57,138,.413,41,55,.745,21,31,52,42,42,21,5,77,191,1997/1998
"Hawkins,Hersey",280,636,.440,125,301,.415,155,335,.463,177,204,.868,71,263,334,221,148,102,17,153,862,1997/1998
"Henderson,Alan",365,753,.485,3,6,.500,362,747,.485,253,388,.652,200,242,442,73,42,110,36,175,986,1997/1998
"Henderson,Cedric",348,725,.480,0,4,.000,348,721,.483,136,190,.716,71,254,325,168,96,165,45,238,832,1997/1998
"Hendrickson,Mark",58,149,.389,0,5,.000,58,144,.403,47,57,.825,33,110,143,41,26,31,9,60,163,1997/1998
"Henson,Steve",13,26,.500,3,8,.375,10,18,.556,7,7,1.000,0,2,2,4,1,6,0,9,36,1997/1998
"Herrera,Carl",76,175,.434,0,1,.000,76,174,.437,18,44,.409,24,67,91,22,19,38,12,71,170,1997/1998
"Higgins,Sean",0,5,.000,0,2,.000,0,3,.000,0,0,,0,0,0,0,2,1,0,3,0,1997/1998
"Hill,Grant",615,1361,.452,3,21,.143,612,1340,.457,479,647,.740,93,530,623,551,143,285,53,196,1712,1997/1998
"Hill,Tyrone",208,418,.498,0,1,.000,208,417,.499,155,255,.608,212,396,608,88,67,106,30,230,571,1997/1998
"Hoiberg,Fred",85,222,.383,32,85,.376,53,137,.387,59,69,.855,14,109,123,45,40,22,3,101,261,1997/1998
"Honeycutt,Jerald",90,221,.407,29,77,.377,61,144,.424,36,58,.621,27,66,93,33,20,49,6,83,245,1997/1998
"Hornacek,Jeff",399,828,.482,56,127,.441,343,701,.489,285,322,.885,65,205,270,349,109,132,15,175,1139,1997/1998
"Horry,Robert",200,420,.476,19,93,.204,181,327,.554,117,169,.692,186,356,542,163,112,99,94,238,536,1997/1998
"Houston,Allan",571,1277,.447,82,213,.385,489,1064,.460,285,335,.851,43,231,274,212,63,200,24,207,1509,1997/1998
"Howard,Juwan",463,991,.467,0,2,.000,463,989,.468,258,358,.721,161,288,449,208,82,185,23,225,1184,1997/1998
"Howard,Stephen",8,21,.381,0,0,,8,21,.381,9,18,.500,6,6,12,3,3,6,1,13,25,1997/1998
"Hudson,Troy",6,14,.429,0,3,.000,6,11,.545,0,0,,1,1,2,4,2,1,0,1,12,1997/1998
"Hunter,Lindsey",316,826,.383,85,265,.321,231,561,.412,145,196,.740,61,186,247,224,123,110,10,174,862,1997/1998
"Hurley,Bobby",93,238,.391,5,22,.227,88,216,.407,59,76,.776,12,54,66,177,23,86,0,79,250,1997/1998
"Hurley,Bobby",47,115,.409,4,15,.267,43,100,.430,30,37,.811,7,29,36,80,13,42,0,36,128,1997/1998
"Hurley,Bobby",46,123,.374,1,7,.143,45,116,.388,29,39,.744,5,25,30,97,10,44,0,43,122,1997/1998
"Ilgauskas,Zydrunas",454,876,.518,1,4,.250,453,872,.519,230,302,.762,279,444,723,71,52,146,135,288,1139,1997/1998
"Iverson,Allen",649,1407,.461,70,235,.298,579,1172,.494,390,535,.729,86,210,296,494,176,244,25,200,1758,1997/1998
"Jackson,Bobby",310,791,.392,21,81,.259,289,710,.407,149,183,.814,78,224,302,317,105,184,11,160,790,1997/1998
"Jackson,Jaren",258,654,.394,112,297,.377,146,357,.409,94,118,.797,55,155,210,156,60,104,8,222,722,1997/1998
"Jackson,Jim",476,1107,.430,61,191,.319,415,916,.453,229,282,.812,130,270,400,381,79,263,8,186,1242,1997/1998
"Jackson,Jim",246,535,.460,39,112,.348,207,423,.489,126,154,.818,69,158,227,223,41,145,6,112,657,1997/1998
"Jackson,Jim",230,572,.402,22,79,.278,208,493,.422,103,128,.805,61,112,173,158,38,118,2,74,585,1997/1998
"Jackson,Mark",249,598,.416,43,137,.314,206,461,.447,137,180,.761,67,255,322,713,84,174,2,132,678,1997/1998
"James,Henry",24,59,.407,11,25,.440,13,34,.382,21,22,.955,2,13,15,5,1,12,1,24,80,1997/1998
"Johnson,Anthony",226,609,.371,42,128,.328,184,481,.383,80,110,.727,51,120,171,329,64,120,6,188,574,1997/1998
"Johnson,Avery",321,671,.478,2,13,.154,319,658,.485,122,168,.726,30,120,150,591,84,165,18,140,766,1997/1998
"Johnson,Eddie",227,544,.417,66,198,.333,161,346,.465,113,136,.831,50,103,153,88,32,62,3,89,633,1997/1998
"Johnson,Ervin",253,471,.537,0,0,,253,471,.537,143,238,.601,242,443,685,59,79,117,158,321,649,1997/1998
"Johnson,Kevin",155,347,.447,4,26,.154,151,321,.470,162,186,.871,35,129,164,245,27,101,8,57,476,1997/1998
"Johnson,Larry",429,884,.485,15,63,.238,414,821,.504,214,283,.756,175,226,401,150,40,127,13,193,1087,1997/1998
"Jones,Charles",7,10,.700,0,0,,7,10,.700,1,2,.500,12,12,24,5,1,4,6,22,15,1997/1998
"Jones,Dontae'",19,57,.333,6,23,.261,13,34,.382,0,0,,3,6,9,5,2,11,3,12,44,1997/1998
"Jones,Eddie",486,1005,.484,143,368,.389,343,637,.538,234,306,.765,85,217,302,246,160,146,55,164,1349,1997/1998
"Jones,Popeye",52,127,.409,2,3,.667,50,124,.403,14,19,.737,50,52,102,18,10,16,3,39,120,1997/1998
"Jordan,Michael",881,1893,.465,30,126,.238,851,1767,.482,565,721,.784,130,345,475,283,141,185,45,151,2357,1997/1998
"Jordan,Reggie",54,113,.478,0,1,.000,54,112,.482,41,72,.569,57,40,97,50,35,30,9,63,149,1997/1998
"Keefe,Adam",229,424,.540,0,0,,229,424,.540,162,200,.810,179,259,438,89,52,71,24,172,620,1997/1998
"Kemp,Shawn",518,1164,.445,2,8,.250,516,1156,.446,404,556,.727,219,526,745,197,108,271,90,310,1442,1997/1998
"Kempton,Tim",2,9,.222,0,0,,2,9,.222,0,0,,4,2,6,3,1,4,2,10,4,1997/1998
"Kempton,Tim",0,2,.000,0,0,,0,2,.000,0,0,,0,1,1,1,0,0,0,3,0,1997/1998
"Kempton,Tim",2,7,.286,0,0,,2,7,.286,0,0,,4,1,5,2,1,4,2,7,4,1997/1998
"Kerr,Steve",137,302,.454,57,130,.438,80,172,.465,45,49,.918,14,63,77,96,26,27,5,71,376,1997/1998
"Kersey,Jerome",97,233,.416,1,10,.100,96,223,.430,39,65,.600,56,79,135,44,52,36,14,104,234,1997/1998
"Kidd,Jason",357,859,.416,73,233,.313,284,626,.454,167,209,.799,108,402,510,745,162,261,26,142,954,1997/1998
"Kittles,Kerry",508,1154,.440,110,263,.418,398,891,.447,202,250,.808,132,230,362,176,132,106,37,152,1328,1997/1998
"Kleine,Joe",39,106,.368,0,0,,39,106,.368,15,18,.833,27,50,77,30,4,28,5,63,93,1997/1998
"Knight,Brevin",261,592,.441,0,7,.000,261,585,.446,201,251,.801,67,186,253,656,196,194,18,271,723,1997/1998
"Knight,Travis",193,438,.441,15,55,.273,178,383,.465,81,103,.786,146,219,365,104,54,87,82,253,482,1997/1998
"Kukoč,Toni",383,841,.455,63,174,.362,320,667,.480,155,219,.708,121,206,327,314,76,154,37,149,984,1997/1998
"Laettner,Christian",354,730,.485,6,27,.222,348,703,.495,306,354,.864,142,345,487,190,71,183,73,246,1020,1997/1998
"Lang,Andrew",54,143,.378,0,1,.000,54,142,.380,44,57,.772,56,97,153,16,18,33,27,101,152,1997/1998
"Lang,Antonio",3,5,.600,0,0,,3,5,.600,6,8,.750,2,3,5,1,2,4,0,3,12,1997/1998
"LaRue,Rusty",20,49,.408,4,16,.250,16,33,.485,5,8,.625,1,7,8,5,3,6,1,12,49,1997/1998
"Lauderdale,Priest",53,127,.417,0,0,,53,127,.417,38,69,.551,27,73,100,21,7,46,17,63,144,1997/1998
"Lawson,Jason",9,15,.600,0,0,,9,15,.600,8,10,.800,8,19,27,5,4,2,4,14,26,1997/1998
"Legler,Tim",3,19,.158,0,6,.000,3,13,.231,3,4,.750,2,2,4,3,1,4,0,11,9,1997/1998
"Lenard,Voshon",363,854,.425,153,378,.405,210,476,.441,141,179,.788,72,220,292,180,58,99,16,219,1020,1997/1998
"Lister,Alton",3,8,.375,0,0,,3,8,.375,0,0,,2,9,11,1,1,2,1,12,6,1997/1998
"Livingston,Randy",3,12,.250,0,0,,3,12,.250,4,5,.800,1,5,6,5,7,6,2,6,10,1997/1998
"Llamas Grey,Horacio",8,21,.381,1,3,.333,7,18,.389,7,10,.700,4,14,18,1,1,9,3,14,24,1997/1998
"Lohaus,Brad",7,21,.333,4,14,.286,3,7,.429,1,3,.333,3,9,12,5,1,3,2,10,19,1997/1998
"Long,Grant",50,117,.427,0,4,.000,50,113,.442,41,57,.719,57,93,150,25,29,22,12,91,141,1997/1998
"Longley,Luc",277,609,.455,0,0,,277,609,.455,109,148,.736,113,228,341,161,34,130,62,206,663,1997/1998
"Lynch,George",248,516,.481,9,30,.300,239,486,.492,111,158,.703,147,215,362,122,65,104,41,161,616,1997/1998
"Mack,Sam",222,559,.397,110,269,.409,112,290,.386,62,77,.805,30,103,133,101,41,69,11,117,616,1997/1998
"MacLean,Don",1,10,.100,1,2,.500,0,8,.000,0,0,,3,2,5,0,0,2,0,7,3,1997/1998
"Madkins,Gerald",13,34,.382,6,15,.400,7,19,.368,5,7,.714,2,13,15,45,13,13,1,18,37,1997/1998
"Mahorn,Rick",59,129,.457,0,0,,59,129,.457,23,34,.676,65,130,195,15,14,37,7,123,141,1997/1998
"Majerle,Dan",184,439,.419,111,295,.376,73,144,.507,40,51,.784,48,220,268,157,68,65,15,139,519,1997/1998
"Malone,Karl",780,1472,.530,2,6,.333,778,1466,.531,628,825,.761,189,645,834,316,96,247,70,237,2190,1997/1998
"Maloney,Matt",239,586,.408,126,346,.364,113,240,.471,65,78,.833,16,126,142,219,62,107,5,99,669,1997/1998
"Manning,Danny",390,756,.516,0,7,.000,390,749,.521,167,226,.739,110,282,392,139,71,100,46,201,947,1997/1998
"Marbury,Stephon",513,1237,.415,95,304,.313,418,933,.448,329,450,.731,58,172,230,704,104,256,7,222,1450,1997/1998
"Marshall,Donyell",451,1090,.414,63,201,.313,388,889,.436,158,216,.731,210,418,628,159,95,147,73,226,1123,1997/1998
"Martin,Darrick",275,730,.377,107,293,.365,168,437,.384,184,217,.848,19,145,164,331,82,154,10,198,841,1997/1998
"Mashburn,Jamal",251,577,.435,37,122,.303,214,455,.470,184,231,.797,72,164,236,132,43,108,14,137,723,1997/1998
"Mason,Anthony",389,764,.509,0,4,.000,389,760,.512,261,402,.649,177,649,826,342,68,146,18,182,1039,1997/1998
"Massenburg,Tony",148,309,.479,0,0,,148,309,.479,100,137,.730,80,152,232,21,25,60,24,123,396,1997/1998
"Maxwell,Vernon",103,258,.399,37,112,.330,66,146,.452,48,60,.800,14,43,57,52,16,40,4,71,291,1997/1998
"Maxwell,Vernon",26,78,.333,6,26,.231,20,52,.385,23,26,.885,5,8,13,12,2,12,1,20,81,1997/1998
"Maxwell,Vernon",77,180,.428,31,86,.360,46,94,.489,25,34,.735,9,35,44,40,14,28,3,51,210,1997/1998
"Mayberry,Lee",131,349,.375,63,180,.350,68,169,.402,38,51,.745,19,95,114,349,65,113,10,164,363,1997/1998
"McCann,Bob",0,1,.000,0,0,,0,1,.000,0,0,,0,1,1,0,0,0,0,1,0,1997/1998
"McCarty,Walter",295,730,.404,54,175,.309,241,555,.434,144,194,.742,141,223,364,177,110,141,44,274,788,1997/1998
"McCloud,George",173,427,.405,71,208,.341,102,219,.466,39,51,.765,45,173,218,84,54,63,13,132,456,1997/1998
"McDaniel,Xavier",10,30,.333,0,0,,10,30,.333,5,8,.625,12,19,31,9,3,8,2,23,25,1997/1998
"McDonald,Michael",0,0,,0,0,,0,0,,0,0,,1,0,1,0,0,2,0,1,0,1997/1998
"McDyess,Antonio",497,927,.536,0,2,.000,497,925,.537,231,329,.702,206,407,613,106,100,142,135,292,1225,1997/1998
"McGrady,Tracy",179,398,.450,14,41,.341,165,357,.462,79,111,.712,105,164,269,98,49,66,61,86,451,1997/1998
"McIlvaine,Jim",101,223,.453,0,3,.000,101,220,.459,45,81,.556,96,163,259,19,24,54,137,240,247,1997/1998
"McKey,Derrick",150,327,.459,4,17,.235,146,310,.471,55,77,.714,74,137,211,88,57,79,30,156,359,1997/1998
"McKie,Aaron",139,381,.365,12,63,.190,127,318,.399,42,55,.764,58,173,231,175,101,76,13,164,332,1997/1998
"McKie,Aaron",43,104,.413,3,17,.176,40,87,.460,20,23,.870,24,44,68,38,23,24,1,47,109,1997/1998
"McKie,Aaron",96,277,.347,9,46,.196,87,231,.377,22,32,.688,34,129,163,137,78,52,12,117,223,1997/1998
"McMillan,Nate",23,67,.343,15,34,.441,8,33,.242,1,1,1.000,13,27,40,55,14,12,4,41,62,1997/1998
"Mercer,Ron",515,1145,.450,3,28,.107,512,1117,.458,188,224,.839,109,171,280,176,125,132,17,213,1221,1997/1998
"Milič,Marko",39,64,.609,3,6,.500,36,58,.621,11,17,.647,10,15,25,12,10,21,0,17,92,1997/1998
"Miller,Anthony",29,52,.558,0,0,,29,52,.558,21,39,.538,30,40,70,3,15,14,3,41,79,1997/1998
"Miller,Oliver",170,369,.461,0,4,.000,170,365,.466,61,101,.604,146,254,400,196,58,131,72,184,401,1997/1998
"Miller,Reggie",516,1081,.477,164,382,.429,352,699,.504,382,440,.868,46,186,232,171,78,128,11,148,1578,1997/1998
"Mills,Chris",292,675,.433,40,137,.292,252,538,.468,152,189,.804,120,288,408,133,45,107,30,218,776,1997/1998
"Mills,Terry",81,206,.393,25,81,.309,56,125,.448,25,33,.758,34,118,152,39,19,45,9,129,212,1997/1998
"Minor,Greg",140,321,.436,6,31,.194,134,290,.462,59,86,.686,55,95,150,88,53,43,11,100,345,1997/1998
"Mitchell,Sam",371,800,.464,15,43,.349,356,757,.470,243,292,.832,118,267,385,107,64,66,22,200,1000,1997/1998
"Montross,Eric",61,144,.424,0,0,,61,144,.424,16,40,.400,69,130,199,11,13,29,27,127,138,1997/1998
"Montross,Eric",30,76,.395,0,0,,30,76,.395,7,19,.368,28,64,92,7,7,15,12,61,67,1997/1998
"Montross,Eric",31,68,.456,0,0,,31,68,.456,9,21,.429,41,66,107,4,6,14,15,66,71,1997/1998
"Morris,Chris",85,207,.411,19,62,.306,66,145,.455,44,61,.721,35,79,114,24,25,33,17,61,233,1997/1998
"Moten,Lawrence",3,13,.231,0,1,.000,3,12,.250,3,4,.750,1,0,1,3,0,1,0,6,9,1997/1998
"Mourning,Alonzo",403,732,.551,0,0,,403,732,.551,309,465,.665,193,365,558,52,40,179,130,208,1115,1997/1998
"Mullin,Chris",333,692,.481,107,243,.440,226,449,.503,154,164,.939,38,211,249,186,95,117,39,186,927,1997/1998
"Murdock,Eric",177,419,.422,28,91,.308,149,328,.454,125,156,.801,39,117,156,219,103,104,13,173,507,1997/1998
"Murray,Lamond",473,984,.481,54,153,.353,419,831,.504,220,294,.748,172,312,484,142,118,171,54,193,1220,1997/1998
"Murray,Tracy",449,1007,.446,158,403,.392,291,604,.482,182,209,.871,75,202,277,84,67,102,25,167,1238,1997/1998
"Mutombo,Dikembe",399,743,.537,0,0,,399,743,.537,303,452,.670,276,656,932,82,34,168,277,254,1101,1997/1998
"Müürsepp,Martin",83,191,.435,16,38,.421,67,153,.438,51,67,.761,46,68,114,30,29,29,14,96,233,1997/1998
"Myers,Pete",5,10,.500,0,0,,5,10,.500,4,6,.667,5,5,10,3,4,4,0,7,14,1997/1998
"Nash,Steve",268,584,.459,81,195,.415,187,389,.481,74,86,.860,32,128,160,262,63,98,4,145,691,1997/1998
"Newbill,Ivano",20,57,.351,1,1,1.000,19,56,.339,17,30,.567,24,45,69,9,10,17,3,38,58,1997/1998
"Newman,Johnny",344,799,.431,36,105,.343,308,694,.444,365,445,.820,50,91,141,138,77,147,24,208,1089,1997/1998
"Nordgaard,Jeff",5,18,.278,0,0,,5,18,.278,8,9,.889,4,10,14,3,2,3,0,7,18,1997/1998
"O'Bannon,Charles",26,69,.377,0,3,.000,26,66,.394,12,15,.800,14,19,33,17,9,9,1,15,64,1997/1998
"O'Neal,Jermaine",112,231,.485,0,2,.000,112,229,.489,45,89,.506,80,121,201,17,15,55,58,101,269,1997/1998
"O'Neal,Shaquille",670,1147,.584,0,0,,670,1147,.584,359,681,.527,208,473,681,142,39,175,144,193,1699,1997/1998
"Oakley,Charles",307,698,.440,0,6,.000,307,692,.444,97,114,.851,218,506,724,201,123,126,22,280,711,1997/1998
"Olajuwon,Hakeem",306,633,.483,0,3,.000,306,630,.486,160,212,.755,116,344,460,143,84,126,96,152,772,1997/1998
"Oliver,Brian",7,19,.368,0,0,,7,19,.368,1,4,.250,3,6,9,2,1,1,0,4,15,1997/1998
"Oliver,Jimmy",2,4,.500,1,2,.500,1,2,.500,0,0,,0,2,2,1,0,0,0,1,5,1997/1998
"Ollie,Kevin",37,98,.378,0,1,.000,37,97,.381,49,70,.700,9,30,39,65,13,44,0,31,123,1997/1998
"Ollie,Kevin",14,42,.333,0,0,,14,42,.333,18,25,.720,6,15,21,32,6,16,0,16,46,1997/1998
"Ollie,Kevin",23,56,.411,0,1,.000,23,55,.418,31,45,.689,3,15,18,33,7,28,0,15,77,1997/1998
"Ostertag,Greg",115,239,.481,0,0,,115,239,.481,67,140,.479,134,240,374,25,28,74,132,166,297,1997/1998
"Outlaw,Bo",301,543,.554,1,4,.250,300,539,.557,180,313,.575,255,382,637,216,107,175,181,260,783,1997/1998
"Overton,Doug",24,63,.381,0,3,.000,24,60,.400,14,16,.875,2,12,14,37,8,23,1,34,62,1997/1998
"Owens,Billy",338,728,.464,26,70,.371,312,658,.474,116,197,.589,170,412,582,219,93,153,38,231,818,1997/1998
"Pack,Robert",33,98,.337,3,6,.500,30,92,.326,25,36,.694,8,26,34,42,20,38,1,17,94,1997/1998
"Parker,Anthony",25,63,.397,9,28,.321,16,35,.457,13,20,.650,8,18,26,19,11,11,3,17,72,1997/1998
"Parks,Cherokee",224,449,.499,0,1,.000,224,448,.500,110,169,.651,140,297,437,53,36,66,86,237,558,1997/1998
"Payton,Gary",579,1278,.453,134,397,.338,445,881,.505,279,375,.744,77,299,376,679,185,229,18,195,1571,1997/1998
"Peeler,Anthony",190,420,.452,53,125,.424,137,295,.464,36,47,.766,37,86,123,137,61,51,6,97,469,1997/1998
"Peeler,Anthony",35,72,.486,5,19,.263,30,53,.566,4,6,.667,6,14,20,23,9,6,0,16,79,1997/1998
"Peeler,Anthony",155,348,.445,48,106,.453,107,242,.442,32,41,.780,31,72,103,114,52,45,6,81,390,1997/1998
"Perdue,Will",162,295,.549,0,1,.000,162,294,.551,70,133,.526,177,358,535,57,22,81,50,137,394,1997/1998
"Perkins,Sam",196,471,.416,87,222,.392,109,249,.438,101,128,.789,53,202,255,113,62,62,29,158,580,1997/1998
"Perry,Elliot",241,561,.430,17,50,.340,224,511,.438,92,109,.844,21,87,108,230,90,128,2,129,591,1997/1998
"Person,Chuck",143,398,.359,95,276,.344,48,122,.393,28,37,.757,17,187,204,86,29,67,10,121,409,1997/1998
"Person,Wesley",440,957,.460,192,447,.430,248,510,.486,132,170,.776,65,298,363,188,129,110,49,108,1204,1997/1998
"Phills,Bobby",246,552,.446,44,114,.386,202,438,.461,106,140,.757,59,157,216,187,81,108,18,181,642,1997/1998
"Piatkowski,Eric",257,568,.452,106,259,.409,151,309,.489,140,170,.824,70,166,236,85,51,80,12,137,760,1997/1998
"Pierce,Ricky",52,143,.364,4,13,.308,48,130,.369,43,52,.827,19,26,45,34,9,21,0,35,151,1997/1998
"Pippen,Scottie",315,704,.447,61,192,.318,254,512,.496,150,193,.777,53,174,227,254,79,109,43,116,841,1997/1998
"Pollard,Scot",35,70,.500,0,0,,35,70,.500,19,23,.826,34,40,74,9,8,12,10,48,89,1997/1998
"Polynice,Olden",249,542,.459,0,1,.000,249,541,.460,52,115,.452,173,266,439,107,37,98,45,158,550,1997/1998
"Pope,Mark",14,41,.341,1,3,.333,13,38,.342,10,17,.588,9,17,26,7,3,10,6,36,39,1997/1998
"Porter,Terry",259,577,.449,92,233,.395,167,344,.485,167,195,.856,37,131,168,271,63,104,16,103,777,1997/1998
"Potapenko,Vitaly",234,488,.480,0,1,.000,234,487,.480,102,144,.708,110,203,313,57,27,132,28,198,570,1997/1998
"Price,Brent",128,310,.413,73,187,.390,55,123,.447,77,98,.786,37,70,107,192,52,111,4,163,406,1997/1998
"Price,Mark",229,531,.431,52,155,.335,177,376,.471,87,103,.845,24,105,129,297,53,162,5,92,597,1997/1998
"Ratliff,Theo",306,597,.513,0,0,,306,597,.513,197,281,.701,221,326,547,57,50,116,258,292,809,1997/1998
"Ratliff,Theo",57,111,.514,0,0,,57,111,.514,43,63,.683,46,75,121,15,12,34,55,83,157,1997/1998
"Ratliff,Theo",249,486,.512,0,0,,249,486,.512,154,218,.706,175,251,426,42,38,82,203,209,652,1997/1998
"Recasner,Eldridge",206,452,.456,62,148,.419,144,304,.474,74,79,.937,32,110,142,117,41,91,1,94,548,1997/1998
"Reeves,Bryant",492,941,.523,0,4,.000,492,937,.525,223,316,.706,196,389,585,155,39,156,80,278,1207,1997/1998
"Reeves,Khalid",248,593,.418,56,152,.368,192,441,.435,165,213,.775,54,131,185,230,80,130,10,195,717,1997/1998
"Reid,Don",94,176,.534,0,0,,94,176,.534,50,71,.704,77,98,175,26,25,28,55,183,238,1997/1998
"Reid,J.R.",146,318,.459,3,8,.375,143,310,.461,89,122,.730,72,138,210,51,35,65,19,172,384,1997/1998
"Respert,Shawn",130,293,.444,31,93,.333,99,200,.495,48,61,.787,37,63,100,61,34,48,1,75,339,1997/1998
"Respert,Shawn",94,209,.450,25,67,.373,69,142,.486,44,54,.815,30,43,73,44,29,33,1,58,257,1997/1998
"Respert,Shawn",36,84,.429,6,26,.231,30,58,.517,4,7,.571,7,20,27,17,5,15,0,17,82,1997/1998
"Rhodes,Rodrick",112,305,.367,2,8,.250,110,297,.370,111,180,.617,28,42,70,110,62,97,10,125,337,1997/1998
"Rice,Glen",634,1386,.457,130,300,.433,504,1086,.464,428,504,.849,89,264,353,182,77,182,22,200,1826,1997/1998
"Richardson,Pooh",124,333,.372,11,57,.193,113,276,.409,30,43,.698,17,79,96,226,44,54,3,71,289,1997/1998
"Richmond,Mitch",543,1220,.445,130,334,.389,413,886,.466,407,471,.864,50,179,229,279,88,181,15,154,1623,1997/1998
"Rider,Isaiah",551,1302,.423,135,420,.321,416,882,.472,221,267,.828,99,247,346,231,55,187,19,188,1458,1997/1998
"Riley,Eric",56,135,.415,0,1,.000,56,134,.418,27,36,.750,43,90,133,22,15,37,46,80,139,1997/1998
"Roberts,Stanley",191,386,.495,0,0,,191,386,.495,75,156,.481,109,254,363,27,24,70,72,226,457,1997/1998
"Robinson,Chris",65,174,.374,24,66,.364,41,108,.380,8,16,.500,9,37,46,39,19,33,4,50,162,1997/1998
"Robinson,Chris",23,63,.365,7,24,.292,16,39,.410,1,2,.500,0,13,13,10,7,15,1,21,54,1997/1998
"Robinson,Chris",42,111,.378,17,42,.405,25,69,.362,7,14,.500,9,24,33,29,12,18,3,29,108,1997/1998
"Robinson,Clifford",429,895,.479,27,84,.321,402,811,.496,248,360,.689,152,258,410,170,92,140,90,249,1133,1997/1998
"Robinson,David",544,1065,.511,1,4,.250,543,1061,.512,485,660,.735,239,536,775,199,64,202,192,204,1574,1997/1998
"Robinson,Glenn",534,1136,.470,25,65,.385,509,1071,.475,215,266,.808,82,225,307,158,69,200,34,164,1308,1997/1998
"Robinson,James",195,501,.389,74,225,.329,121,276,.438,77,107,.720,37,74,111,135,37,97,10,101,541,1997/1998
"Robinson,Larry",6,19,.316,3,6,.500,3,13,.231,2,2,1.000,2,10,12,1,4,2,0,0,17,1997/1998
"Rodman,Dennis",155,360,.431,4,23,.174,151,337,.448,61,111,.550,421,780,1201,230,47,147,18,238,375,1997/1998
"Rogers,Carlos",47,91,.516,0,2,.000,47,89,.528,18,32,.563,35,32,67,18,10,14,8,35,112,1997/1998
"Rogers,Carlos",45,87,.517,0,1,.000,45,86,.523,18,32,.563,34,31,65,16,9,13,8,34,108,1997/1998
"Rogers,Carlos",2,4,.500,0,1,.000,2,3,.667,0,0,,1,1,2,2,1,1,0,1,4,1997/1998
"Rogers,Rodney",426,935,.456,72,212,.340,354,723,.490,225,328,.686,155,269,424,202,93,193,38,242,1149,1997/1998
"Rogers,Roy",9,25,.360,0,0,,9,25,.360,2,6,.333,8,9,17,2,3,5,8,18,20,1997/1998
"Rogers,Roy",3,8,.375,0,0,,3,8,.375,1,2,.500,0,5,5,1,2,1,4,6,7,1997/1998
"Rogers,Roy",6,17,.353,0,0,,6,17,.353,1,4,.250,8,4,12,1,1,4,4,12,13,1997/1998
"Rooks,Sean",46,101,.455,0,0,,46,101,.455,47,79,.595,46,72,118,24,2,19,23,68,139,1997/1998
"Rose,Jalen",290,607,.478,25,73,.342,265,534,.496,166,228,.728,28,167,195,155,56,132,14,171,771,1997/1998
"Rose,Malik",59,136,.434,1,3,.333,58,133,.436,39,61,.639,40,50,90,19,21,44,7,79,158,1997/1998
"Royal,Donald",25,69,.362,0,0,,25,69,.362,29,33,.879,18,23,41,17,7,10,1,35,79,1997/1998
"Royal,Donald",1,6,.167,0,0,,1,6,.167,3,4,.750,2,2,4,1,1,3,0,5,5,1997/1998
"Royal,Donald",24,63,.381,0,0,,24,63,.381,26,29,.897,16,21,37,16,6,7,1,30,74,1997/1998
"Rozier,Clifford",3,6,.500,0,0,,3,6,.500,0,1,.000,3,3,6,0,0,4,0,7,6,1997/1998
"Russell,Bryon",226,525,.430,73,214,.341,153,311,.492,213,278,.766,78,248,326,101,90,81,31,229,738,1997/1998
"Sabonis,Arvydas",407,826,.493,30,115,.261,377,711,.530,323,405,.798,149,580,729,218,65,190,80,267,1167,1997/1998
"Salvadori,Kevin",1,13,.077,0,0,,1,13,.077,3,6,.500,5,15,20,3,0,5,11,12,5,1997/1998
"Schayes,Danny",155,371,.418,0,0,,155,371,.418,96,119,.807,97,145,242,44,34,61,33,182,406,1997/1998
"Schrempf,Detlef",437,898,.487,61,147,.415,376,751,.501,297,352,.844,135,419,554,341,60,168,19,205,1232,1997/1998
"Scott,Dennis",329,828,.397,125,342,.365,204,486,.420,105,130,.808,47,200,247,153,53,104,39,152,888,1997/1998
"Scott,Dennis",258,666,.387,94,273,.344,164,393,.417,97,118,.822,39,158,197,129,43,92,32,121,707,1997/1998
"Scott,Dennis",71,162,.438,31,69,.449,40,93,.430,8,12,.667,8,42,50,24,10,12,7,31,181,1997/1998
"Scott,Shawnelle",16,36,.444,0,0,,16,36,.444,12,18,.667,20,39,59,8,6,10,8,45,44,1997/1998
"Seals,Shea",1,8,.125,0,3,.000,1,5,.200,2,4,.500,3,1,4,0,1,0,0,1,4,1997/1998
"Sealy,Malik",216,505,.428,9,41,.220,207,464,.446,150,182,.824,48,171,219,100,65,79,20,156,591,1997/1998
"Seikaly,Rony",250,579,.432,0,2,.000,250,577,.433,246,332,.741,146,247,393,77,28,146,43,164,746,1997/1998
"Seikaly,Rony",237,538,.441,0,2,.000,237,536,.442,230,305,.754,130,227,357,69,25,134,39,137,704,1997/1998
"Seikaly,Rony",13,41,.317,0,0,,13,41,.317,16,27,.593,16,20,36,8,3,12,4,27,42,1997/1998
"Shammgod,God",19,58,.328,0,2,.000,19,56,.339,23,30,.767,2,5,7,36,7,21,1,27,61,1997/1998
"Shaw,Brian",154,446,.345,28,95,.295,126,351,.359,36,52,.692,37,178,215,261,49,99,17,148,372,1997/1998
"Shaw,Brian",103,307,.336,21,67,.313,82,240,.342,24,33,.727,20,131,151,173,35,75,14,93,251,1997/1998
"Shaw,Brian",51,139,.367,7,28,.250,44,111,.396,12,19,.632,17,47,64,88,14,24,3,55,121,1997/1998
"Simpkins,Dickey",48,89,.539,0,2,.000,48,87,.552,36,70,.514,27,50,77,33,9,32,5,54,132,1997/1998
"Simpkins,Dickey",22,48,.458,0,1,.000,22,47,.468,10,26,.385,19,27,46,16,5,19,2,19,54,1997/1998
"Simpkins,Dickey",26,41,.634,0,1,.000,26,40,.650,26,44,.591,8,23,31,17,4,13,3,35,78,1997/1998
"Slater,Reggie",211,459,.460,0,0,,211,459,.460,203,322,.630,134,171,305,74,45,102,30,201,625,1997/1998
"Smith,Charles",49,125,.392,15,47,.319,34,78,.436,6,11,.545,13,14,27,21,12,27,6,24,119,1997/1998
"Smith,Charles",4,18,.222,1,3,.333,3,15,.200,1,2,.500,5,3,8,2,2,6,1,3,10,1997/1998
"Smith,Charles",45,107,.421,14,44,.318,31,63,.492,5,9,.556,8,11,19,19,10,21,5,21,109,1997/1998
"Smith,Joe",464,1070,.434,0,8,.000,464,1062,.437,227,293,.775,199,272,471,94,62,158,51,263,1155,1997/1998
"Smith,Joe",343,800,.429,0,7,.000,343,793,.433,160,208,.769,141,197,338,67,44,106,38,169,846,1997/1998
"Smith,Joe",121,270,.448,0,1,.000,121,269,.450,67,85,.788,58,75,133,27,18,52,13,94,309,1997/1998
"Smith,Michael",93,194,.479,0,1,.000,93,193,.482,65,103,.631,120,186,306,88,41,51,15,95,251,1997/1998
"Smith,Michael",26,61,.426,0,0,,26,61,.426,17,30,.567,35,65,100,29,15,15,9,35,69,1997/1998
"Smith,Michael",67,133,.504,0,1,.000,67,132,.508,48,73,.658,85,121,206,59,26,36,6,60,182,1997/1998
"Smith,Steve",489,1101,.444,97,276,.351,392,825,.475,389,455,.855,133,176,309,292,75,176,29,219,1464,1997/1998
"Smith,Tony",8,24,.333,0,4,.000,8,20,.400,3,4,.750,4,3,7,10,5,9,2,7,19,1997/1998
"Smits,Rik",514,1038,.495,0,3,.000,514,1035,.497,188,240,.783,127,378,505,101,40,134,88,243,1216,1997/1998
"Snow,Eric",79,184,.429,2,17,.118,77,167,.461,49,71,.690,19,62,81,177,60,63,5,114,209,1997/1998
"Snow,Eric",10,23,.435,0,1,.000,10,22,.455,5,10,.500,0,4,4,13,0,12,1,15,25,1997/1998
"Snow,Eric",69,161,.429,2,16,.125,67,145,.462,44,61,.721,19,58,77,164,60,51,4,99,184,1997/1998
"Spencer,Felton",59,129,.457,0,0,,59,129,.457,44,79,.557,93,133,226,17,23,49,37,175,162,1997/1998
"Sprewell,Latrell",110,277,.397,9,48,.188,101,229,.441,70,94,.745,7,44,51,68,19,44,5,26,299,1997/1998
"Stackhouse,Jerry",424,975,.435,47,195,.241,377,780,.483,354,450,.787,105,161,266,241,89,224,59,175,1249,1997/1998
"Stackhouse,Jerry",128,283,.452,16,46,.348,112,237,.473,81,101,.802,28,48,76,67,31,74,21,56,353,1997/1998
"Stackhouse,Jerry",296,692,.428,31,149,.208,265,543,.488,273,349,.782,77,113,190,174,58,150,38,119,896,1997/1998
"Starks,John",372,947,.393,130,398,.327,242,549,.441,185,235,.787,48,182,230,219,78,143,5,205,1059,1997/1998
"Stephens,Joe",10,28,.357,3,10,.300,7,18,.389,4,6,.667,3,3,6,1,2,2,0,2,27,1997/1998
"Stewart,Kebu",12,26,.462,0,0,,12,26,.462,16,25,.640,9,22,31,2,5,8,2,13,40,1997/1998
"Stewart,Michael",155,323,.480,0,0,,155,323,.480,65,142,.458,197,339,536,61,29,85,195,251,375,1997/1998
"Stith,Bryant",75,225,.333,10,48,.208,65,177,.367,75,86,.872,15,50,65,50,21,35,8,52,235,1997/1998
"Stockton,John",270,511,.528,39,91,.429,231,420,.550,191,231,.827,35,131,166,543,89,161,10,138,770,1997/1998
"Stokes,Ed",1,3,.333,0,0,,1,3,.333,1,2,.500,1,3,4,1,1,2,2,4,3,1997/1998
"Stoudamire,Damon",448,1091,.411,91,304,.299,357,787,.454,238,287,.829,87,211,298,580,113,223,7,150,1225,1997/1998
"Stoudamire,Damon",354,833,.425,65,205,.317,289,628,.460,179,212,.844,63,154,217,399,80,159,5,112,952,1997/1998
"Stoudamire,Damon",94,258,.364,26,99,.263,68,159,.428,59,75,.787,24,57,81,181,33,64,2,38,273,1997/1998
"Strickland,Erick",199,558,.357,48,163,.294,151,395,.382,65,84,.774,35,126,161,167,56,106,8,140,511,1997/1998
"Strickland,Mark",145,269,.539,0,1,.000,145,268,.541,59,82,.720,80,133,213,26,18,47,34,87,349,1997/1998
"Strickland,Rod",490,1130,.434,12,48,.250,478,1082,.442,357,492,.726,112,293,405,801,126,266,25,182,1349,1997/1998
"Strong,Derek",259,617,.420,0,4,.000,259,613,.423,218,279,.781,152,275,427,51,31,74,24,122,736,1997/1998
"Sura,Bob",87,231,.377,19,60,.317,68,171,.398,74,131,.565,25,69,94,171,44,93,7,113,267,1997/1998
"Tabak,Žan",142,304,.467,0,1,.000,142,303,.469,23,61,.377,84,128,212,48,20,61,38,163,307,1997/1998
"Tabak,Žan",116,249,.466,0,1,.000,116,248,.468,16,48,.333,59,95,154,36,15,44,27,117,248,1997/1998
"Tabak,Žan",26,55,.473,0,0,,26,55,.473,7,13,.538,25,33,58,12,5,17,11,46,59,1997/1998
"Taylor,Johnny",13,37,.351,1,2,.500,12,35,.343,11,16,.688,4,9,13,1,3,8,2,22,38,1997/1998
"Taylor,Maurice",321,675,.476,0,1,.000,321,674,.476,173,244,.709,118,178,296,53,34,107,40,222,815,1997/1998
"Thomas,Carl",56,140,.400,20,59,.339,36,81,.444,16,25,.640,10,37,47,19,21,18,7,39,148,1997/1998
"Thomas,Carl",25,65,.385,5,21,.238,20,44,.455,7,10,.700,4,6,10,9,5,6,1,12,62,1997/1998
"Thomas,Carl",4,5,.800,0,0,,4,5,.800,1,2,.500,0,0,0,1,0,0,1,0,9,1997/1998
"Thomas,Carl",27,70,.386,15,38,.395,12,32,.375,8,13,.615,6,31,37,9,16,12,5,27,77,1997/1998
"Thomas,John",55,113,.487,0,0,,55,113,.487,41,54,.759,48,58,106,17,22,46,12,97,151,1997/1998
"Thomas,John",41,80,.513,0,0,,41,80,.513,26,33,.788,32,38,70,13,19,33,9,65,108,1997/1998
"Thomas,John",14,33,.424,0,0,,14,33,.424,15,21,.714,16,20,36,4,3,13,3,32,43,1997/1998
"Thomas,Kurt",17,45,.378,0,0,,17,45,.378,3,3,1.000,8,16,24,3,1,10,0,19,37,1997/1998
"Thomas,Tim",306,684,.447,62,171,.363,244,513,.476,171,231,.740,107,181,288,90,54,118,17,185,845,1997/1998
"Thompson,Brooks",23,56,.411,9,30,.300,14,26,.538,4,8,.500,1,14,15,27,10,16,1,22,59,1997/1998
"Thompson,Brooks",10,27,.370,5,16,.313,5,11,.455,1,3,.333,1,4,5,3,4,5,0,6,26,1997/1998
"Thompson,Brooks",13,29,.448,4,14,.286,9,15,.600,3,5,.600,0,10,10,24,6,11,1,16,33,1997/1998
"Thorpe,Otis",294,624,.471,0,5,.000,294,619,.475,164,240,.683,151,386,537,222,48,152,30,238,752,1997/1998
"Thorpe,Otis",205,430,.477,0,4,.000,205,426,.481,118,170,.694,100,271,371,161,30,115,23,158,528,1997/1998
"Thorpe,Otis",89,194,.459,0,1,.000,89,193,.461,46,70,.657,51,115,166,61,18,37,7,80,224,1997/1998
"Trent,Gary",241,505,.477,4,12,.333,237,493,.481,144,212,.679,123,215,338,72,35,94,27,161,630,1997/1998
"Trent,Gary",177,359,.493,4,9,.444,173,350,.494,113,163,.693,80,154,234,58,27,72,19,115,471,1997/1998
"Trent,Gary",64,146,.438,0,3,.000,64,143,.448,31,49,.633,43,61,104,14,8,22,8,46,159,1997/1998
"Van Exel,Nick",311,743,.419,123,316,.389,188,427,.440,136,172,.791,31,163,194,442,64,104,6,120,881,1997/1998
"Van Horn,Keith",446,1047,.426,69,224,.308,377,823,.458,258,305,.846,142,266,408,106,64,164,25,216,1219,1997/1998
"Vaughn,David",66,148,.446,0,1,.000,66,147,.449,30,47,.638,53,99,152,20,15,40,10,83,162,1997/1998
"Vaughn,David",46,114,.404,0,1,.000,46,113,.407,22,34,.647,34,68,102,18,10,31,6,48,114,1997/1998
"Vaughn,David",1,1,1.000,0,0,,1,1,1.000,2,4,.500,0,1,1,0,0,0,0,1,4,1997/1998
"Vaughn,David",19,33,.576,0,0,,19,33,.576,6,9,.667,19,30,49,2,5,9,4,34,44,1997/1998
"Vaughn,Jacque",44,122,.361,3,8,.375,41,114,.360,48,68,.706,4,34,38,84,9,56,1,63,139,1997/1998
"Vaught,Loy",36,84,.429,0,2,.000,36,82,.439,3,8,.375,16,49,65,7,4,13,2,33,75,1997/1998
"Vranković,Stojko",79,186,.425,0,0,,79,186,.425,37,65,.569,71,192,263,36,11,46,66,130,195,1997/1998
"Walker,Antoine",722,1705,.423,91,292,.312,631,1413,.447,305,473,.645,270,566,836,273,142,292,60,262,1840,1997/1998
"Walker,Samaki",156,321,.486,0,1,.000,156,320,.488,53,97,.546,96,206,302,24,30,61,40,127,365,1997/1998
"Wallace,Ben",85,164,.518,0,0,,85,164,.518,35,98,.357,112,212,324,18,61,28,72,116,205,1997/1998
"Wallace,John",468,979,.478,1,2,.500,467,977,.478,210,293,.717,117,256,373,110,62,172,101,239,1147,1997/1998
"Wallace,Rasheed",466,875,.533,8,39,.205,458,836,.548,184,278,.662,132,346,478,195,75,167,88,268,1124,1997/1998
"Walters,Rex",24,53,.453,6,22,.273,18,31,.581,26,28,.929,5,19,24,35,8,27,1,28,80,1997/1998
"Walters,Rex",11,29,.379,3,14,.214,8,15,.533,17,17,1.000,3,6,9,21,5,17,0,17,42,1997/1998
"Walters,Rex",13,24,.542,3,8,.375,10,16,.625,9,11,.818,2,13,15,14,3,10,1,11,38,1997/1998
"Ward,Charlie",235,516,.455,81,215,.377,154,301,.512,91,113,.805,32,242,274,466,144,175,37,195,642,1997/1998
"Washington,Eric",201,498,.404,44,137,.321,157,361,.435,65,83,.783,47,80,127,78,53,72,25,143,511,1997/1998
"Weatherspoon,Clarence",268,608,.441,0,0,,268,608,.441,200,277,.722,198,396,594,89,85,119,74,194,736,1997/1998
"Weatherspoon,Clarence",141,331,.426,0,0,,141,331,.426,123,174,.707,109,227,336,40,43,69,52,108,405,1997/1998
"Weatherspoon,Clarence",127,277,.458,0,0,,127,277,.458,77,103,.748,89,169,258,49,42,50,22,86,331,1997/1998
"Webb,Spud",5,12,.417,0,1,.000,5,11,.455,2,2,1.000,2,1,3,5,1,7,0,6,12,1997/1998
"Webber,Chris",647,1341,.482,65,205,.317,582,1136,.512,196,333,.589,176,498,674,273,111,185,124,269,1555,1997/1998
"Wells,Bubba",48,116,.414,1,6,.167,47,110,.427,31,43,.721,22,46,68,34,15,31,4,40,128,1997/1998
"Wennington,Bill",75,172,.436,0,0,,75,172,.436,17,21,.810,32,48,80,19,4,16,5,77,167,1997/1998
"Wesley,David",383,864,.443,59,170,.347,324,694,.467,229,288,.795,49,164,213,529,140,226,30,229,1054,1997/1998
"West,Doug",64,171,.374,0,2,.000,64,169,.379,29,40,.725,23,59,82,45,11,21,5,97,157,1997/1998
"West,Mark",10,21,.476,0,0,,10,21,.476,3,6,.500,6,9,15,2,2,8,4,15,23,1997/1998
"Wheat,DeJuan",20,50,.400,8,17,.471,12,33,.364,9,15,.600,3,8,11,25,6,9,1,12,57,1997/1998
"Whiteside,Donald",1,2,.500,0,1,.000,1,1,1.000,0,2,.000,0,1,1,1,0,1,0,0,2,1997/1998
"Whitney,Chris",126,355,.355,52,169,.308,74,186,.398,118,129,.915,16,99,115,196,34,65,6,106,422,1997/1998
"Wilkins,Gerald",141,434,.325,29,109,.266,112,325,.345,69,98,.704,16,74,90,78,34,79,6,78,380,1997/1998
"Williams,Aaron",115,220,.523,0,1,.000,115,219,.525,66,85,.776,48,99,147,14,19,50,38,119,296,1997/1998
"Williams,Alvin",125,282,.443,9,28,.321,116,254,.457,65,90,.722,24,57,81,103,38,58,3,79,324,1997/1998
"Williams,Alvin",109,238,.458,7,24,.292,102,214,.477,58,79,.734,19,41,60,83,30,50,2,60,283,1997/1998
"Williams,Alvin",16,44,.364,2,4,.500,14,40,.350,7,11,.636,5,16,21,20,8,8,1,19,41,1997/1998
"Williams,Brandon",16,50,.320,3,9,.333,13,41,.317,2,4,.500,4,11,15,3,6,9,3,18,37,1997/1998
"Williams,Buck",75,149,.503,0,0,,75,149,.503,52,71,.732,78,105,183,21,17,38,15,93,202,1997/1998
"Williams,Eric",24,61,.393,0,0,,24,61,.393,31,45,.689,10,11,21,12,4,9,0,9,79,1997/1998
"Williams,Herb",18,43,.419,0,0,,18,43,.419,1,8,.125,6,23,29,4,6,5,9,34,37,1997/1998
"Williams,Hot Rod",95,202,.470,0,0,,95,202,.470,65,93,.699,107,205,312,49,33,29,60,138,255,1997/1998
"Williams,Jayson",321,645,.498,0,4,.000,321,641,.501,195,293,.666,443,440,883,67,45,95,49,236,837,1997/1998
"Williams,Jerome",151,288,.524,0,1,.000,151,287,.526,108,166,.651,170,209,379,48,51,60,10,144,410,1997/1998
"Williams,Lorenzo",13,17,.765,0,0,,13,17,.765,0,2,.000,16,10,26,3,2,2,3,17,26,1997/1998
"Williams,Micheal",16,48,.333,0,4,.000,16,44,.364,32,33,.970,2,12,14,32,9,16,2,24,64,1997/1998
"Williams,Monty",165,368,.448,1,2,.500,164,366,.448,122,182,.670,67,112,179,89,34,82,24,133,453,1997/1998
"Williams,Scott",93,213,.437,0,5,.000,93,208,.447,51,63,.810,87,124,211,29,17,30,21,132,237,1997/1998
"Williams,Travis",56,119,.471,0,1,.000,56,118,.475,24,46,.522,53,39,92,20,18,30,5,55,136,1997/1998
"Williams,Walt",210,544,.386,80,219,.365,130,325,.400,108,125,.864,50,150,200,122,59,92,35,161,608,1997/1998
"Williams,Walt",125,319,.392,49,129,.380,76,190,.400,49,60,.817,27,91,118,69,40,52,23,100,348,1997/1998
"Williams,Walt",85,225,.378,31,90,.344,54,135,.400,59,65,.908,23,59,82,53,19,40,12,61,260,1997/1998
"Williamson,Corliss",561,1134,.495,0,9,.000,561,1125,.499,279,443,.630,162,284,446,230,76,199,48,252,1401,1997/1998
"Willis,Kevin",531,1041,.510,1,7,.143,530,1034,.513,242,305,.793,232,447,679,78,55,170,38,235,1305,1997/1998
"Wingate,David",66,140,.471,3,7,.429,63,133,.474,15,29,.517,19,60,79,37,21,37,3,58,150,1997/1998
"Wingfield,Dontonio",0,3,.000,0,0,,0,3,.000,1,2,.500,2,2,4,0,0,1,0,2,1,1997/1998
"Wolf,Joe",40,121,.331,2,10,.200,38,111,.342,5,10,.500,36,90,126,30,20,22,7,92,87,1997/1998
"Wright,Lorenzen",241,542,.445,0,2,.000,241,540,.446,141,214,.659,180,426,606,55,55,81,87,237,623,1997/1998
"Wright,Sharone",7,14,.500,0,0,,7,14,.500,2,4,.500,1,8,9,4,0,2,0,7,16,1997/1998
"Zídek,George",7,29,.241,1,2,.500,6,27,.222,14,16,.875,4,13,17,2,0,4,2,10,29,1997/1998
"Zídek,George",4,15,.267,0,0,,4,15,.267,10,12,.833,4,9,13,1,0,3,2,5,18,1997/1998
"Zídek,George",3,14,.214,1,2,.500,2,12,.167,4,4,1.000,0,4,4,1,0,1,0,5,11,1997/1998
"Abdul-Wahad,Tariq",177,407,.435,6,21,.286,171,386,.443,94,136,.691,72,114,186,50,50,70,16,121,454,1998/1999
"Abdur-Rahim,Shareef",386,893,.432,11,36,.306,375,857,.438,369,439,.841,114,260,374,172,69,186,55,137,1152,1998/1999
"Alexander,Cory",97,260,.373,30,105,.286,67,155,.432,37,44,.841,7,67,74,119,35,69,5,77,261,1998/1999
"Allen,Ray",303,673,.450,74,208,.356,229,465,.492,176,195,.903,57,155,212,178,53,122,7,117,856,1998/1999
"Aluma,Peter",1,2,.500,0,0,,1,2,.500,0,0,,1,1,2,0,1,2,1,4,2,1998/1999
"Anderson,Derek",125,314,.398,21,69,.304,104,245,.424,138,165,.836,20,89,109,145,48,82,4,73,409,1998/1999
"Anderson,Kenny",161,357,.451,6,24,.250,155,333,.465,84,101,.832,24,79,103,193,33,71,2,78,412,1998/1999
"Anderson,Nick",253,640,.395,96,277,.347,157,363,.433,99,162,.611,51,226,277,91,64,83,15,72,701,1998/1999
"Anderson,Shandon",162,363,.446,14,41,.341,148,322,.460,89,125,.712,49,83,132,56,39,66,10,89,427,1998/1999
"Anstey,Chris",50,139,.360,0,7,.000,50,132,.379,34,48,.708,35,62,97,27,18,26,13,98,134,1998/1999
"Anthony,Greg",104,251,.414,49,125,.392,55,126,.437,62,89,.697,14,49,63,100,66,55,3,75,319,1998/1999
"Armstrong,B.J.",40,88,.455,7,15,.467,33,73,.452,18,21,.857,2,37,39,61,12,25,0,31,105,1998/1999
"Armstrong,B.J.",21,43,.488,6,8,.750,15,35,.429,9,10,.900,1,15,16,27,3,10,0,16,57,1998/1999
"Armstrong,B.J.",19,45,.422,1,7,.143,18,38,.474,9,11,.818,1,22,23,34,9,15,0,15,48,1998/1999
"Armstrong,Darrell",230,522,.441,69,189,.365,161,333,.483,161,178,.904,53,127,180,335,108,158,4,90,690,1998/1999
"Askins,Keith",20,62,.323,8,29,.276,12,33,.364,5,8,.625,10,34,44,10,17,13,3,58,53,1998/1999
"Augmon,Stacey",78,174,.448,0,2,.000,78,172,.453,52,76,.684,47,78,125,58,57,30,18,81,208,1998/1999
"Austin,Isaac",185,453,.408,2,7,.286,183,446,.410,105,157,.669,83,154,237,89,47,114,35,125,477,1998/1999
"Avent,Anthony",4,13,.308,0,0,,4,13,.308,1,2,.500,8,4,12,1,2,7,0,6,9,1998/1999
"Bailey,Thurl",78,175,.446,0,2,.000,78,173,.451,25,34,.735,36,58,94,26,9,27,28,78,181,1998/1999
"Bailey,Toby",34,86,.395,1,5,.200,33,81,.407,9,13,.692,24,30,54,13,9,11,2,24,78,1998/1999
"Baker,LaMark",0,1,.000,0,0,,0,1,.000,0,0,,0,0,0,0,0,1,0,0,0,1998/1999
"Baker,Vin",198,437,.453,0,3,.000,198,434,.456,72,160,.450,86,125,211,56,32,76,34,121,468,1998/1999
"Barkley,Charles",240,502,.478,4,25,.160,236,477,.495,192,267,.719,167,349,516,192,43,100,13,89,676,1998/1999
"Barros,Dana",168,371,.453,64,160,.400,104,211,.493,64,73,.877,16,89,105,208,52,88,5,64,464,1998/1999
"Barry,Brent",141,356,.396,52,172,.302,89,184,.484,78,101,.772,39,105,144,116,42,72,11,98,412,1998/1999
"Barry,Drew",10,32,.313,8,24,.333,2,8,.250,9,13,.692,3,17,20,29,7,12,1,24,37,1998/1999
"Barry,Jon",59,138,.428,24,79,.304,35,59,.593,71,84,.845,25,71,96,112,53,47,5,61,213,1998/1999
"Battie,Tony",147,283,.519,0,3,.000,147,280,.525,41,61,.672,96,204,300,53,29,45,71,159,335,1998/1999
"Beck,Corey",18,39,.462,1,1,1.000,17,38,.447,8,15,.533,6,22,28,20,9,13,2,26,45,1998/1999
"Beck,Corey",4,8,.500,0,0,,4,8,.500,2,2,1.000,3,2,5,0,2,2,0,5,10,1998/1999
"Beck,Corey",14,31,.452,1,1,1.000,13,30,.433,6,13,.462,3,20,23,20,7,11,2,21,35,1998/1999
"Benjamin,Benoit",2,7,.286,0,0,,2,7,.286,0,0,,3,5,8,1,0,3,0,6,4,1998/1999
"Benjamin,Corey",44,117,.376,3,14,.214,41,103,.398,27,40,.675,15,25,40,10,11,21,8,46,118,1998/1999
"Bennett,Mario",2,6,.333,0,0,,2,6,.333,3,4,.750,2,3,5,0,1,1,0,4,7,1998/1999
"Best,Travis",127,305,.416,22,59,.373,105,246,.427,70,83,.843,19,61,80,169,42,62,4,111,346,1998/1999
"Bibby,Mike",260,605,.430,15,74,.203,245,531,.461,127,169,.751,30,106,136,325,78,146,5,122,662,1998/1999
"Billups,Chauncey",191,495,.386,85,235,.362,106,260,.408,157,172,.913,24,72,96,173,58,98,14,115,624,1998/1999
"Blaylock,Mookie",247,651,.379,77,251,.307,170,400,.425,69,91,.758,45,179,224,278,99,115,9,61,640,1998/1999
"Blount,Corie",36,100,.360,0,1,.000,36,99,.364,28,54,.519,58,93,151,12,19,21,16,74,100,1998/1999
"Blount,Corie",13,33,.394,0,1,.000,13,32,.406,6,12,.500,24,22,46,2,1,6,4,27,32,1998/1999
"Blount,Corie",23,67,.343,0,0,,23,67,.343,22,42,.524,34,71,105,10,18,15,12,47,68,1998/1999
"Bogues,Muggsy",76,154,.494,0,6,.000,76,148,.514,31,36,.861,16,57,73,134,43,47,1,44,183,1998/1999
"Bohannon,Etdrick",0,0,,0,0,,0,0,,0,0,,0,0,0,0,0,0,0,0,0,1998/1999
"Booth,Keith",49,151,.325,1,10,.100,48,141,.340,21,42,.500,25,68,93,38,22,39,11,60,120,1998/1999
"Bowen,Bruce",26,93,.280,7,26,.269,19,67,.284,11,24,.458,15,37,52,28,21,13,9,51,70,1998/1999
"Boykins,Earl",30,79,.380,3,18,.167,27,61,.443,2,3,.667,7,10,17,33,6,20,0,20,65,1998/1999
"Boykins,Earl",10,21,.476,1,5,.200,9,16,.563,0,0,,1,3,4,6,1,7,0,3,21,1998/1999
"Boykins,Earl",20,58,.345,2,13,.154,18,45,.400,2,3,.667,6,7,13,27,5,13,0,17,44,1998/1999
"Bradley,Shawn",167,348,.480,0,4,.000,167,344,.485,86,115,.748,130,262,392,40,35,56,159,153,420,1998/1999
"Brandon,Terrell",212,507,.418,12,47,.255,200,460,.435,65,78,.833,27,107,134,309,63,74,10,82,501,1998/1999
"Brandon,Terrell",85,208,.409,7,28,.250,78,180,.433,26,31,.839,11,42,53,104,24,36,3,25,203,1998/1999
"Brandon,Terrell",127,299,.425,5,19,.263,122,280,.436,39,47,.830,16,65,81,205,39,38,7,57,298,1998/1999
"Brown,Chucky",176,373,.472,15,40,.375,161,333,.483,40,59,.678,36,138,174,57,16,38,19,106,407,1998/1999
"Brown,Dee",187,495,.378,135,349,.387,52,146,.356,40,55,.727,15,88,103,143,56,80,8,75,549,1998/1999
"Brown,Gerald",33,89,.371,3,10,.300,30,79,.380,11,14,.786,5,17,22,31,5,22,1,21,80,1998/1999
"Brown,P.J.",229,477,.480,0,0,,229,477,.480,113,146,.774,115,231,346,66,46,69,48,166,571,1998/1999
"Brown,Randy",132,319,.414,0,10,.000,132,309,.427,78,103,.757,27,105,132,149,68,80,8,93,342,1998/1999
"Brunson,Rick",6,21,.286,0,5,.000,6,16,.375,5,18,.278,3,7,10,19,9,12,0,8,17,1998/1999
"Bryant,Kobe",362,779,.465,27,101,.267,335,678,.494,245,292,.839,53,211,264,190,72,157,50,153,996,1998/1999
"Bryant,Mark",168,348,.483,0,1,.000,168,347,.484,71,110,.645,92,140,232,48,34,68,16,149,407,1998/1999
"Buechler,Jud",100,240,.417,61,148,.412,39,92,.424,13,18,.722,29,104,133,57,37,21,13,83,274,1998/1999
"Bullard,Matt",43,114,.377,24,62,.387,19,52,.365,7,10,.700,9,33,42,18,13,14,4,28,117,1998/1999
"Burrell,Scott",75,208,.361,28,72,.389,47,136,.346,34,42,.810,32,87,119,45,40,23,11,82,212,1998/1999
"Burton,Willie",1,7,.143,0,1,.000,1,6,.167,2,4,.500,4,2,6,0,0,1,0,2,4,1998/1999
"Butler,Mitchell",67,139,.482,11,29,.379,56,110,.509,23,32,.719,13,31,44,22,15,29,4,41,168,1998/1999
"Caffey,Jason",123,277,.444,0,1,.000,123,276,.446,62,98,.633,79,126,205,18,24,75,9,113,308,1998/1999
"Camby,Marcus",136,261,.521,0,0,,136,261,.521,57,103,.553,102,151,253,12,29,39,74,131,329,1998/1999
"Campbell,Elden",222,465,.477,0,1,.000,222,464,.478,172,269,.639,126,271,397,69,39,80,73,159,616,1998/1999
"Campbell,Elden",44,101,.436,0,0,,44,101,.436,38,62,.613,38,58,96,8,1,22,16,51,126,1998/1999
"Campbell,Elden",178,364,.489,0,1,.000,178,363,.490,134,207,.647,88,213,301,61,38,58,57,108,490,1998/1999
"Carr,Antoine",21,52,.404,0,1,.000,21,51,.412,5,7,.714,9,22,31,9,1,9,10,31,47,1998/1999
"Carr,Chris",76,205,.371,28,75,.373,48,130,.369,27,40,.675,23,48,71,23,8,28,2,45,207,1998/1999
"Carr,Chris",9,26,.346,3,9,.333,6,17,.353,2,4,.500,0,12,12,7,1,4,1,9,23,1998/1999
"Carr,Chris",67,179,.374,25,66,.379,42,113,.372,25,36,.694,23,36,59,16,7,24,1,36,184,1998/1999
"Carr,Cory",71,216,.329,5,30,.167,66,186,.355,24,32,.750,8,41,49,66,21,46,7,66,171,1998/1999
"Carter,Vince",345,766,.450,19,66,.288,326,700,.466,204,268,.761,94,189,283,149,55,110,77,140,913,1998/1999
"Cassell,Sam",39,93,.419,2,10,.200,37,83,.446,47,50,.940,5,10,15,36,9,20,0,22,127,1998/1999
"Cassell,Sam",21,49,.429,1,7,.143,20,42,.476,29,31,.935,1,5,6,19,3,12,0,13,72,1998/1999
"Cassell,Sam",18,44,.409,1,3,.333,17,41,.415,18,19,.947,4,5,9,17,6,8,0,9,55,1998/1999
"Cato,Kelvin",58,129,.450,1,1,1.000,57,128,.445,34,67,.507,49,101,150,19,23,27,56,100,151,1998/1999
"Causwell,Duane",20,35,.571,0,0,,20,35,.571,4,12,.333,14,21,35,2,0,18,11,32,44,1998/1999
"Ceballos,Cedric",59,140,.421,11,28,.393,48,112,.429,34,49,.694,23,62,85,12,7,28,5,23,163,1998/1999
"Chapman,Rex",165,459,.359,53,151,.351,112,308,.364,76,91,.835,12,92,104,109,34,54,9,46,459,1998/1999
"Cheaney,Calbert",172,415,.414,8,37,.216,164,378,.434,33,67,.493,33,108,141,73,39,42,16,146,385,1998/1999
"Chilcutt,Pete",63,172,.366,26,68,.382,37,104,.356,14,17,.824,29,88,117,30,22,28,12,52,166,1998/1999
"Childs,Chris",114,267,.427,36,94,.383,78,173,.451,64,78,.821,18,115,133,193,44,85,1,156,328,1998/1999
"Christie,Doug",252,650,.388,49,161,.304,203,489,.415,207,246,.841,59,148,207,187,113,119,26,111,760,1998/1999
"Clark,Keon",36,80,.450,0,1,.000,36,79,.456,21,37,.568,36,60,96,10,10,21,31,52,93,1998/1999
"Closs,Keith",12,23,.522,0,1,.000,12,22,.545,8,10,.800,5,20,25,0,3,6,9,14,32,1998/1999
"Coker,John",13,31,.419,0,0,,13,31,.419,5,6,.833,7,15,22,0,1,2,2,17,31,1998/1999
"Coleman,Derrick",168,406,.414,7,33,.212,161,373,.432,143,190,.753,76,252,328,78,24,90,42,96,486,1998/1999
"Coles,Bimbo",183,414,.442,6,25,.240,177,389,.455,83,101,.822,21,96,117,222,45,82,11,113,455,1998/1999
"Conlon,Marty",3,13,.231,0,0,,3,13,.231,2,2,1.000,1,4,5,1,0,3,1,6,8,1998/1999
"Corbin,Tyrone",131,335,.391,38,119,.319,93,216,.431,52,80,.650,37,108,145,43,31,43,7,74,352,1998/1999
"Cotton,James",6,18,.333,0,3,.000,6,15,.400,13,18,.722,2,8,10,0,3,3,0,6,25,1998/1999
"Crawford,Chris",110,255,.431,11,33,.333,99,222,.446,57,70,.814,37,53,90,24,10,48,13,106,288,1998/1999
"Croshere,Austin",32,75,.427,8,29,.276,24,46,.522,20,23,.870,16,29,45,10,7,23,8,32,92,1998/1999
"Crotty,John",51,124,.411,14,36,.389,37,88,.420,43,50,.860,8,23,31,63,11,33,0,31,159,1998/1999
"Crotty,John",4,8,.500,1,1,1.000,3,7,.429,3,3,1.000,0,1,1,5,2,0,0,1,12,1998/1999
"Crotty,John",47,116,.405,13,35,.371,34,81,.420,40,47,.851,8,22,30,58,9,33,0,30,147,1998/1999
"Cummings,Terry",186,424,.439,1,1,1.000,185,423,.437,81,114,.711,95,160,255,58,46,58,10,168,454,1998/1999
"Cunningham,William",3,18,.167,0,0,,3,18,.167,0,2,.000,13,15,28,1,1,5,11,30,6,1998/1999
"Cunningham,William",0,0,,0,0,,0,0,,0,0,,0,0,0,0,0,0,0,0,0,1998/1999
"Cunningham,William",3,18,.167,0,0,,3,18,.167,0,2,.000,13,15,28,1,1,5,11,30,6,1998/1999
"Curley,Bill",29,72,.403,1,5,.200,28,67,.418,19,22,.864,20,31,51,14,17,10,9,83,78,1998/1999
"Curry,Dell",163,336,.485,69,145,.476,94,191,.492,28,34,.824,18,67,85,48,36,45,3,42,423,1998/1999
"Curry,Michael",90,206,.437,1,15,.067,89,191,.466,63,79,.797,19,89,108,78,42,37,7,135,244,1998/1999
"Dampier,Erick",161,414,.389,0,0,,161,414,.389,120,204,.588,164,218,382,54,26,92,58,165,442,1998/1999
"Daniels,Antonio",83,183,.454,5,17,.294,78,166,.470,49,65,.754,13,41,54,106,30,44,6,39,220,1998/1999
"Dávid,Kornél",109,243,.449,0,1,.000,109,242,.450,90,111,.811,70,103,173,40,23,48,17,88,308,1998/1999
"Davis,Antonio",164,348,.471,0,0,,164,348,.471,135,192,.703,116,228,344,33,22,50,42,136,463,1998/1999
"Davis,Ben",7,17,.412,0,0,,7,17,.412,3,6,.500,9,2,11,3,0,1,0,4,17,1998/1999
"Davis,Dale",161,302,.533,0,0,,161,302,.533,76,123,.618,155,261,416,22,20,43,57,115,398,1998/1999
"Davis,Hubert",174,397,.438,65,144,.451,109,253,.431,44,50,.880,3,83,86,89,21,57,3,76,457,1998/1999
"Davis,Mark",2,6,.333,0,0,,2,6,.333,5,6,.833,2,5,7,1,1,7,0,12,9,1998/1999
"Davis,Ricky",81,200,.405,2,12,.167,79,188,.420,45,59,.763,40,44,84,58,30,54,7,46,209,1998/1999
"Davis,Terry",49,92,.533,0,0,,49,92,.533,28,38,.737,50,89,139,10,11,16,3,79,126,1998/1999
"DeClercq,Andrew",138,276,.500,0,0,,138,276,.500,95,141,.674,104,151,255,31,50,54,29,161,371,1998/1999
"DeClercq,Andrew",28,57,.491,0,0,,28,57,.491,19,29,.655,33,30,63,10,13,22,9,51,75,1998/1999
"DeClercq,Andrew",110,219,.502,0,0,,110,219,.502,76,112,.679,71,121,192,21,37,32,20,110,296,1998/1999
"Dehere,Terry",31,85,.365,16,39,.410,15,46,.326,5,7,.714,7,17,24,27,7,16,3,30,83,1998/1999
"Dehere,Terry",4,11,.364,1,5,.200,3,6,.500,0,0,,2,0,2,1,2,2,0,2,9,1998/1999
"Dehere,Terry",27,74,.365,15,34,.441,12,40,.300,5,7,.714,5,17,22,26,5,14,3,28,74,1998/1999
"Del Negro,Vinny",114,270,.422,13,30,.433,101,240,.421,40,50,.800,14,88,102,174,33,55,3,62,281,1998/1999
"Dele,Bison",216,431,.501,0,1,.000,216,430,.502,81,118,.686,92,180,272,71,38,111,40,181,513,1998/1999
"Delk,Tony",92,253,.364,16,66,.242,76,187,.406,46,71,.648,11,43,54,95,16,45,6,47,246,1998/1999
"Dickerson,Michael",215,462,.465,71,164,.433,144,298,.483,46,72,.639,26,57,83,95,27,66,11,90,547,1998/1999
"Divac,Vlade",262,557,.470,11,43,.256,251,514,.488,179,255,.702,140,361,501,215,44,131,51,166,714,1998/1999
"Doleac,Michael",125,267,.468,0,0,,125,267,.468,54,80,.675,66,82,148,20,19,26,17,117,304,1998/1999
"Douglas,Sherman",96,219,.438,0,11,.000,96,208,.462,55,87,.632,16,42,58,124,27,61,3,54,247,1998/1999
"Drew,Bryce",47,129,.364,16,49,.327,31,80,.388,8,8,1.000,3,29,32,52,12,31,4,61,118,1998/1999
"Dudley,Chris",48,109,.440,0,0,,48,109,.440,19,40,.475,79,114,193,7,13,24,38,116,115,1998/1999
"Dumars,Joe",144,350,.411,89,221,.403,55,129,.426,51,61,.836,12,56,68,134,23,53,2,51,428,1998/1999
"Duncan,Tim",418,845,.495,1,7,.143,417,838,.498,247,358,.690,159,412,571,121,45,146,126,147,1084,1998/1999
"Edwards,Blue",32,72,.444,4,10,.400,28,62,.452,9,13,.692,7,26,33,30,17,21,5,23,77,1998/1999
"Eisley,Howard",140,314,.446,21,50,.420,119,264,.451,67,80,.838,12,82,94,185,30,109,2,122,368,1998/1999
"Elie,Mario",156,331,.471,40,107,.374,116,224,.518,103,119,.866,36,101,137,89,46,61,12,91,455,1998/1999
"Elliott,Sean",208,507,.410,39,119,.328,169,388,.436,106,140,.757,35,178,213,117,26,71,17,104,561,1998/1999
"Ellis,Dale",174,395,.441,94,217,.433,80,178,.449,53,70,.757,25,90,115,38,25,45,3,77,495,1998/1999
"Ellis,LaPhonso",80,190,.421,1,5,.200,79,185,.427,43,61,.705,25,84,109,18,8,34,7,48,204,1998/1999
"Evans,Brian",13,44,.295,4,13,.308,9,31,.290,4,4,1.000,6,13,19,15,5,2,3,8,34,1998/1999
"Evans,Brian",11,34,.324,4,11,.364,7,23,.304,4,4,1.000,4,13,17,14,3,2,3,7,30,1998/1999
"Evans,Brian",2,10,.200,0,2,.000,2,8,.250,0,0,,2,0,2,1,2,0,0,1,4,1998/1999
"Ewing,Patrick",247,568,.435,0,2,.000,247,566,.436,163,231,.706,74,303,377,43,30,99,100,105,657,1998/1999
"Feick,Jamie",67,134,.500,0,0,,67,134,.500,43,60,.717,112,176,288,24,25,34,18,73,177,1998/1999
"Feick,Jamie",0,1,.000,0,0,,0,1,.000,0,0,,0,2,2,0,0,0,0,0,0,1998/1999
"Feick,Jamie",67,133,.504,0,0,,67,133,.504,43,60,.717,112,174,286,24,25,34,18,73,177,1998/1999
"Ferrell,Duane",1,14,.071,0,0,,1,14,.071,3,4,.750,5,1,6,0,1,1,1,4,5,1998/1999
"Ferry,Danny",141,296,.476,38,97,.392,103,199,.518,29,33,.879,16,86,102,53,23,39,10,113,349,1998/1999
"Finley,Michael",389,876,.444,45,136,.331,344,740,.465,186,226,.823,69,194,263,218,66,107,15,96,1009,1998/1999
"Fisher,Derek",99,263,.376,38,97,.392,61,166,.367,60,79,.759,21,70,91,197,61,77,1,95,296,1998/1999
"Fortson,Danny",191,386,.495,0,3,.000,191,383,.499,168,231,.727,210,371,581,32,31,77,22,212,550,1998/1999
"Foster,Greg",52,138,.377,1,4,.250,51,134,.381,13,21,.619,28,55,83,25,6,24,8,63,118,1998/1999
"Fox,Rick",148,330,.448,32,95,.337,116,235,.494,66,89,.742,26,63,89,89,28,56,10,114,394,1998/1999
"Foyle,Adonal",52,121,.430,0,0,,52,121,.430,25,51,.490,79,115,194,18,15,31,43,90,129,1998/1999
"Fuller,Todd",56,124,.452,0,0,,56,124,.452,30,50,.600,28,73,101,6,6,27,14,60,142,1998/1999
"Funderburke,Lawrence",167,299,.559,1,5,.200,166,294,.565,85,120,.708,101,121,222,30,22,52,23,77,420,1998/1999
"Garnett,Kevin",414,900,.460,4,14,.286,410,886,.463,145,206,.704,166,323,489,202,78,135,83,152,977,1998/1999
"Garnett,Marlon",15,51,.294,6,23,.261,9,28,.321,15,20,.750,3,18,21,18,5,12,1,18,51,1998/1999
"Garrett,Dean",116,231,.502,0,0,,116,231,.502,38,51,.745,99,158,257,28,30,29,45,113,270,1998/1999
"Garrity,Pat",85,170,.500,7,18,.389,78,152,.513,40,56,.714,26,49,75,18,8,20,3,62,217,1998/1999
"Gatling,Chris",117,265,.442,1,8,.125,116,257,.451,37,93,.398,52,127,179,32,32,62,10,118,272,1998/1999
"Gatling,Chris",36,97,.371,0,1,.000,36,96,.375,12,24,.500,21,44,65,12,8,29,4,40,84,1998/1999
"Gatling,Chris",81,168,.482,1,7,.143,80,161,.497,25,69,.362,31,83,114,20,24,33,6,78,188,1998/1999
"Gaze,Andrew",8,25,.320,5,16,.313,3,9,.333,0,0,,2,3,5,6,2,4,1,7,21,1998/1999
"Geiger,Matt",266,555,.479,1,5,.200,265,550,.482,141,177,.797,137,225,362,58,39,101,40,157,674,1998/1999
"Gill,Kendall",236,593,.398,2,17,.118,234,576,.406,114,167,.683,61,183,244,123,134,71,26,162,588,1998/1999
"Gilliam,Armen",101,223,.453,0,1,.000,101,222,.455,79,101,.782,33,93,126,19,22,36,12,48,281,1998/1999
"Grant,Brian",183,382,.479,0,0,,183,382,.479,184,226,.814,173,297,470,67,21,96,34,136,550,1998/1999
"Grant,Gary",0,1,.000,0,0,,0,1,.000,0,0,,0,0,0,3,1,0,0,0,0,1998/1999
"Grant,Harvey",62,168,.369,1,6,.167,61,162,.377,21,29,.724,36,74,110,23,20,21,16,73,146,1998/1999
"Grant,Horace",198,456,.434,0,2,.000,198,454,.436,47,70,.671,117,234,351,90,46,44,60,99,443,1998/1999
"Grant,Paul",2,6,.333,0,0,,2,6,.333,0,0,,1,0,1,0,1,2,0,4,4,1998/1999
"Grant,Paul",1,4,.250,0,0,,1,4,.250,0,0,,1,0,1,0,0,1,0,4,2,1998/1999
"Grant,Paul",1,2,.500,0,0,,1,2,.500,0,0,,0,0,0,0,1,1,0,0,2,1998/1999
"Gray,Ed",53,182,.291,12,42,.286,41,140,.293,28,37,.757,7,21,28,12,12,29,1,30,146,1998/1999
"Green,A.C.",108,256,.422,0,8,.000,108,248,.435,30,52,.577,82,146,228,25,28,19,8,69,246,1998/1999
"Green,Litterial",0,1,.000,0,0,,0,1,.000,0,0,,0,0,0,0,0,0,0,0,0,1998/1999
"Gugliotta,Tom",277,573,.483,2,7,.286,275,566,.486,173,218,.794,131,250,381,121,59,88,21,110,729,1998/1999
"Hammonds,Tom",82,179,.458,0,0,,82,179,.458,48,75,.640,54,82,136,20,8,32,7,88,212,1998/1999
"Hardaway,Anfernee",301,717,.420,40,140,.286,261,577,.452,149,211,.706,74,210,284,266,111,150,23,111,791,1998/1999
"Hardaway,Tim",301,752,.400,112,311,.360,189,441,.429,121,149,.812,15,137,152,352,57,131,6,102,835,1998/1999
"Harper,Derek",120,291,.412,43,117,.368,77,174,.443,26,32,.813,13,54,67,187,44,52,4,66,309,1998/1999
"Harper,Ron",147,390,.377,27,85,.318,120,305,.393,71,101,.703,49,131,180,115,60,65,35,80,392,1998/1999
"Harpring,Matt",148,320,.463,10,25,.400,138,295,.468,102,143,.713,88,126,214,45,30,73,6,112,408,1998/1999
"Harrington,Al",18,56,.321,0,5,.000,18,51,.353,9,15,.600,20,19,39,5,4,11,2,26,45,1998/1999
"Harrington,Othella",156,304,.513,0,0,,156,304,.513,88,122,.721,72,174,246,15,6,61,25,103,400,1998/1999
"Harris,Lucious",73,181,.403,11,50,.220,62,131,.473,36,48,.750,21,46,67,31,18,18,7,52,193,1998/1999
"Hawkins,Hersey",171,408,.419,55,180,.306,116,228,.509,119,132,.902,51,150,201,123,80,80,18,90,516,1998/1999
"Hawkins,Michael",14,40,.350,5,19,.263,9,21,.429,3,3,1.000,10,15,25,27,3,13,1,14,36,1998/1999
"Henderson,Alan",187,423,.442,0,1,.000,187,422,.443,100,149,.671,100,150,250,28,33,58,19,96,474,1998/1999
"Henderson,Cedric",189,453,.417,2,12,.167,187,441,.424,74,91,.813,45,152,197,113,58,97,24,136,454,1998/1999
"Henderson,J.R.",35,96,.365,2,5,.400,33,91,.363,25,45,.556,20,27,47,22,9,18,4,29,97,1998/1999
"Hendrickson,Mark",39,88,.443,0,1,.000,39,87,.448,42,50,.840,27,41,68,13,12,15,1,39,120,1998/1999
"Henson,Steve",1,2,.500,0,0,,1,2,.500,2,2,1.000,0,0,0,3,1,3,0,1,4,1998/1999
"Herrera,Carl",30,76,.395,0,1,.000,30,75,.400,5,11,.455,25,37,62,4,12,16,7,41,65,1998/1999
"Herrera,Carl",3,13,.231,0,0,,3,13,.231,0,2,.000,5,3,8,3,0,4,0,3,6,1998/1999
"Herrera,Carl",27,63,.429,0,1,.000,27,62,.435,5,9,.556,20,34,54,1,12,12,7,38,59,1998/1999
"Hill,Grant",384,802,.479,0,14,.000,384,788,.487,285,379,.752,65,290,355,300,80,184,27,114,1053,1998/1999
"Hill,Tyrone",122,268,.455,0,0,,122,268,.455,81,150,.540,115,172,287,35,34,59,16,145,325,1998/1999
"Hill,Tyrone",50,118,.424,0,0,,50,118,.424,46,81,.568,51,83,134,17,18,24,8,68,146,1998/1999
"Hill,Tyrone",72,150,.480,0,0,,72,150,.480,35,69,.507,64,89,153,18,16,35,8,77,179,1998/1999
"Hoiberg,Fred",6,21,.286,1,9,.111,5,12,.417,6,6,1.000,2,9,11,4,0,3,0,11,19,1998/1999
"Honeycutt,Jerald",9,32,.281,5,17,.294,4,15,.267,7,10,.700,3,9,12,3,5,9,2,16,30,1998/1999
"Honeycutt,Jerald",2,5,.400,0,3,.000,2,2,1.000,1,2,.500,0,1,1,0,1,1,0,6,5,1998/1999
"Honeycutt,Jerald",7,27,.259,5,14,.357,2,13,.154,6,8,.750,3,8,11,3,4,8,2,10,25,1998/1999
"Hornacek,Jeff",214,449,.477,34,81,.420,180,368,.489,125,140,.893,33,127,160,192,52,82,14,95,587,1998/1999
"Horry,Robert",67,146,.459,20,45,.444,47,101,.465,34,46,.739,56,96,152,56,36,49,39,103,188,1998/1999
"Houston,Allan",294,703,.418,57,140,.407,237,563,.421,168,195,.862,20,132,152,137,35,130,9,115,813,1998/1999
"Howard,Juwan",286,604,.474,0,3,.000,286,601,.476,110,146,.753,90,203,293,107,42,95,14,130,682,1998/1999
"Hudson,Troy",60,150,.400,15,47,.319,45,103,.437,34,38,.895,15,40,55,92,11,38,2,28,169,1998/1999
"Hughes,Larry",170,414,.411,8,52,.154,162,362,.448,107,151,.709,83,106,189,77,44,68,14,97,455,1998/1999
"Hunter,Lindsey",228,524,.435,59,153,.386,169,371,.456,67,89,.753,26,142,168,193,86,92,8,126,582,1998/1999
"Ilgauskas,Zydrunas",29,57,.509,0,0,,29,57,.509,18,30,.600,17,27,44,4,4,9,7,24,76,1998/1999
"Iverson,Allen",435,1056,.412,58,199,.291,377,857,.440,356,474,.751,66,170,236,223,110,167,7,98,1284,1998/1999
"Jackson,Bobby",141,348,.405,10,27,.370,131,321,.408,61,79,.772,43,92,135,167,39,75,3,75,353,1998/1999
"Jackson,Jaren",108,284,.380,53,147,.361,55,137,.401,32,39,.821,21,78,99,49,41,37,9,63,301,1998/1999
"Jackson,Jim",152,370,.411,25,90,.278,127,280,.454,85,101,.842,36,123,159,128,43,82,6,80,414,1998/1999
"Jackson,Mark",138,329,.419,32,103,.311,106,226,.469,65,79,.823,33,151,184,386,42,99,3,58,373,1998/1999
"Jackson,Randell",46,108,.426,1,7,.143,45,101,.446,21,32,.656,30,24,54,8,3,26,11,29,114,1998/1999
"Jacobson,Sam",3,5,.600,0,1,.000,3,4,.750,2,2,1.000,0,3,3,0,0,1,0,2,8,1998/1999
"James,Jerome",9,24,.375,0,0,,9,24,.375,6,12,.500,6,11,17,1,2,9,6,11,24,1998/1999
"Jamison,Antawn",178,394,.452,3,10,.300,175,384,.456,90,153,.588,131,170,301,34,38,68,16,102,449,1998/1999
"Johnson,Anthony",91,225,.404,5,19,.263,86,206,.417,57,82,.695,16,59,75,107,35,65,7,67,244,1998/1999
"Johnson,Avery",218,461,.473,1,12,.083,217,449,.483,50,88,.568,22,96,118,369,51,112,11,101,487,1998/1999
"Johnson,Eddie",6,13,.462,0,1,.000,6,12,.500,0,0,,0,2,2,1,0,2,0,3,12,1998/1999
"Johnson,Ervin",96,189,.508,0,0,,96,189,.508,64,105,.610,120,200,320,19,29,47,57,151,256,1998/1999
"Johnson,Larry",210,458,.459,33,92,.359,177,366,.484,134,164,.817,91,193,284,119,34,89,10,147,587,1998/1999
"Jones,Charles",39,123,.317,19,61,.311,20,62,.323,11,22,.500,9,33,42,41,18,29,5,30,108,1998/1999
"Jones,Damon",43,119,.361,25,62,.403,18,57,.316,14,17,.824,6,38,44,42,13,17,0,23,125,1998/1999
"Jones,Damon",14,44,.318,10,29,.345,4,15,.267,11,13,.846,2,11,13,13,7,5,0,7,49,1998/1999
"Jones,Damon",29,75,.387,15,33,.455,14,42,.333,3,4,.750,4,27,31,29,6,12,0,16,76,1998/1999
"Jones,Eddie",260,595,.437,48,142,.338,212,453,.468,212,271,.782,50,144,194,186,125,93,58,128,780,1998/1999
"Jones,Eddie",96,227,.423,20,64,.313,76,163,.466,59,80,.738,20,56,76,61,35,21,24,42,271,1998/1999
"Jones,Eddie",164,368,.446,28,78,.359,136,290,.469,153,191,.801,30,88,118,125,90,72,34,86,509,1998/1999
"Jones,Popeye",20,51,.392,0,1,.000,20,50,.400,14,17,.824,28,24,52,15,5,7,0,31,54,1998/1999
"Jordan,Adonis",2,4,.500,0,2,.000,2,2,1.000,2,4,.500,0,0,0,3,3,2,0,0,6,1998/1999
"Jordan,Reggie",15,54,.278,0,0,,15,54,.278,21,38,.553,27,32,59,41,12,14,5,38,51,1998/1999
"Keefe,Adam",56,124,.452,0,4,.000,56,120,.467,62,89,.697,51,91,142,28,16,33,12,63,174,1998/1999
"Kemp,Shawn",277,575,.482,1,2,.500,276,573,.482,307,389,.789,131,257,388,101,48,127,45,159,862,1998/1999
"Kerner,Jonathan",0,1,.000,0,0,,0,1,.000,0,0,,0,0,0,0,0,0,0,2,0,1998/1999
"Kerr,Steve",68,174,.391,25,80,.313,43,94,.457,31,35,.886,6,38,44,49,23,22,3,28,192,1998/1999
"Kersey,Jerome",68,200,.340,3,14,.214,65,186,.349,6,14,.429,42,88,130,41,37,30,14,92,145,1998/1999
"Kidd,Jason",310,698,.444,45,123,.366,265,575,.461,181,239,.757,87,252,339,539,114,150,19,108,846,1998/1999
"King,Chris",2,7,.286,0,0,,2,7,.286,0,4,.000,1,10,11,1,2,4,1,8,4,1998/1999
"King,Gerard",6,14,.429,0,0,,6,14,.429,11,18,.611,6,8,14,4,2,4,1,12,23,1998/1999
"Kittles,Kerry",227,613,.370,50,158,.316,177,455,.389,88,114,.772,52,139,191,116,79,66,26,82,592,1998/1999
"Kleine,Joe",30,74,.405,0,2,.000,30,72,.417,8,12,.667,27,40,67,12,8,10,1,46,68,1998/1999
"Knight,Brevin",134,315,.425,0,5,.000,134,310,.432,105,141,.745,16,115,131,302,70,105,7,115,373,1998/1999
"Knight,Negele",3,8,.375,0,1,.000,3,7,.429,2,4,.500,1,5,6,8,1,7,0,5,8,1998/1999
"Knight,Travis",67,130,.515,0,1,.000,67,129,.519,22,29,.759,34,94,128,31,21,35,27,108,156,1998/1999
"Kukoč,Toni",315,750,.420,39,137,.285,276,613,.450,159,215,.740,65,245,310,235,49,121,11,82,828,1998/1999
"Laettner,Christian",38,106,.358,1,3,.333,37,103,.359,44,57,.772,21,33,54,24,15,19,12,30,121,1998/1999
"LaFrentz,Raef",59,129,.457,12,31,.387,47,98,.480,36,48,.750,33,58,91,8,9,9,17,38,166,1998/1999
"Lang,Andrew",32,99,.323,0,0,,32,99,.323,16,23,.696,33,60,93,13,5,17,12,43,80,1998/1999
"Lang,Antonio",4,6,.667,0,0,,4,6,.667,5,9,.556,6,10,16,1,2,4,1,13,13,1998/1999
"LaRue,Rusty",78,217,.359,30,89,.337,48,128,.375,17,17,1.000,9,47,56,63,33,34,3,66,203,1998/1999
"Legler,Tim",51,115,.443,14,35,.400,37,80,.463,3,6,.500,8,32,40,21,4,14,3,42,119,1998/1999
"Lenard,Voshon",31,79,.392,12,35,.343,19,44,.432,8,11,.727,4,12,16,10,3,7,1,18,82,1998/1999
"Lewis,Rashard",19,52,.365,1,6,.167,18,46,.391,8,14,.571,13,12,25,4,8,20,1,19,47,1998/1999
"Livingston,Randy",5,8,.625,0,0,,5,8,.625,2,2,1.000,0,2,2,3,2,1,0,1,12,1998/1999
"Long,Grant",151,359,.421,3,18,.167,148,341,.434,184,235,.783,100,196,296,53,57,74,16,143,489,1998/1999
"Longley,Luc",140,290,.483,0,0,,140,290,.483,59,76,.776,59,162,221,45,23,53,21,119,339,1998/1999
"López,Felipe",169,379,.446,12,44,.273,157,335,.469,87,135,.644,69,97,166,62,49,82,14,128,437,1998/1999
"Lue,Tyronn",28,65,.431,7,16,.438,21,49,.429,12,21,.571,2,4,6,25,5,11,0,28,75,1998/1999
"Lynch,George",147,349,.421,9,23,.391,138,326,.423,53,84,.631,110,169,279,76,85,79,22,142,356,1998/1999
"Mack,Sam",167,384,.435,87,219,.397,80,165,.485,51,58,.879,14,81,95,55,35,33,4,94,472,1998/1999
"Mack,Sam",86,212,.406,42,108,.389,44,104,.423,28,30,.933,7,46,53,23,20,20,1,53,242,1998/1999
"Mack,Sam",81,172,.471,45,111,.405,36,61,.590,23,28,.821,7,35,42,32,15,13,3,41,230,1998/1999
"MacLean,Don",63,159,.396,9,33,.273,54,126,.429,50,80,.625,18,47,65,16,5,25,5,34,185,1998/1999
"Macon,Mark",4,20,.200,1,3,.333,3,17,.176,0,0,,3,2,5,4,5,6,1,6,9,1998/1999
"Mahorn,Rick",5,18,.278,0,0,,5,18,.278,3,8,.375,7,16,23,2,5,6,1,22,13,1998/1999
"Majerle,Dan",118,298,.396,68,203,.335,50,95,.526,33,46,.717,21,187,208,150,38,55,7,100,337,1998/1999
"Malone,Karl",393,797,.493,0,1,.000,393,796,.494,378,480,.788,107,356,463,201,62,162,28,134,1164,1998/1999
"Maloney,Matt",5,28,.179,1,15,.067,4,13,.308,10,11,.909,2,8,10,21,4,14,0,7,21,1998/1999
"Manning,Danny",187,386,.484,1,9,.111,186,377,.493,78,112,.696,62,157,219,113,36,69,38,129,453,1998/1999
"Marbury,Stephon",378,883,.428,66,197,.335,312,686,.455,222,278,.799,37,105,142,437,59,164,8,125,1044,1998/1999
"Marbury,Stephon",124,304,.408,8,39,.205,116,265,.438,63,87,.724,17,45,62,167,29,55,5,44,319,1998/1999
"Marbury,Stephon",254,579,.439,58,158,.367,196,421,.466,159,191,.832,20,60,80,270,30,109,3,81,725,1998/1999
"Marks,Sean",5,8,.625,0,0,,5,8,.625,1,2,.500,0,1,1,0,1,3,0,3,11,1998/1999
"Marshall,Donyell",208,494,.421,26,72,.361,182,422,.431,88,121,.727,115,227,342,66,47,80,37,123,530,1998/1999
"Martin,Darrick",102,278,.367,31,106,.292,71,172,.413,61,76,.803,5,43,48,144,43,67,4,82,296,1998/1999
"Mashburn,Jamal",134,297,.451,13,30,.433,121,267,.453,75,104,.721,24,122,146,75,20,60,3,58,356,1998/1999
"Massenburg,Tony",189,388,.487,0,2,.000,189,386,.490,103,155,.665,83,174,257,23,26,64,39,108,481,1998/1999
"Maxwell,Vernon",164,421,.390,80,231,.346,84,190,.442,84,114,.737,13,72,85,76,30,67,3,111,492,1998/1999
"Mayberry,Lee",7,19,.368,2,10,.200,5,9,.556,4,5,.800,0,3,3,23,7,11,0,13,20,1998/1999
"McCarty,Kelly",2,3,.667,0,0,,2,3,.667,0,0,,2,1,3,0,0,2,0,0,4,1998/1999
"McCarty,Walter",64,177,.362,13,50,.260,51,127,.402,40,57,.702,36,79,115,40,24,40,13,88,181,1998/1999
"McCloud,George",142,324,.438,69,166,.416,73,158,.462,75,87,.862,34,128,162,79,45,49,14,128,428,1998/1999
"McCoy,Jelani",56,76,.737,0,0,,56,76,.737,21,42,.500,27,52,79,4,11,10,20,42,133,1998/1999
"McDyess,Antonio",415,882,.471,1,9,.111,414,873,.474,230,338,.680,168,369,537,82,73,138,115,175,1061,1998/1999
"McGrady,Tracy",168,385,.436,8,35,.229,160,350,.457,114,157,.726,120,158,278,113,52,80,66,94,458,1998/1999
"McIlvaine,Jim",22,51,.431,0,0,,22,51,.431,4,6,.667,31,23,54,2,9,13,32,59,48,1998/1999
"McInnis,Jeff",50,134,.373,9,35,.257,41,99,.414,21,28,.750,9,12,21,73,19,30,1,36,130,1998/1999
"McKey,Derrick",23,52,.442,0,1,.000,23,51,.451,14,17,.824,18,23,41,13,12,12,4,24,60,1998/1999
"McKie,Aaron",95,237,.401,6,31,.194,89,206,.432,44,62,.710,27,113,140,100,63,57,3,90,240,1998/1999
"McLeod,Roshown",62,163,.380,1,10,.100,61,153,.399,37,45,.822,12,38,50,14,2,23,1,24,162,1998/1999
"Mercer,Ron",305,707,.431,5,30,.167,300,677,.443,83,105,.790,37,118,155,104,67,89,12,81,698,1998/1999
"Meyer,Loren",7,28,.250,1,5,.200,6,23,.261,1,2,.500,4,12,16,1,0,4,3,22,16,1998/1999
"Milič,Marko",8,20,.400,0,1,.000,8,19,.421,0,0,,3,2,5,2,3,6,1,7,16,1998/1999
"Miller,Anthony",28,60,.467,0,1,.000,28,59,.475,14,22,.636,26,41,67,7,7,9,5,34,70,1998/1999
"Miller,Brad",78,138,.565,1,2,.500,77,136,.566,81,102,.794,35,82,117,22,9,32,18,65,238,1998/1999
"Miller,Oliver",5,11,.455,0,0,,5,11,.455,0,0,,7,1,8,0,0,4,2,3,10,1998/1999
"Miller,Reggie",294,671,.438,106,275,.385,188,396,.475,226,247,.915,25,110,135,112,37,76,9,101,920,1998/1999
"Mills,Chris",186,453,.411,32,115,.278,154,338,.456,79,96,.823,49,188,237,103,39,58,14,125,483,1998/1999
"Mills,Terry",3,8,.375,2,4,.500,1,4,.250,1,2,.500,3,1,4,0,1,3,0,3,9,1998/1999
"Minor,Greg",85,204,.417,8,28,.286,77,176,.438,36,48,.750,31,86,117,50,20,38,6,69,214,1998/1999
"Mitchell,Sam",213,522,.408,9,38,.237,204,484,.421,126,165,.764,55,127,182,98,35,34,16,111,561,1998/1999
"Mobley,Cuttino",172,405,.425,53,148,.358,119,257,.463,90,110,.818,22,89,111,121,44,79,23,98,487,1998/1999
"Mohammed,Nazr",15,42,.357,0,0,,15,42,.357,12,21,.571,18,19,37,2,5,12,4,22,42,1998/1999
"Montross,Eric",42,80,.525,0,1,.000,42,79,.532,11,32,.344,45,94,139,14,12,16,27,107,95,1998/1999
"Moore,Mikki",1,1,1.000,0,0,,1,1,1.000,2,2,1.000,0,1,1,0,0,0,0,0,4,1998/1999
"Morris,Chris",64,149,.430,16,56,.286,48,93,.516,40,46,.870,54,67,121,23,16,21,11,54,184,1998/1999
"Mourning,Alonzo",324,634,.511,0,2,.000,324,632,.513,276,423,.652,166,341,507,74,34,139,180,161,924,1998/1999
"Mullin,Chris",177,371,.477,73,157,.465,104,214,.486,80,92,.870,25,135,160,81,47,60,13,101,507,1998/1999
"Murdock,Eric",45,114,.395,8,22,.364,37,92,.402,21,26,.808,3,32,35,66,22,29,2,35,119,1998/1999
"Mureșan,Gheorghe",0,1,.000,0,0,,0,1,.000,0,0,,0,0,0,0,0,1,0,0,0,1998/1999
"Murray,Lamond",226,578,.391,34,103,.330,192,475,.404,126,157,.803,59,136,195,61,58,99,20,107,612,1998/1999
"Murray,Tracy",83,237,.350,33,103,.320,50,134,.373,34,42,.810,18,63,81,27,21,29,6,65,233,1998/1999
"Mutombo,Dikembe",173,338,.512,0,0,,173,338,.512,195,285,.684,192,418,610,57,16,94,147,145,541,1998/1999
"N'Diaye,Makhtar",1,4,.250,0,0,,1,4,.250,3,4,.750,3,2,5,1,0,1,1,9,5,1998/1999
"Nash,Steve",114,314,.363,49,131,.374,65,183,.355,38,46,.826,32,82,114,219,37,83,2,98,315,1998/1999
"Nesby,Tyrone",182,405,.449,35,96,.365,147,309,.476,104,133,.782,57,118,175,82,77,53,20,143,503,1998/1999
"Nesterović,Rasho",3,12,.250,0,0,,3,12,.250,2,2,1.000,3,5,8,1,0,1,0,5,8,1998/1999
"Newman,Johnny",106,251,.422,23,61,.377,83,190,.437,68,84,.810,15,60,75,41,28,41,12,126,303,1998/1999
"Norris,Moochie",13,40,.325,6,15,.400,7,25,.280,6,16,.375,4,16,20,24,7,16,0,17,38,1998/1999
"Nowitzki,Dirk",136,336,.405,14,68,.206,122,268,.455,99,128,.773,41,121,162,47,29,73,27,105,385,1998/1999
"O'Bannon,Charles",24,56,.429,0,1,.000,24,55,.436,8,8,1.000,18,16,34,12,2,8,3,22,56,1998/1999
"O'Neal,Jermaine",36,83,.434,0,1,.000,36,82,.439,18,35,.514,42,55,97,13,4,14,14,41,90,1998/1999
"O'Neal,Shaquille",510,885,.576,0,1,.000,510,884,.577,269,498,.540,187,338,525,114,36,122,82,155,1289,1998/1999
"Oakley,Charles",140,327,.428,1,5,.200,139,322,.432,67,83,.807,96,278,374,168,46,96,21,182,348,1998/1999
"Olajuwon,Hakeem",373,725,.514,4,13,.308,369,712,.518,195,272,.717,106,372,478,88,82,139,123,160,945,1998/1999
"Oliver,Jimmy",1,3,.333,1,1,1.000,0,2,.000,0,0,,0,0,0,0,0,0,0,2,3,1998/1999
"Ollie,Kevin",4,14,.286,0,0,,4,14,.286,5,7,.714,0,7,7,3,3,3,1,9,13,1998/1999
"Ollie,Kevin",4,13,.308,0,0,,4,13,.308,4,5,.800,0,6,6,3,3,3,1,8,12,1998/1999
"Ollie,Kevin",0,1,.000,0,0,,0,1,.000,1,2,.500,0,1,1,0,0,0,0,1,1,1998/1999
"Olowokandi,Michael",172,399,.431,0,0,,172,399,.431,57,118,.483,120,237,357,25,27,85,55,137,401,1998/1999
"Ostertag,Greg",99,208,.476,0,0,,99,208,.476,75,121,.620,105,243,348,23,12,45,131,140,273,1998/1999
"Outlaw,Bo",84,154,.545,0,3,.000,84,151,.556,35,81,.432,54,113,167,56,40,58,43,79,203,1998/1999
"Overton,Doug",36,84,.429,2,7,.286,34,77,.442,18,20,.900,7,14,21,23,5,20,1,18,92,1998/1999
"Overton,Doug",6,12,.500,0,2,.000,6,10,.600,6,6,1.000,1,1,2,3,1,3,0,2,18,1998/1999
"Overton,Doug",25,57,.439,2,4,.500,23,53,.434,12,14,.857,6,11,17,16,3,15,1,14,64,1998/1999
"Overton,Doug",5,15,.333,0,1,.000,5,14,.357,0,0,,0,2,2,4,1,2,0,2,10,1998/1999
"Owens,Billy",65,165,.394,5,11,.455,60,154,.390,28,35,.800,35,45,80,38,12,33,4,37,163,1998/1999
"Pack,Robert",75,174,.431,0,4,.000,75,170,.441,72,88,.818,9,27,36,81,20,49,1,41,222,1998/1999
"Parker,Anthony",1,1,1.000,0,0,,1,1,1.000,0,0,,0,0,0,0,0,0,0,0,2,1998/1999
"Parks,Cherokee",118,275,.429,0,1,.000,118,274,.431,30,55,.545,75,168,243,36,28,49,28,114,266,1998/1999
"Patterson,Andrae",43,97,.443,0,5,.000,43,92,.467,28,36,.778,30,35,65,15,19,22,7,62,114,1998/1999
"Patterson,Ruben",21,51,.412,1,6,.167,20,45,.444,22,31,.710,17,13,30,2,5,12,3,16,65,1998/1999
"Payton,Gary",401,923,.434,83,281,.295,318,642,.495,199,276,.721,62,182,244,436,109,154,12,115,1084,1998/1999
"Peeler,Anthony",103,272,.379,34,114,.298,69,158,.437,30,41,.732,30,54,84,78,35,38,6,60,270,1998/1999
"Perdue,Will",38,60,.633,0,0,,38,60,.633,14,26,.538,33,105,138,18,9,22,10,63,90,1998/1999
"Perkins,Sam",80,200,.400,35,90,.389,45,110,.409,43,60,.717,36,102,138,25,15,22,14,74,238,1998/1999
"Perry,Elliot",39,103,.379,10,24,.417,29,79,.367,10,14,.714,7,27,34,47,20,34,0,25,98,1998/1999
"Perry,Elliot",9,17,.529,1,1,1.000,8,16,.500,1,2,.500,1,7,8,12,4,2,0,3,20,1998/1999
"Perry,Elliot",30,86,.349,9,23,.391,21,63,.333,9,12,.750,6,20,26,35,16,32,0,22,78,1998/1999
"Person,Chuck",112,289,.388,55,157,.350,57,132,.432,24,32,.750,17,115,132,60,20,41,8,90,303,1998/1999
"Person,Wesley",198,437,.453,75,200,.375,123,237,.519,32,53,.604,19,123,142,80,37,41,16,52,503,1998/1999
"Phills,Bobby",215,497,.433,68,172,.395,147,325,.452,115,168,.685,39,135,174,149,60,92,25,124,613,1998/1999
"Piatkowski,Eric",180,417,.432,65,165,.394,115,252,.456,88,102,.863,39,101,140,53,44,53,6,86,513,1998/1999
"Pierce,Paul",284,647,.439,84,204,.412,200,443,.451,139,195,.713,117,192,309,115,82,113,50,139,791,1998/1999
"Pippen,Scottie",261,604,.432,72,212,.340,189,392,.482,132,183,.721,63,260,323,293,98,159,37,118,726,1998/1999
"Pollard,Scot",33,61,.541,0,0,,33,61,.541,16,23,.696,38,44,82,4,8,5,18,41,82,1998/1999
"Polynice,Olden",169,358,.472,1,1,1.000,168,357,.471,29,94,.309,184,241,425,43,20,49,30,150,368,1998/1999
"Pope,Mark",1,7,.143,0,4,.000,1,3,.333,0,1,.000,2,2,4,0,0,1,0,6,2,1998/1999
"Porter,Terry",172,370,.465,58,141,.411,114,229,.498,123,148,.831,13,127,140,146,48,74,11,97,525,1998/1999
"Potapenko,Vitaly",204,412,.495,0,1,.000,204,411,.496,91,155,.587,114,218,332,75,35,100,36,169,499,1998/1999
"Potapenko,Vitaly",55,126,.437,0,1,.000,55,125,.440,33,49,.673,23,71,94,16,11,28,16,53,143,1998/1999
"Potapenko,Vitaly",149,286,.521,0,0,,149,286,.521,58,106,.547,91,147,238,59,24,72,20,116,356,1998/1999
"Price,Brent",100,207,.483,46,112,.411,54,95,.568,46,61,.754,18,60,78,113,33,65,1,90,292,1998/1999
"Ratliff,Theo",197,419,.470,0,0,,197,419,.470,166,229,.725,139,268,407,30,45,92,149,180,560,1998/1999
"Recasner,Eldridge",82,184,.446,24,60,.400,58,124,.468,34,39,.872,20,57,77,91,17,58,1,66,222,1998/1999
"Reeves,Bryant",102,251,.406,0,1,.000,102,250,.408,67,116,.578,50,88,138,37,13,47,8,103,271,1998/1999
"Reeves,Khalid",8,21,.381,1,3,.333,7,18,.389,8,14,.571,3,4,7,11,4,7,0,13,25,1998/1999
"Reid,Don",97,174,.557,0,0,,97,174,.557,48,79,.608,66,104,170,33,27,36,43,156,242,1998/1999
"Reid,J.R.",132,277,.477,0,1,.000,132,276,.478,105,137,.766,45,167,212,48,37,51,10,135,369,1998/1999
"Reid,J.R.",88,169,.521,0,0,,88,169,.521,67,84,.798,21,92,113,25,22,28,10,63,243,1998/1999
"Reid,J.R.",44,108,.407,0,1,.000,44,107,.411,38,53,.717,24,75,99,23,15,23,0,72,126,1998/1999
"Respert,Shawn",13,36,.361,4,13,.308,9,23,.391,7,10,.700,2,11,13,8,5,5,0,10,37,1998/1999
"Rhodes,Rodrick",13,52,.250,1,7,.143,12,45,.267,16,25,.640,9,8,17,11,5,20,2,21,43,1998/1999
"Rhodes,Rodrick",2,8,.250,0,0,,2,8,.250,5,6,.833,2,2,4,1,1,5,0,5,9,1998/1999
"Rhodes,Rodrick",11,44,.250,1,7,.143,10,37,.270,11,19,.579,7,6,13,10,4,15,2,16,34,1998/1999
"Rice,Glen",171,396,.432,53,135,.393,118,261,.452,77,90,.856,9,90,99,71,17,45,6,67,472,1998/1999
"Richardson,Pooh",12,36,.333,0,6,.000,12,30,.400,4,4,1.000,1,12,13,30,4,9,0,5,28,1998/1999
"Richmond,Mitch",331,803,.412,70,221,.317,261,582,.448,251,293,.857,30,142,172,122,64,136,10,121,983,1998/1999
"Rider,Isaiah",249,605,.412,42,111,.378,207,494,.419,111,147,.755,59,137,196,104,25,95,9,100,651,1998/1999
"Riley,Eric",28,54,.519,0,0,,28,54,.519,22,31,.710,36,63,99,13,9,26,26,73,78,1998/1999
"Roberts,Stanley",5,13,.385,0,0,,5,13,.385,4,8,.500,4,7,11,0,0,4,1,2,14,1998/1999
"Robinson,Clifford",299,629,.475,58,139,.417,241,490,.492,163,234,.697,69,158,227,128,75,88,59,153,819,1998/1999
"Robinson,David",268,527,.509,0,1,.000,268,526,.510,239,363,.658,148,344,492,103,69,108,119,143,775,1998/1999
"Robinson,Glenn",347,756,.459,31,79,.392,316,677,.467,140,161,.870,73,203,276,100,46,106,41,114,865,1998/1999
"Robinson,James",67,185,.362,21,74,.284,46,111,.414,28,41,.683,18,44,62,56,22,44,8,60,183,1998/1999
"Robinson,James",39,98,.398,8,30,.267,31,68,.456,20,27,.741,10,17,27,18,14,16,3,29,106,1998/1999
"Robinson,James",28,87,.322,13,44,.295,15,43,.349,8,14,.571,8,27,35,38,8,28,5,31,77,1998/1999
"Rodman,Dennis",16,46,.348,0,2,.000,16,44,.364,17,39,.436,62,196,258,30,10,31,12,71,49,1998/1999
"Rogers,Carlos",2,2,1.000,0,0,,2,2,1.000,1,4,.250,0,1,1,1,0,0,0,2,5,1998/1999
"Rogers,Rodney",131,297,.441,18,63,.286,113,234,.483,68,101,.673,65,114,179,77,47,66,22,140,348,1998/1999
"Rooks,Sean",32,79,.405,0,2,.000,32,77,.416,34,48,.708,33,39,72,9,2,21,9,61,98,1998/1999
"Rose,Jalen",200,496,.403,17,65,.262,183,431,.425,125,158,.791,34,120,154,93,50,72,15,128,542,1998/1999
"Rose,Malik",93,201,.463,0,1,.000,93,200,.465,98,146,.671,90,92,182,29,40,56,22,120,284,1998/1999
"Russell,Bryon",217,468,.464,52,147,.354,165,321,.514,136,171,.795,65,201,266,74,76,76,15,154,622,1998/1999
"Sabonis,Arvydas",232,478,.485,7,24,.292,225,454,.496,135,175,.771,88,305,393,119,34,85,63,147,606,1998/1999
"Sasser,Jason",5,11,.455,0,0,,5,11,.455,1,2,.500,2,5,7,2,2,2,0,4,11,1998/1999
"Schayes,Danny",11,29,.379,0,0,,11,29,.379,6,8,.750,3,11,14,4,1,8,2,23,28,1998/1999
"Schintzius,Dwayne",4,16,.250,0,0,,4,16,.250,3,4,.750,7,12,19,8,0,10,3,17,11,1998/1999
"Schrempf,Detlef",259,549,.472,34,86,.395,225,463,.486,200,243,.823,77,293,370,184,41,103,26,152,752,1998/1999
"Scott,Dennis",87,213,.408,37,97,.381,50,116,.431,23,31,.742,8,50,58,40,15,19,3,49,234,1998/1999
"Scott,Dennis",17,56,.304,8,29,.276,9,27,.333,1,4,.250,3,17,20,8,3,5,1,17,43,1998/1999
"Scott,Dennis",70,157,.446,29,68,.426,41,89,.461,22,27,.815,5,33,38,32,12,14,2,32,191,1998/1999
"Sealy,Malik",95,231,.411,6,23,.261,89,208,.428,55,61,.902,23,69,92,36,30,33,5,68,251,1998/1999
"Seikaly,Rony",4,20,.200,0,0,,4,20,.200,7,18,.389,5,16,21,2,4,10,6,15,15,1998/1999
"Shackleford,Charles",44,90,.489,0,0,,44,90,.489,19,29,.655,41,88,129,13,5,27,13,66,107,1998/1999
"Shaw,Brian",0,1,.000,0,0,,0,1,.000,0,0,,0,1,1,1,0,1,0,1,0,1998/1999
"Shaw,Casey",1,8,.125,0,0,,1,8,.125,0,0,,3,0,3,0,0,2,0,2,2,1998/1999
"Sheppard,Jeff",15,39,.385,2,7,.286,13,32,.406,8,13,.615,6,16,22,16,3,7,0,12,40,1998/1999
"Simon,Miles",1,5,.200,0,2,.000,1,3,.333,0,0,,1,1,2,0,1,3,0,1,2,1998/1999
"Simpkins,Dickey",150,324,.463,0,1,.000,150,323,.464,156,242,.645,110,229,339,65,36,72,13,128,456,1998/1999
"Sims,Alvin",4,10,.400,1,1,1.000,3,9,.333,2,5,.400,3,1,4,5,2,6,0,2,11,1998/1999
"Skinner,Brian",33,71,.465,0,0,,33,71,.465,20,33,.606,20,33,53,1,10,19,13,20,86,1998/1999
"Slater,Reggie",31,81,.383,0,0,,31,81,.383,53,85,.624,36,34,70,5,3,25,3,50,115,1998/1999
"Smith,Charles",35,97,.361,7,33,.212,28,64,.438,7,16,.438,7,17,24,13,17,20,14,35,84,1998/1999
"Smith,Joe",223,522,.427,0,3,.000,223,519,.430,142,188,.755,154,200,354,68,32,66,66,147,588,1998/1999
"Smith,Michael",77,144,.535,0,1,.000,77,143,.538,76,128,.594,135,215,350,48,46,60,18,107,230,1998/1999
"Smith,Steve",217,540,.402,47,139,.338,170,401,.424,191,225,.849,50,101,151,118,36,99,11,100,672,1998/1999
"Smits,Rik",310,633,.490,0,2,.000,310,631,.491,108,132,.818,73,202,275,52,18,75,52,159,728,1998/1999
"Snow,Eric",149,348,.428,5,21,.238,144,327,.440,110,150,.733,25,137,162,301,100,111,1,149,413,1998/1999
"Spencer,Felton",15,33,.455,0,0,,15,33,.455,12,26,.462,18,28,46,0,5,9,10,41,42,1998/1999
"Sprewell,Latrell",215,518,.415,21,77,.273,194,441,.440,155,191,.812,41,115,156,91,46,79,2,65,606,1998/1999
"Stack,Ryan",14,37,.378,0,0,,14,37,.378,19,20,.950,19,15,34,5,2,9,11,31,47,1998/1999
"Stackhouse,Jerry",181,488,.371,35,126,.278,146,362,.403,210,247,.850,26,81,107,118,34,121,19,79,607,1998/1999
"Starks,John",269,728,.370,78,269,.290,191,459,.416,74,100,.740,33,130,163,235,69,83,5,135,690,1998/1999
"Stepania,Vladimir",53,125,.424,0,3,.000,53,122,.434,21,40,.525,27,48,75,12,10,32,23,58,127,1998/1999
"Stewart,Michael",22,53,.415,0,0,,22,53,.415,17,25,.680,43,56,99,5,4,12,28,76,61,1998/1999
"Stith,Bryant",114,290,.393,31,106,.292,83,184,.451,61,71,.859,30,77,107,82,28,45,15,65,320,1998/1999
"Stockton,John",200,410,.488,16,50,.320,184,360,.511,137,169,.811,31,115,146,374,81,110,13,107,553,1998/1999
"Stojaković,Peja",141,373,.378,57,178,.320,84,195,.431,63,74,.851,43,100,143,72,41,53,7,43,402,1998/1999
"Stoudamire,Damon",249,629,.396,44,142,.310,205,487,.421,89,122,.730,41,126,167,312,49,110,4,81,631,1998/1999
"Strickland,Erick",89,221,.403,18,59,.305,71,162,.438,53,65,.815,12,71,83,64,40,36,2,44,249,1998/1999
"Strickland,Mark",50,101,.495,0,1,.000,50,100,.500,19,26,.731,26,52,78,9,7,13,8,28,119,1998/1999
"Strickland,Rod",251,603,.416,12,42,.286,239,561,.426,176,236,.746,56,156,212,434,76,142,5,91,690,1998/1999
"Strong,Derek",76,180,.422,0,2,.000,76,178,.427,71,99,.717,66,95,161,17,15,37,7,64,223,1998/1999
"Šundov,Bruno",2,7,.286,0,0,,2,7,.286,0,0,,0,0,0,1,0,1,0,4,4,1998/1999
"Sura,Bob",70,210,.333,9,45,.200,61,165,.370,65,103,.631,21,81,102,152,46,67,14,98,214,1998/1999
"Taylor,Johnny",82,198,.414,26,68,.382,56,130,.431,17,23,.739,30,71,101,24,28,34,17,97,207,1998/1999
"Taylor,Maurice",311,675,.461,1,6,.167,310,669,.463,150,206,.728,100,142,242,67,16,120,29,179,773,1998/1999
"Thomas,John",71,123,.577,0,1,.000,71,122,.582,27,48,.563,65,69,134,15,17,21,9,82,169,1998/1999
"Thomas,Kurt",170,368,.462,0,1,.000,170,367,.463,66,108,.611,82,204,286,55,45,73,17,159,406,1998/1999
"Thomas,Tim",132,279,.473,21,68,.309,111,211,.526,73,112,.652,49,77,126,46,26,46,12,107,358,1998/1999
"Thomas,Tim",27,67,.403,5,19,.263,22,48,.458,19,24,.792,7,26,33,15,3,15,3,21,78,1998/1999
"Thomas,Tim",105,212,.495,16,49,.327,89,163,.546,54,88,.614,42,51,93,31,23,31,9,86,280,1998/1999
"Thorpe,Otis",240,440,.545,0,2,.000,240,438,.548,74,106,.698,96,238,334,101,42,88,19,196,554,1998/1999
"Traylor,Robert",108,201,.537,0,1,.000,108,200,.540,43,80,.538,80,102,182,38,44,42,44,140,259,1998/1999
"Trent,Gary",287,602,.477,0,5,.000,287,597,.481,145,235,.617,127,224,351,77,29,66,23,122,719,1998/1999
"Van Exel,Nick",306,769,.398,72,234,.308,234,535,.437,142,175,.811,14,99,113,368,40,121,3,90,826,1998/1999
"Van Horn,Keith",322,752,.428,16,53,.302,306,699,.438,256,298,.859,114,244,358,65,43,133,53,134,916,1998/1999
"Vaughn,David",13,24,.542,0,0,,13,24,.542,8,10,.800,13,21,34,1,2,11,8,22,34,1998/1999
"Vaughn,Jacque",11,30,.367,2,8,.250,9,22,.409,20,24,.833,1,10,11,12,5,14,0,14,44,1998/1999
"Vaught,Loy",59,155,.381,0,1,.000,59,154,.383,9,14,.643,36,110,146,11,15,17,6,54,127,1998/1999
"Vranković,Stojko",1,4,.250,0,0,,1,4,.250,0,0,,4,2,6,0,0,0,0,2,2,1998/1999
"Walker,Antoine",303,735,.412,65,176,.369,238,559,.426,113,202,.559,106,253,359,130,63,119,28,142,784,1998/1999
"Walker,Samaki",88,190,.463,0,1,.000,88,189,.466,53,98,.541,46,97,143,6,9,37,16,87,229,1998/1999
"Wallace,Ben",115,199,.578,0,0,,115,199,.578,47,132,.356,137,247,384,18,50,36,90,111,277,1998/1999
"Wallace,John",153,354,.432,0,0,,153,354,.432,105,150,.700,54,117,171,46,12,70,43,92,411,1998/1999
"Wallace,Rasheed",242,476,.508,13,31,.419,229,445,.515,131,179,.732,57,184,241,60,48,80,54,175,628,1998/1999
"Walters,Rex",35,95,.368,12,38,.316,23,57,.404,19,23,.826,10,40,50,58,10,32,3,63,101,1998/1999
"Ward,Charlie",135,334,.404,53,149,.356,82,185,.443,55,78,.705,23,149,172,271,103,131,8,105,378,1998/1999
"Washington,Eric",73,184,.397,37,97,.381,36,87,.414,22,32,.688,35,54,89,30,25,34,18,87,205,1998/1999
"Watson,Jamie",1,2,.500,0,0,,1,2,.500,0,0,,0,1,1,1,0,1,0,1,2,1998/1999
"Weatherspoon,Clarence",141,264,.534,0,0,,141,264,.534,115,143,.804,72,171,243,34,28,61,17,107,397,1998/1999
"Webber,Chris",378,778,.486,4,34,.118,374,744,.503,79,174,.454,149,396,545,173,60,148,89,145,839,1998/1999
"Wells,Bonzi",11,20,.550,1,3,.333,10,17,.588,8,18,.444,4,5,9,3,1,6,1,5,31,1998/1999
"Wennington,Bill",62,178,.348,1,1,1.000,61,177,.345,18,22,.818,20,59,79,18,13,17,12,79,143,1998/1999
"Wesley,David",243,545,.446,61,170,.359,182,375,.485,159,191,.832,23,138,161,322,100,142,10,130,706,1998/1999
"West,Doug",31,65,.477,0,2,.000,31,63,.492,19,25,.760,5,20,25,19,16,12,7,38,81,1998/1999
"West,Mark",22,59,.373,0,0,,22,59,.373,16,45,.356,49,76,125,13,4,17,22,81,60,1998/1999
"Wheat,DeJuan",73,193,.378,22,60,.367,51,133,.383,40,55,.727,11,34,45,102,26,48,2,59,208,1998/1999
"Wheeler,Tyson",1,1,1.000,1,1,1.000,0,0,,1,2,.500,0,0,0,2,0,0,0,1,4,1998/1999
"White,Jahidi",17,32,.531,0,0,,17,32,.531,15,35,.429,23,35,58,1,3,16,11,39,49,1998/1999
"Whitney,Chris",64,156,.410,32,95,.337,32,61,.525,27,31,.871,8,39,47,69,18,36,2,49,187,1998/1999
"Wilkins,Dominique",50,132,.379,5,19,.263,45,113,.398,29,42,.690,30,41,71,16,4,23,1,19,134,1998/1999
"Wilkins,Gerald",0,9,.000,0,0,,0,9,.000,2,2,1.000,0,1,1,1,0,3,0,3,2,1998/1999
"Williams,Aaron",52,123,.423,0,1,.000,52,122,.426,54,74,.730,54,74,128,22,14,30,24,75,158,1998/1999
"Williams,Alvin",95,237,.401,14,42,.333,81,195,.415,44,52,.846,19,63,82,130,51,56,12,94,248,1998/1999
"Williams,Brandon",0,0,,0,0,,0,0,,2,4,.500,1,0,1,0,0,0,0,0,2,1998/1999
"Williams,Eric",80,219,.365,6,26,.231,74,193,.383,111,139,.799,34,47,81,37,27,49,8,76,277,1998/1999
"Williams,Herb",4,8,.500,0,0,,4,8,.500,2,2,1.000,3,3,6,0,0,2,2,2,10,1998/1999
"Williams,Hot Rod",11,33,.333,0,0,,11,33,.333,7,10,.700,36,47,83,15,13,13,18,49,29,1998/1999
"Williams,Jason",231,617,.374,100,323,.310,131,294,.446,79,105,.752,14,139,153,299,95,143,1,91,641,1998/1999
"Williams,Jayson",97,218,.445,0,2,.000,97,216,.449,48,85,.565,147,213,360,33,24,46,60,126,242,1998/1999
"Williams,Jerome",124,248,.500,0,0,,124,248,.500,107,159,.673,158,191,349,23,63,41,7,108,355,1998/1999
"Williams,Micheal",1,5,.200,0,0,,1,5,.200,0,0,,1,0,1,0,0,1,0,1,2,1998/1999
"Williams,Monty",0,2,.000,0,0,,0,2,.000,1,2,.500,0,0,0,0,0,0,0,0,1,1998/1999
"Williams,Scott",5,17,.294,0,0,,5,17,.294,4,7,.571,3,11,14,1,3,4,2,9,14,1998/1999
"Williams,Scott",0,2,.000,0,0,,0,2,.000,0,0,,1,1,2,1,2,2,1,4,0,1998/1999
"Williams,Scott",5,15,.333,0,0,,5,15,.333,4,7,.571,2,10,12,0,1,2,1,5,14,1998/1999
"Williams,Shammond",0,1,.000,0,0,,0,1,.000,3,4,.750,0,0,0,1,0,0,0,0,3,1998/1999
"Williams,Travis",6,13,.462,0,0,,6,13,.462,3,4,.750,6,13,19,2,2,6,1,10,15,1998/1999
"Williams,Walt",147,347,.424,63,144,.438,84,203,.414,89,107,.832,36,107,143,80,37,63,28,101,446,1998/1999
"Williamson,Corliss",269,555,.485,1,5,.200,268,550,.487,120,188,.638,85,121,206,66,30,75,8,118,659,1998/1999
"Willis,Kevin",187,447,.418,0,2,.000,187,445,.420,130,155,.839,109,241,350,67,28,86,28,134,504,1998/1999
"Wingate,David",7,16,.438,0,0,,7,16,.438,0,0,,3,5,8,5,4,6,0,10,14,1998/1999
"Winter,Trevor",0,0,,0,0,,0,0,,0,0,,1,2,3,0,0,0,0,5,0,1998/1999
"Wolf,Joe",0,1,.000,0,0,,0,1,.000,0,2,.000,0,1,1,0,0,0,0,6,0,1998/1999
"Workman,Haywoode",73,170,.429,17,47,.362,56,123,.455,37,47,.787,14,88,102,172,32,63,1,53,200,1998/1999
"Wright,Lorenzen",119,260,.458,0,1,.000,119,259,.459,81,117,.692,142,219,361,33,26,48,36,162,319,1998/1999
"Young,Korleone",5,10,.500,1,4,.250,4,6,.667,2,2,1.000,2,2,4,1,0,1,0,3,13,1998/1999
"Abdul-Wahad,Tariq",274,646,.424,3,23,.130,271,623,.435,146,193,.756,101,190,291,98,59,106,28,147,697,1999/2000
"Abdul-Wahad,Tariq",223,515,.433,2,21,.095,221,494,.447,115,151,.762,77,162,239,72,53,87,16,116,563,1999/2000
"Abdul-Wahad,Tariq",51,131,.389,1,2,.500,50,129,.388,31,42,.738,24,28,52,26,6,19,12,31,134,1999/2000
"Abdur-Rahim,Shareef",594,1277,.465,29,96,.302,565,1181,.478,446,551,.809,218,607,825,271,89,249,87,244,1663,1999/2000
"Alexander,Cory",28,98,.286,9,35,.257,19,63,.302,17,22,.773,8,34,42,58,24,28,2,39,82,1999/2000
"Allen,Ray",642,1411,.455,172,407,.423,470,1004,.468,353,398,.887,83,276,359,308,110,183,19,187,1809,1999/2000
"Alston,Rafer",27,95,.284,3,14,.214,24,81,.296,3,4,.750,5,18,23,70,12,29,0,29,60,1999/2000
"Amaechi,John",306,700,.437,1,6,.167,305,694,.439,223,291,.766,62,204,266,95,35,139,37,161,836,1999/2000
"Anderson,Derek",377,860,.438,55,178,.309,322,682,.472,271,309,.877,80,178,258,220,90,167,11,149,1080,1999/2000
"Anderson,Kenny",434,986,.440,85,220,.386,349,766,.456,196,253,.775,55,170,225,420,139,130,8,230,1149,1999/2000
"Anderson,Nick",306,782,.391,132,397,.332,174,385,.452,37,76,.487,83,256,339,123,94,95,16,118,781,1999/2000
"Anderson,Shandon",368,778,.473,79,225,.351,289,553,.523,194,253,.767,91,293,384,239,96,194,32,182,1009,1999/2000
"Anstey,Chris",161,364,.442,1,6,.167,160,358,.447,116,147,.789,90,190,280,65,29,80,25,180,439,1999/2000
"Anthony,Greg",169,416,.406,88,233,.378,81,183,.443,88,114,.772,17,116,133,208,59,85,9,143,514,1999/2000
"Armstrong,B.J.",83,186,.446,13,29,.448,70,157,.446,22,25,.880,2,45,47,78,7,40,1,34,201,1999/2000
"Armstrong,Darrell",484,1119,.433,137,403,.340,347,716,.485,225,247,.911,65,205,270,501,169,248,9,137,1330,1999/2000
"Atkins,Chucky",314,741,.424,57,163,.350,257,578,.445,97,133,.729,20,106,126,306,52,142,3,137,782,1999/2000
"Augmon,Stacey",83,175,.474,0,2,.000,83,173,.480,37,55,.673,42,74,116,53,27,38,11,69,203,1999/2000
"Austin,Isaac",151,352,.429,1,4,.250,150,348,.431,94,137,.686,64,218,282,74,17,107,38,128,397,1999/2000
"Avent,Anthony",29,96,.302,0,0,,29,96,.302,23,32,.719,23,51,74,11,16,24,15,62,81,1999/2000
"Avery,William",56,181,.309,18,63,.286,38,118,.322,24,36,.667,8,32,40,88,14,42,2,60,154,1999/2000
"Bailey,Toby",58,140,.414,2,10,.200,56,130,.431,45,65,.692,26,46,72,30,13,24,4,55,163,1999/2000
"Baker,Vin",514,1129,.455,2,8,.250,512,1121,.457,281,412,.682,227,378,605,148,47,213,66,288,1311,1999/2000
"Barkley,Charles",106,222,.477,6,26,.231,100,196,.510,71,110,.645,71,138,209,63,14,44,4,48,289,1999/2000
"Barros,Dana",196,435,.451,59,144,.410,137,291,.471,66,76,.868,13,86,99,133,31,66,4,80,517,1999/2000
"Barry,Brent",327,707,.463,164,399,.411,163,308,.529,127,157,.809,50,322,372,291,103,142,31,228,945,1999/2000
"Barry,Drew",15,33,.455,7,18,.389,8,15,.533,4,5,.800,0,12,12,33,2,13,0,23,41,1999/2000
"Barry,Drew",9,18,.500,3,9,.333,6,9,.667,1,2,.500,0,8,8,17,2,6,0,14,22,1999/2000
"Barry,Drew",6,15,.400,4,9,.444,2,6,.333,3,3,1.000,0,4,4,16,0,7,0,9,19,1999/2000
"Barry,Jon",161,346,.465,66,154,.429,95,192,.495,107,116,.922,38,121,159,150,75,85,7,104,495,1999/2000
"Battie,Tony",219,459,.477,1,8,.125,218,451,.483,102,151,.675,152,258,410,63,47,67,70,249,541,1999/2000
"Bender,Jonathan",23,70,.329,2,12,.167,21,58,.362,16,24,.667,4,17,21,3,1,7,5,18,64,1999/2000
"Benjamin,Benoit",1,3,.333,0,0,,1,3,.333,0,0,,0,1,1,0,0,0,1,1,2,1999/2000
"Benjamin,Corey",145,350,.414,31,89,.348,114,261,.437,49,82,.598,21,67,88,54,31,74,22,122,370,1999/2000
"Bennett,Mario",0,3,.000,0,0,,0,3,.000,0,0,,1,1,2,0,0,0,0,1,0,1999/2000
"Best,Travis",271,561,.483,35,93,.376,236,468,.504,156,190,.821,16,126,142,272,76,107,5,204,733,1999/2000
"Bibby,Mike",459,1031,.445,77,212,.363,382,819,.466,195,250,.780,73,233,306,665,132,247,15,171,1190,1999/2000
"Billups,Chauncey",34,101,.337,7,41,.171,27,60,.450,37,44,.841,8,26,34,39,10,24,2,27,112,1999/2000
"Blaylock,Mookie",327,837,.391,101,301,.336,226,536,.422,67,95,.705,55,215,270,489,146,143,22,122,822,1999/2000
"Blount,Corie",44,89,.494,0,2,.000,44,87,.506,19,33,.576,52,61,113,10,15,28,7,78,107,1999/2000
"Bogues,Muggsy",157,358,.439,17,51,.333,140,307,.456,79,87,.908,25,110,135,299,65,59,4,119,410,1999/2000
"Bohannon,Etdrick",7,13,.538,0,0,,7,13,.538,15,24,.625,13,18,31,5,2,10,6,25,29,1999/2000
"Bohannon,Etdrick",0,0,,0,0,,0,0,,3,4,.750,1,0,1,0,0,2,0,1,3,1999/2000
"Bohannon,Etdrick",7,13,.538,0,0,,7,13,.538,12,20,.600,12,18,30,5,2,8,6,24,26,1999/2000
"Booth,Calvin",16,46,.348,0,0,,16,46,.348,10,14,.714,15,17,32,7,3,6,14,23,42,1999/2000
"Borrell,Lazaro",28,63,.444,0,3,.000,28,60,.467,6,11,.545,14,26,40,10,6,6,3,9,62,1999/2000
"Bowdler,Cal",49,115,.426,0,1,.000,49,114,.430,24,38,.632,22,63,85,14,14,21,9,46,122,1999/2000
"Bowen,Bruce",72,194,.371,27,58,.466,45,136,.331,25,43,.581,27,69,96,34,23,19,15,118,196,1999/2000
"Bowen,Bruce",26,73,.356,1,2,.500,25,71,.352,6,12,.500,14,22,36,16,9,5,5,37,59,1999/2000
"Bowen,Bruce",46,121,.380,26,56,.464,20,65,.308,19,31,.613,13,47,60,18,14,14,10,81,137,1999/2000
"Bowen,Ryan",46,117,.393,1,9,.111,45,108,.417,38,53,.717,75,39,114,20,39,14,13,95,131,1999/2000
"Bowman,Ira",2,2,1.000,0,0,,2,2,1.000,1,2,.500,0,2,2,1,1,1,0,0,5,1999/2000
"Boykins,Earl",56,116,.483,8,20,.400,48,96,.500,18,23,.783,12,14,26,48,12,17,1,23,138,1999/2000
"Boykins,Earl",3,4,.750,0,0,,3,4,.750,0,0,,1,0,1,3,0,0,0,0,6,1999/2000
"Boykins,Earl",53,112,.473,8,20,.400,45,92,.489,18,23,.783,11,14,25,45,12,17,1,23,132,1999/2000
"Bradley,Shawn",266,555,.479,1,5,.200,265,550,.482,114,149,.765,160,337,497,60,71,74,190,260,647,1999/2000
"Bramlett,A.J.",4,21,.190,0,0,,4,21,.190,0,0,,12,10,22,0,1,3,0,13,8,1999/2000
"Brand,Elton",630,1306,.482,0,2,.000,630,1304,.483,367,536,.685,348,462,810,155,66,228,132,259,1627,1999/2000
"Brandon,Terrell",486,1042,.466,53,132,.402,433,910,.476,187,208,.899,44,194,238,629,134,184,30,158,1212,1999/2000
"Brown,Chucky",148,328,.451,2,10,.200,146,318,.459,36,52,.692,35,132,167,66,20,45,18,114,334,1999/2000
"Brown,Chucky",82,176,.466,1,3,.333,81,173,.468,25,31,.806,11,66,77,41,8,28,10,53,190,1999/2000
"Brown,Chucky",66,152,.434,1,7,.143,65,145,.448,11,21,.524,24,66,90,25,12,17,8,61,144,1999/2000
"Brown,Dee",93,258,.360,67,187,.358,26,71,.366,11,16,.688,9,45,54,86,24,39,5,62,264,1999/2000
"Brown,Marcus",4,14,.286,0,7,.000,4,7,.571,2,2,1.000,3,4,7,3,0,3,0,8,10,1999/2000
"Brown,P.J.",322,671,.480,0,1,.000,322,670,.481,120,159,.755,216,384,600,145,65,100,61,264,764,1999/2000
"Brown,Randy",157,435,.361,3,6,.500,154,429,.359,62,84,.738,23,121,144,202,61,105,15,120,379,1999/2000
"Brunson,Rick",29,70,.414,2,13,.154,27,57,.474,11,18,.611,3,24,27,49,9,31,1,35,71,1999/2000
"Bryant,Kobe",554,1183,.468,46,144,.319,508,1039,.489,331,403,.821,108,308,416,323,106,182,62,220,1485,1999/2000
"Bryant,Mark",174,346,.503,0,0,,174,346,.503,76,94,.809,126,226,352,61,31,87,31,250,424,1999/2000
"Buckner,Greg",111,233,.476,10,26,.385,101,207,.488,43,63,.683,56,118,174,55,38,36,20,148,275,1999/2000
"Buechler,Jud",55,156,.353,18,83,.217,37,73,.507,2,7,.286,30,61,91,33,25,13,16,50,130,1999/2000
"Buford,Rodney",62,151,.411,7,29,.241,55,122,.451,16,22,.727,10,38,48,21,10,9,8,44,147,1999/2000
"Bullard,Matt",139,340,.409,79,177,.446,60,163,.368,25,30,.833,13,125,138,63,19,36,13,85,382,1999/2000
"Burrell,Scott",165,419,.394,82,232,.353,83,187,.444,39,50,.780,65,191,256,72,67,38,44,173,451,1999/2000
"Caffey,Jason",323,675,.479,0,2,.000,323,673,.480,206,345,.597,189,293,482,119,62,170,20,269,852,1999/2000
"Cage,Michael",12,24,.500,0,0,,12,24,.500,3,3,1.000,33,48,81,9,8,4,8,30,27,1999/2000
"Camby,Marcus",226,471,.480,1,2,.500,225,469,.480,148,221,.670,174,287,461,49,43,72,116,204,601,1999/2000
"Campbell,Elden",370,829,.446,0,6,.000,370,823,.450,247,358,.690,168,422,590,129,56,127,150,269,987,1999/2000
"Carr,Antoine",28,64,.438,0,0,,28,64,.438,11,14,.786,8,24,32,7,3,9,6,42,67,1999/2000
"Carr,Chris",196,496,.395,32,101,.317,164,395,.415,107,125,.856,41,132,173,84,30,117,15,113,531,1999/2000
"Carr,Chris",11,33,.333,1,8,.125,10,25,.400,16,19,.842,5,8,13,3,0,5,1,12,39,1999/2000
"Carr,Chris",185,463,.400,31,93,.333,154,370,.416,91,106,.858,36,124,160,81,30,112,14,101,492,1999/2000
"Carter,Anthony",201,509,.395,3,23,.130,198,486,.407,93,124,.750,48,151,199,378,93,173,5,167,498,1999/2000
"Carter,Vince",788,1696,.465,95,236,.403,693,1460,.475,436,551,.791,150,326,476,322,110,178,92,263,2107,1999/2000
"Cassell,Sam",545,1170,.466,26,90,.289,519,1080,.481,390,445,.876,69,232,301,729,102,267,8,255,1506,1999/2000
"Cato,Kelvin",216,402,.537,0,4,.000,216,398,.543,135,208,.649,102,287,389,26,33,71,124,175,567,1999/2000
"Causwell,Duane",20,37,.541,0,0,,20,37,.541,26,38,.684,11,36,47,2,2,10,16,42,66,1999/2000
"Ceballos,Cedric",447,1002,.446,44,134,.328,403,868,.464,209,248,.843,172,290,462,90,56,125,24,165,1147,1999/2000
"Celestand,John",15,45,.333,2,9,.222,13,36,.361,5,6,.833,1,10,11,20,7,16,0,22,37,1999/2000
"Chapman,Rex",124,320,.388,41,123,.333,83,197,.421,59,78,.756,10,70,80,62,22,38,1,70,348,1999/2000
"Cheaney,Calbert",120,273,.440,18,54,.333,102,219,.466,9,21,.429,23,115,138,80,44,46,14,158,267,1999/2000
"Chilcutt,Pete",53,127,.417,6,26,.231,47,101,.465,8,8,1.000,46,85,131,27,15,20,10,73,120,1999/2000
"Chilcutt,Pete",22,62,.355,1,10,.100,21,52,.404,2,2,1.000,15,28,43,10,5,9,4,31,47,1999/2000
"Chilcutt,Pete",0,2,.000,0,0,,0,2,.000,0,0,,4,5,9,1,0,0,0,3,0,1999/2000
"Chilcutt,Pete",31,63,.492,5,16,.313,26,47,.553,6,6,1.000,27,52,79,16,10,11,6,39,73,1999/2000
"Childs,Chris",146,357,.409,37,104,.356,109,253,.431,47,59,.797,17,130,147,285,36,105,4,240,376,1999/2000
"Christie,Doug",311,764,.407,99,275,.360,212,489,.434,182,216,.843,63,222,285,321,102,144,43,167,903,1999/2000
"Clark,Keon",286,528,.542,1,8,.125,285,520,.548,121,176,.688,162,343,505,71,45,125,114,231,694,1999/2000
"Closs,Keith",96,197,.487,0,3,.000,96,194,.495,46,78,.590,65,114,179,25,13,34,73,80,238,1999/2000
"Coleman,Derrick",446,979,.456,51,141,.362,395,838,.471,296,377,.785,124,508,632,175,34,173,130,195,1239,1999/2000
"Coles,Bimbo",276,607,.455,8,39,.205,268,568,.472,85,104,.817,30,142,172,290,58,103,11,178,645,1999/2000
"Conlon,Marty",1,2,.500,0,0,,1,2,.500,0,0,,1,1,2,0,0,0,0,1,2,1999/2000
"Corbin,Tyrone",88,247,.356,10,44,.227,78,203,.384,33,39,.846,40,125,165,60,36,29,5,99,219,1999/2000
"Crawford,Chris",91,229,.397,7,27,.259,84,202,.416,63,81,.778,51,48,99,33,17,37,16,83,252,1999/2000
"Croshere,Austin",288,653,.441,63,174,.362,225,479,.470,196,231,.848,135,381,516,89,44,121,60,203,835,1999/2000
"Crotty,John",106,251,.422,33,80,.413,73,171,.427,80,93,.860,17,58,75,128,27,54,5,104,325,1999/2000
"Cummings,Terry",76,177,.429,0,0,,76,177,.429,32,39,.821,45,62,107,21,13,27,8,74,184,1999/2000
"Cummings,Vonteego",265,655,.405,49,151,.325,216,504,.429,127,169,.751,57,127,184,247,91,132,13,174,706,1999/2000
"Curley,Bill",29,68,.426,0,1,.000,29,67,.433,18,25,.720,18,32,50,14,13,21,4,61,76,1999/2000
"Curley,Bill",6,11,.545,0,0,,6,11,.545,0,0,,4,4,8,0,2,4,0,10,12,1999/2000
"Curley,Bill",23,57,.404,0,1,.000,23,56,.411,18,25,.720,14,28,42,14,11,17,4,51,64,1999/2000
"Curry,Dell",194,454,.427,95,242,.393,99,212,.467,24,32,.750,11,89,100,89,32,40,9,66,507,1999/2000
"Curry,Michael",182,379,.480,1,5,.200,181,374,.484,141,168,.839,21,83,104,87,33,73,5,209,506,1999/2000
"Dampier,Erick",70,173,.405,0,0,,70,173,.405,27,51,.529,48,86,134,19,8,29,15,75,167,1999/2000
"Daniels,Antonio",163,344,.474,22,66,.333,141,278,.507,72,101,.713,16,70,86,177,55,58,5,73,420,1999/2000
"Dávid,Kornél",67,157,.427,0,3,.000,67,154,.435,45,56,.804,26,55,81,17,17,33,3,56,179,1999/2000
"Dávid,Kornél",63,148,.426,0,3,.000,63,145,.434,42,52,.808,22,51,73,16,13,31,2,49,168,1999/2000
"Dávid,Kornél",4,9,.444,0,0,,4,9,.444,3,4,.750,4,4,8,1,4,2,1,7,11,1999/2000
"Davis,Antonio",313,712,.440,0,0,,313,712,.440,284,371,.765,235,461,696,105,38,121,100,267,910,1999/2000
"Davis,Baron",182,433,.420,25,111,.225,157,322,.488,97,153,.634,48,117,165,309,97,140,19,201,486,1999/2000
"Davis,Ben",2,6,.333,0,0,,2,6,.333,0,0,,3,6,9,2,1,3,1,2,4,1999/2000
"Davis,Dale",302,602,.502,0,0,,302,602,.502,139,203,.685,256,473,729,64,52,91,94,203,743,1999/2000
"Davis,Emanual",80,220,.364,31,103,.301,49,117,.419,26,38,.684,15,85,100,70,38,44,5,72,217,1999/2000
"Davis,Hubert",217,464,.468,82,167,.491,135,297,.455,67,77,.870,17,117,134,141,24,70,3,109,583,1999/2000
"Davis,Mark",56,137,.409,0,2,.000,56,135,.415,31,47,.660,31,53,84,38,25,40,4,52,143,1999/2000
"Davis,Ricky",94,187,.503,0,4,.000,94,183,.514,39,51,.765,29,54,83,62,30,46,8,39,227,1999/2000
"Day,Todd",130,330,.394,64,165,.388,66,165,.400,72,108,.667,31,98,129,65,44,50,22,127,396,1999/2000
"DeClercq,Andrew",225,443,.508,0,0,,225,443,.508,94,160,.588,156,283,439,58,63,108,66,275,544,1999/2000
"Del Negro,Vinny",153,325,.471,8,24,.333,145,301,.482,35,39,.897,9,98,107,160,36,48,0,81,349,1999/2000
"Delk,Tony",120,279,.430,9,40,.225,111,239,.464,47,59,.797,36,52,88,55,35,32,5,58,296,1999/2000
"Dial,Derrick",17,46,.370,3,12,.250,14,34,.412,3,5,.600,14,12,26,5,1,6,1,10,40,1999/2000
"Dickerson,Michael",554,1270,.436,119,291,.409,435,979,.444,269,324,.830,78,201,279,208,116,165,45,226,1496,1999/2000
"Divac,Vlade",384,764,.503,7,26,.269,377,738,.511,230,333,.691,174,482,656,244,103,190,103,251,1005,1999/2000
"Doleac,Michael",242,535,.452,1,2,.500,241,533,.452,80,95,.842,89,245,334,63,29,65,34,224,565,1999/2000
"Douglas,Sherman",45,90,.500,5,16,.313,40,74,.541,25,28,.893,13,16,29,34,17,24,0,26,120,1999/2000
"Drew,Bryce",158,413,.383,59,163,.362,99,250,.396,45,53,.849,23,80,103,162,41,66,1,79,420,1999/2000
"Dudley,Chris",23,67,.343,0,0,,23,67,.343,9,27,.333,63,73,136,5,7,18,21,95,55,1999/2000
"Duncan,Tim",628,1281,.490,1,11,.091,627,1270,.494,459,603,.761,262,656,918,234,66,242,165,210,1716,1999/2000
"Eisley,Howard",282,675,.418,60,163,.368,222,512,.434,84,102,.824,23,147,170,347,59,132,9,223,708,1999/2000
"Ekezie,Obinna",41,88,.466,0,0,,41,88,.466,43,64,.672,34,58,92,8,9,26,4,61,125,1999/2000
"Elie,Mario",195,457,.427,74,186,.398,121,271,.446,126,149,.846,48,201,249,193,73,130,9,156,590,1999/2000
"Elliott,Sean",38,106,.358,13,37,.351,25,69,.362,25,32,.781,6,41,47,28,12,19,2,34,114,1999/2000
"Ellis,Dale",66,159,.415,37,100,.370,29,59,.492,9,13,.692,13,43,56,14,13,20,0,45,178,1999/2000
"Ellis,Dale",47,101,.465,23,65,.354,24,36,.667,6,9,.667,7,27,34,6,6,7,0,23,123,1999/2000
"Ellis,Dale",19,58,.328,14,35,.400,5,23,.217,3,4,.750,6,16,22,8,7,13,0,22,55,1999/2000
"Ellis,LaPhonso",209,464,.450,3,21,.143,206,443,.465,66,95,.695,98,192,290,59,32,52,25,133,487,1999/2000
"Ellison,Pervis",19,43,.442,0,0,,19,43,.442,15,21,.714,29,38,67,13,10,13,8,67,53,1999/2000
"Eschmeyer,Evan",38,72,.528,0,0,,38,72,.528,15,30,.500,40,68,108,21,8,21,21,84,91,1999/2000
"Ewing,Patrick",361,775,.466,0,2,.000,361,773,.467,207,283,.731,140,464,604,58,36,142,84,196,929,1999/2000
"Farmer,Tony",127,312,.407,8,44,.182,119,268,.444,203,265,.766,118,177,295,74,66,82,16,167,465,1999/2000
"Feick,Jamie",181,423,.428,3,3,1.000,178,420,.424,94,133,.707,264,491,755,68,43,59,38,206,459,1999/2000
"Ferry,Danny",189,380,.497,33,75,.440,156,305,.511,52,57,.912,55,183,238,67,22,55,24,181,463,1999/2000
"Finley,Michael",748,1636,.457,99,247,.401,649,1389,.467,260,317,.820,122,396,518,438,109,196,32,171,1855,1999/2000
"Fisher,Derek",167,483,.346,52,166,.313,115,317,.363,105,145,.724,22,121,143,216,80,75,3,150,491,1999/2000
"Fortson,Danny",140,265,.528,0,0,,140,265,.528,139,189,.735,141,225,366,29,20,67,5,180,419,1999/2000
"Foster,Greg",91,224,.406,3,15,.200,88,209,.421,18,28,.643,16,91,107,41,10,28,18,105,203,1999/2000
"Foster,Jeff",13,23,.565,0,1,.000,13,22,.591,17,25,.680,12,20,32,5,5,2,1,18,43,1999/2000
"Fox,Rick",206,498,.414,59,181,.326,147,317,.464,63,78,.808,63,135,198,138,52,87,26,203,534,1999/2000
"Foyle,Adonal",193,380,.508,0,0,,193,380,.508,34,90,.378,174,250,424,42,26,71,136,218,420,1999/2000
"Francis,Steve",497,1117,.445,107,310,.345,390,807,.483,287,365,.786,152,257,409,507,118,306,29,231,1388,1999/2000
"Fuller,Todd",51,122,.418,0,0,,51,122,.418,32,53,.604,36,74,110,5,9,27,8,46,134,1999/2000
"Funderburke,Lawrence",184,352,.523,0,2,.000,184,350,.526,115,163,.706,98,136,234,33,32,40,20,91,483,1999/2000
"Garnett,Kevin",759,1526,.497,30,81,.370,729,1445,.504,309,404,.765,223,733,956,401,120,268,126,205,1857,1999/2000
"Garrett,Dean",48,108,.444,0,0,,48,108,.444,18,26,.692,41,99,140,19,8,21,40,94,114,1999/2000
"Garris,Kiwane",2,10,.200,0,1,.000,2,9,.222,0,0,,0,1,1,2,0,1,0,0,4,1999/2000
"Garrity,Pat",258,585,.441,79,197,.401,179,388,.461,80,111,.721,44,166,210,58,31,85,19,197,675,1999/2000
"Gatling,Chris",365,802,.455,18,70,.257,347,732,.474,266,373,.713,154,348,502,71,82,169,23,246,1014,1999/2000
"Gatling,Chris",210,462,.455,7,23,.304,203,439,.462,171,245,.698,91,206,297,40,48,105,10,142,598,1999/2000
"Gatling,Chris",155,340,.456,11,47,.234,144,293,.491,95,128,.742,63,142,205,31,34,64,13,104,416,1999/2000
"Geiger,Matt",260,589,.441,0,4,.000,260,585,.444,109,140,.779,154,233,387,39,29,91,22,194,629,1999/2000
"George,Devean",56,144,.389,16,47,.340,40,97,.412,27,41,.659,29,46,75,12,10,21,4,54,155,1999/2000
"Gill,Kendall",396,956,.414,20,78,.256,376,878,.428,181,255,.710,82,201,283,210,139,89,41,211,993,1999/2000
"Gilliam,Armen",133,305,.436,0,1,.000,133,304,.438,67,86,.779,72,137,209,42,12,55,16,83,333,1999/2000
"Glover,Dion",66,171,.386,12,45,.267,54,126,.429,51,70,.729,15,23,38,27,15,28,4,28,195,1999/2000
"Grant,Brian",173,352,.491,1,2,.500,172,350,.491,112,166,.675,121,223,344,64,32,84,28,166,459,1999/2000
"Grant,Gary",6,14,.429,0,0,,6,14,.429,0,0,,0,3,3,1,1,2,0,3,12,1999/2000
"Grant,Horace",266,599,.444,0,4,.000,266,595,.447,80,111,.721,167,424,591,188,55,61,60,192,612,1999/2000
"Gray,Devin",15,37,.405,0,0,,15,37,.405,19,29,.655,11,14,25,5,5,4,3,22,49,1999/2000
"Green,A.C.",173,387,.447,1,4,.250,172,383,.449,66,95,.695,160,326,486,80,53,53,18,127,413,1999/2000
"Griffin,Adrian",175,413,.424,16,57,.281,159,356,.447,119,158,.753,128,244,372,177,116,93,15,222,485,1999/2000
"Gugliotta,Tom",310,645,.481,1,8,.125,309,637,.485,117,151,.775,141,284,425,124,80,106,31,152,738,1999/2000
"Ham,Darvin",71,128,.555,0,1,.000,71,127,.559,35,78,.449,85,87,172,42,29,29,29,102,177,1999/2000
"Hamilton,Richard",254,605,.420,28,77,.364,226,528,.428,103,133,.774,38,91,129,108,28,84,6,142,639,1999/2000
"Hamilton,Thomas",35,79,.443,0,0,,35,79,.443,12,23,.522,31,59,90,15,4,28,14,25,82,1999/2000
"Hammonds,Tom",42,97,.433,0,0,,42,97,.433,33,56,.589,34,67,101,10,8,21,3,55,117,1999/2000
"Hardaway,Anfernee",378,798,.474,33,102,.324,345,696,.496,226,286,.790,91,256,347,315,94,153,38,164,1015,1999/2000
"Hardaway,Tim",246,638,.386,94,256,.367,152,382,.398,110,133,.827,25,125,150,385,49,119,4,112,696,1999/2000
"Harper,Ron",212,531,.399,33,106,.311,179,425,.421,100,147,.680,96,241,337,270,85,132,39,164,557,1999/2000
"Harpring,Matt",4,17,.235,2,2,1.000,2,15,.133,6,7,.857,5,7,12,8,5,1,1,7,16,1999/2000
"Harrington,Al",121,264,.458,8,34,.235,113,230,.491,78,111,.703,47,112,159,38,25,65,9,130,328,1999/2000
"Harrington,Othella",420,830,.506,0,2,.000,420,828,.507,236,298,.792,196,367,563,97,36,217,58,287,1076,1999/2000
"Harris,Lucious",198,463,.428,38,115,.330,160,348,.460,79,99,.798,53,134,187,100,65,42,6,98,513,1999/2000
"Harvey,Antonio",17,30,.567,0,0,,17,30,.567,7,12,.583,8,25,33,5,1,12,6,20,41,1999/2000
"Hawkins,Hersey",159,375,.424,55,141,.390,104,234,.444,107,119,.899,31,144,175,134,74,100,15,146,480,1999/2000
"Hawkins,Michael",3,13,.231,1,5,.200,2,8,.250,1,2,.500,0,7,7,13,0,3,0,2,8,1999/2000
"Henderson,Alan",429,930,.461,1,10,.100,428,920,.465,224,334,.671,265,306,571,77,81,139,54,233,1083,1999/2000
"Henderson,Cedric",129,326,.396,1,15,.067,128,311,.412,69,104,.663,34,106,140,55,39,68,17,99,328,1999/2000
"Hendrickson,Mark",5,8,.625,0,0,,5,8,.625,3,4,.750,3,10,13,6,2,3,1,8,13,1999/2000
"Hendrickson,Mark",5,7,.714,0,0,,5,7,.714,2,2,1.000,2,9,11,3,2,3,1,7,12,1999/2000
"Hendrickson,Mark",0,1,.000,0,0,,0,1,.000,1,2,.500,1,1,2,3,0,0,0,1,1,1999/2000
"Herren,Chris",45,124,.363,24,67,.358,21,57,.368,27,40,.675,12,40,52,111,15,42,2,74,141,1999/2000
"Hill,Grant",696,1422,.489,34,98,.347,662,1324,.500,480,604,.795,97,393,490,385,103,240,43,190,1906,1999/2000
"Hill,Tyrone",318,656,.485,0,1,.000,318,655,.485,179,259,.691,220,405,625,52,64,124,27,243,815,1999/2000
"Hoiberg,Fred",89,230,.387,32,94,.340,57,136,.419,69,76,.908,7,103,110,85,40,43,2,66,279,1999/2000
"Hood,Derek",0,3,.000,0,0,,0,3,.000,0,0,,0,1,1,0,0,0,0,0,0,1999/2000
"Hornacek,Jeff",358,728,.492,66,138,.478,292,590,.495,171,180,.950,49,133,182,202,66,113,16,149,953,1999/2000
"Horry,Robert",159,363,.438,29,94,.309,130,269,.483,89,113,.788,133,228,361,118,84,73,80,189,436,1999/2000
"Houston,Allan",614,1271,.483,106,243,.436,508,1028,.494,280,334,.838,38,233,271,224,65,186,14,219,1614,1999/2000
"Howard,Juwan",509,1108,.459,0,7,.000,509,1101,.462,202,275,.735,132,338,470,247,67,225,21,299,1220,1999/2000
"Hudson,Troy",204,541,.377,60,193,.311,144,348,.414,77,95,.811,28,120,148,242,43,108,0,65,545,1999/2000
"Hughes,Larry",459,1147,.400,29,125,.232,430,1022,.421,279,377,.740,113,236,349,205,115,195,28,191,1226,1999/2000
"Hughes,Larry",192,461,.416,11,51,.216,181,410,.441,106,142,.746,52,107,159,75,54,95,12,94,501,1999/2000
"Hughes,Larry",267,686,.389,18,74,.243,249,612,.407,173,235,.736,61,129,190,130,61,100,16,97,725,1999/2000
"Hughes,Rick",35,72,.486,0,1,.000,35,71,.493,12,26,.462,24,25,49,9,3,14,1,30,82,1999/2000
"Hunter,Lindsey",379,892,.425,168,389,.432,211,503,.419,117,154,.760,35,215,250,327,129,145,22,216,1043,1999/2000
"Iverson,Allen",729,1733,.421,89,261,.341,640,1472,.435,442,620,.713,71,196,267,328,144,230,5,162,1989,1999/2000
"Jackson,Bobby",140,346,.405,13,46,.283,127,300,.423,76,98,.776,50,103,153,172,48,58,7,114,369,1999/2000
"Jackson,Jaren",186,488,.381,108,306,.353,78,182,.429,33,51,.647,34,147,181,118,54,66,7,157,513,1999/2000
"Jackson,Jermaine",1,11,.091,0,1,.000,1,10,.100,5,8,.625,1,10,11,4,3,7,0,7,7,1999/2000
"Jackson,Jim",507,1235,.411,117,303,.386,390,932,.418,186,212,.877,101,293,394,230,57,185,10,167,1317,1999/2000
"Jackson,Mark",246,570,.432,89,221,.403,157,349,.450,79,98,.806,63,233,296,650,76,174,10,111,660,1999/2000
"Jackson,Randell",0,0,,0,0,,0,0,,0,0,,0,0,0,0,0,0,0,0,0,1999/2000
"Jacobson,Sam",108,212,.509,9,24,.375,99,188,.527,30,41,.732,25,46,71,32,30,33,3,113,255,1999/2000
"Jacobson,Sam",5,9,.556,0,0,,5,9,.556,0,2,.000,0,1,1,2,1,2,0,1,10,1999/2000
"Jacobson,Sam",103,203,.507,9,24,.375,94,179,.525,30,39,.769,25,45,70,30,29,31,3,112,245,1999/2000
"James,Tim",5,14,.357,0,0,,5,14,.357,1,3,.333,3,1,4,2,0,2,3,1,11,1999/2000
"Jamison,Antawn",356,756,.471,2,7,.286,354,749,.473,127,208,.611,172,187,359,90,30,113,15,115,841,1999/2000
"Jamison,Harold",7,20,.350,0,0,,7,20,.350,4,18,.222,16,5,21,4,2,4,1,17,18,1999/2000
"Johnson,Anthony",62,164,.378,2,11,.182,60,153,.392,28,39,.718,21,30,51,72,33,32,4,58,154,1999/2000
"Johnson,Anthony",36,103,.350,1,6,.167,35,97,.361,19,24,.792,15,24,39,59,23,24,2,41,92,1999/2000
"Johnson,Anthony",26,61,.426,1,5,.200,25,56,.446,9,15,.600,6,6,12,13,10,8,2,17,62,1999/2000
"Johnson,Avery",402,850,.473,1,9,.111,401,841,.477,114,155,.735,33,125,158,491,76,140,18,150,919,1999/2000
"Johnson,DeMarco",3,9,.333,0,0,,3,9,.333,0,0,,3,4,7,0,1,3,0,5,6,1999/2000
"Johnson,Ervin",144,279,.516,0,1,.000,144,278,.518,95,157,.605,233,415,648,44,81,80,127,298,383,1999/2000
"Johnson,Kevin",16,28,.571,1,1,1.000,15,27,.556,7,7,1.000,0,16,16,24,2,7,0,6,40,1999/2000
"Johnson,Larry",282,652,.433,58,174,.333,224,478,.469,128,167,.766,87,293,380,175,42,94,7,205,750,1999/2000
"Jones,Charles",66,201,.328,39,118,.331,27,83,.325,17,23,.739,17,45,62,94,30,28,5,46,188,1999/2000
"Jones,Damon",80,208,.385,41,114,.360,39,94,.415,32,48,.667,12,43,55,96,18,40,1,34,233,1999/2000
"Jones,Damon",25,54,.463,11,23,.478,14,31,.452,7,9,.778,0,16,16,39,6,15,0,13,68,1999/2000
"Jones,Damon",55,154,.357,30,91,.330,25,63,.397,25,39,.641,12,27,39,57,12,25,1,21,165,1999/2000
"Jones,Eddie",478,1119,.427,128,341,.375,350,778,.450,362,419,.864,81,262,343,305,192,160,49,176,1446,1999/2000
"Jones,Jumaine",22,58,.379,2,4,.500,20,54,.370,11,18,.611,16,22,38,5,6,14,5,10,57,1999/2000
"Jones,Popeye",44,104,.423,2,3,.667,42,101,.416,14,19,.737,41,62,103,19,3,13,6,50,104,1999/2000
"Jordan,Reggie",17,53,.321,0,1,.000,17,52,.327,7,13,.538,16,25,41,32,12,19,2,29,41,1999/2000
"Keefe,Adam",53,130,.408,0,1,.000,53,129,.411,29,36,.806,45,91,136,34,17,46,13,90,135,1999/2000
"Kemp,Shawn",484,1160,.417,2,6,.333,482,1154,.418,493,635,.776,231,494,725,138,100,291,96,371,1463,1999/2000
"Kerr,Steve",32,74,.432,16,31,.516,16,43,.372,9,11,.818,3,16,19,12,4,7,0,14,89,1999/2000
"Kersey,Jerome",146,354,.412,0,9,.000,146,345,.423,29,41,.707,58,167,225,69,67,51,47,161,321,1999/2000
"Ketner,Lari",13,32,.406,0,0,,13,32,.406,8,12,.667,12,22,34,1,4,10,3,20,34,1999/2000
"Ketner,Lari",4,10,.400,0,0,,4,10,.400,2,2,1.000,0,7,7,1,1,3,1,8,10,1999/2000
"Ketner,Lari",9,22,.409,0,0,,9,22,.409,6,10,.600,12,15,27,0,3,7,2,12,24,1999/2000
"Kidd,Jason",350,855,.409,56,166,.337,294,689,.427,203,245,.829,96,387,483,678,134,226,28,148,959,1999/2000
"King,Gerard",139,277,.502,0,0,,139,277,.502,49,66,.742,84,166,250,49,34,41,15,132,327,1999/2000
"Kittles,Kerry",305,698,.437,96,240,.400,209,458,.456,101,127,.795,46,179,225,142,79,56,19,120,807,1999/2000
"Kleine,Joe",4,11,.364,0,0,,4,11,.364,3,3,1.000,0,6,6,2,1,2,0,7,11,1999/2000
"Knight,Brevin",230,558,.412,2,10,.200,228,548,.416,140,184,.761,38,155,193,458,107,157,21,185,602,1999/2000
"Knight,Travis",46,118,.390,0,0,,46,118,.390,17,28,.607,46,83,129,23,6,26,23,88,109,1999/2000
"Kukoč,Toni",297,728,.408,44,168,.262,253,560,.452,192,265,.725,75,198,273,265,77,146,28,112,830,1999/2000
"Kukoč,Toni",148,388,.381,18,78,.231,130,310,.419,118,155,.761,37,93,130,124,44,75,19,51,432,1999/2000
"Kukoč,Toni",149,340,.438,26,90,.289,123,250,.492,74,110,.673,38,105,143,141,33,71,9,61,398,1999/2000
"Laettner,Christian",379,801,.473,7,24,.292,372,777,.479,237,292,.812,175,378,553,186,83,186,45,326,1002,1999/2000
"LaFrentz,Raef",392,879,.446,60,183,.328,332,696,.477,162,236,.686,170,471,641,97,42,96,180,292,1006,1999/2000
"Lang,Andrew",28,64,.438,0,0,,28,64,.438,3,7,.429,16,44,60,3,8,5,6,31,59,1999/2000
"Lang,Antonio",1,6,.167,0,0,,1,6,.167,4,5,.800,0,5,5,2,4,2,1,8,6,1999/2000
"Lang,Antonio",0,5,.000,0,0,,0,5,.000,3,4,.750,0,5,5,1,4,2,1,7,3,1999/2000
"Lang,Antonio",1,1,1.000,0,0,,1,1,1.000,1,1,1.000,0,0,0,1,0,0,0,1,3,1999/2000
"Langdon,Trajan",15,40,.375,8,19,.421,7,21,.333,11,11,1.000,4,11,15,11,5,6,0,16,49,1999/2000
"LaRue,Rusty",15,43,.349,2,14,.143,13,29,.448,5,7,.714,1,9,10,11,7,7,0,9,37,1999/2000
"Legler,Tim",28,78,.359,7,21,.333,21,57,.368,14,18,.778,4,19,23,24,4,6,1,33,77,1999/2000
"Lenard,Voshon",228,560,.407,89,228,.390,139,332,.419,84,106,.792,37,116,153,136,41,80,15,127,629,1999/2000
"Lewis,Quincy",111,298,.372,23,63,.365,88,235,.374,38,52,.731,46,67,113,40,24,46,15,158,283,1999/2000
"Lewis,Rashard",275,566,.486,40,120,.333,235,446,.527,84,123,.683,127,209,336,70,62,78,36,163,674,1999/2000
"Livingston,Randy",155,373,.416,19,55,.345,136,318,.428,52,62,.839,25,105,130,170,49,92,13,129,381,1999/2000
"Long,Grant",74,167,.443,0,4,.000,74,163,.454,55,71,.775,86,148,234,43,45,49,10,108,203,1999/2000
"Longley,Luc",186,399,.466,0,0,,186,399,.466,80,97,.825,100,223,323,77,22,136,42,221,452,1999/2000
"López,Felipe",111,261,.425,3,18,.167,108,243,.444,67,109,.615,59,65,124,44,32,53,17,94,292,1999/2000
"Lue,Tyronn",19,39,.487,4,8,.500,15,31,.484,6,8,.750,2,10,12,17,3,9,0,17,48,1999/2000
"Lynch,George",297,644,.461,15,36,.417,282,608,.464,113,183,.617,216,366,582,136,119,120,38,231,722,1999/2000
"MacCulloch,Todd",89,161,.553,0,0,,89,161,.553,28,54,.519,48,98,146,13,11,26,37,94,206,1999/2000
"Mack,Sam",37,122,.303,21,64,.328,16,58,.276,19,20,.950,7,32,39,24,18,19,1,45,114,1999/2000
"MacLean,Don",18,49,.367,2,6,.333,16,43,.372,4,6,.667,6,17,23,8,2,8,1,24,42,1999/2000
"Maggette,Corey",224,469,.478,2,11,.182,222,458,.485,196,261,.751,123,180,303,61,24,138,26,169,646,1999/2000
"Majerle,Dan",170,422,.403,110,304,.362,60,118,.508,56,69,.812,27,306,333,206,89,62,17,156,506,1999/2000
"Malone,Karl",752,1476,.509,2,8,.250,750,1468,.511,589,739,.797,169,610,779,304,79,231,71,229,2095,1999/2000
"Maloney,Matt",114,318,.358,62,174,.356,52,144,.361,37,45,.822,10,54,64,138,32,63,3,42,327,1999/2000
"Manning,Danny",149,339,.440,1,4,.250,148,335,.442,34,52,.654,50,158,208,73,62,55,29,183,333,1999/2000
"Marbury,Stephon",569,1317,.432,66,233,.283,503,1084,.464,436,536,.813,61,179,240,622,112,270,15,195,1640,1999/2000
"Marion,Shawn",222,471,.471,4,22,.182,218,449,.486,72,85,.847,105,227,332,69,38,51,53,113,520,1999/2000
"Marks,Sean",2,6,.333,0,1,.000,2,5,.400,4,4,1.000,0,2,2,0,1,3,1,3,8,1999/2000
"Marshall,Donny",3,11,.273,0,3,.000,3,8,.375,5,6,.833,0,1,1,0,2,3,0,7,11,1999/2000
"Marshall,Donyell",331,840,.394,49,138,.355,282,702,.402,199,255,.780,189,448,637,167,68,123,68,180,910,1999/2000
"Martin,Darrick",133,350,.380,38,124,.306,95,226,.420,98,119,.824,7,37,44,122,28,62,2,89,402,1999/2000
"Mashburn,Jamal",515,1158,.445,112,278,.403,403,880,.458,186,239,.778,64,317,381,298,79,180,14,215,1328,1999/2000
"Mason,Anthony",317,661,.480,0,1,.000,317,660,.480,314,421,.746,145,554,699,367,74,160,29,220,948,1999/2000
"Massenburg,Tony",16,36,.444,0,0,,16,36,.444,14,16,.875,7,20,27,3,2,9,5,13,46,1999/2000
"Maxwell,Vernon",169,490,.345,67,223,.300,102,267,.382,108,148,.730,15,64,79,75,38,53,9,83,513,1999/2000
"McCarty,Walter",78,230,.339,34,110,.309,44,120,.367,39,54,.722,33,77,110,70,24,67,23,83,229,1999/2000
"McCloud,George",266,638,.417,107,283,.378,159,355,.448,148,181,.818,72,213,285,246,48,134,26,180,787,1999/2000
"McCoy,Jelani",102,177,.576,0,0,,102,177,.576,45,91,.495,54,125,179,24,15,45,46,127,249,1999/2000
"McDyess,Antonio",614,1211,.507,0,2,.000,614,1209,.508,323,516,.626,234,451,685,159,69,230,139,316,1551,1999/2000
"McGrady,Tracy",459,1018,.451,18,65,.277,441,953,.463,277,392,.707,188,313,501,263,90,160,151,201,1213,1999/2000
"McIlvaine,Jim",64,154,.416,0,0,,64,154,.416,29,56,.518,106,124,230,36,26,38,117,205,157,1999/2000
"McInnis,Jeff",80,186,.430,7,21,.333,73,165,.442,13,17,.765,18,54,72,89,15,27,2,55,180,1999/2000
"McKey,Derrick",43,108,.398,10,23,.435,33,85,.388,43,56,.768,29,106,135,35,29,19,13,81,139,1999/2000
"McKie,Aaron",244,593,.411,44,121,.364,200,472,.424,121,146,.829,47,199,246,240,108,113,18,194,653,1999/2000
"McLeod,Roshown",131,332,.395,2,13,.154,129,319,.404,54,70,.771,41,97,138,52,16,59,5,84,318,1999/2000
"Mercer,Ron",460,1080,.426,15,48,.313,445,1032,.431,213,270,.789,64,186,250,158,75,151,23,151,1148,1999/2000
"Mercer,Ron",272,612,.444,15,39,.385,257,573,.449,119,151,.788,29,123,152,104,33,87,15,75,678,1999/2000
"Mercer,Ron",188,468,.402,0,9,.000,188,459,.410,94,119,.790,35,63,98,54,42,64,8,76,470,1999/2000
"Miller,Andre",339,755,.449,10,49,.204,329,706,.466,226,292,.774,85,195,280,476,84,166,17,194,914,1999/2000
"Miller,Anthony",52,97,.536,0,0,,52,97,.536,26,51,.510,49,115,164,16,11,19,10,68,130,1999/2000
"Miller,Brad",135,293,.461,0,2,.000,135,291,.464,153,195,.785,113,180,293,45,23,48,35,111,423,1999/2000
"Miller,Oliver",137,233,.588,0,0,,137,233,.588,49,73,.671,87,174,261,68,42,74,80,132,323,1999/2000
"Miller,Reggie",466,1041,.448,165,404,.408,301,637,.473,373,406,.919,50,189,239,187,85,129,25,126,1470,1999/2000
"Mills,Chris",123,292,.421,8,30,.267,115,262,.439,68,84,.810,46,77,123,47,18,25,4,60,322,1999/2000
"Mills,Terry",214,488,.439,95,242,.393,119,246,.484,25,34,.735,50,340,390,85,38,46,24,242,548,1999/2000
"Miskiri,Jason",0,1,.000,0,1,.000,0,0,,0,0,,0,0,0,1,0,0,0,2,0,1999/2000
"Mitchell,Sam",168,376,.447,10,23,.435,158,353,.448,81,92,.880,28,110,138,111,27,44,14,116,427,1999/2000
"Mobley,Cuttino",437,1016,.430,104,292,.356,333,724,.460,299,353,.847,59,229,288,208,87,186,32,171,1277,1999/2000
"Mohammed,Nazr",21,54,.389,0,0,,21,54,.389,12,22,.545,16,34,50,2,4,18,12,29,54,1999/2000
"Montross,Eric",17,55,.309,0,0,,17,55,.309,6,12,.500,18,54,72,7,6,22,9,81,40,1999/2000
"Moore,Mikki",87,140,.621,0,0,,87,140,.621,54,68,.794,44,68,112,17,9,23,31,104,228,1999/2000
"Mourning,Alonzo",652,1184,.551,0,4,.000,652,1180,.553,414,582,.711,215,538,753,123,40,217,294,308,1718,1999/2000
"Mullin,Chris",80,187,.428,45,110,.409,35,77,.455,37,41,.902,14,62,76,37,28,28,9,60,242,1999/2000
"Murdock,Eric",79,205,.385,16,42,.381,63,163,.387,51,80,.638,15,62,77,108,47,58,5,67,225,1999/2000
"Mureșan,Gheorghe",41,90,.456,0,0,,41,90,.456,23,38,.605,24,44,68,9,0,16,12,52,105,1999/2000
"Murray,Lamond",460,1019,.451,51,139,.367,409,880,.465,204,268,.761,127,296,423,132,105,184,36,208,1175,1999/2000
"Murray,Tracy",290,670,.433,113,263,.430,177,407,.435,120,141,.851,63,208,271,72,45,84,24,185,813,1999/2000
"Mutombo,Dikembe",322,573,.562,0,0,,322,573,.562,298,421,.708,304,853,1157,105,27,174,269,248,942,1999/2000
"Nash,Steve",173,363,.477,60,149,.403,113,214,.528,75,85,.882,34,87,121,272,37,102,3,122,481,1999/2000
"Nesby,Tyrone",364,915,.398,94,281,.335,270,634,.426,151,191,.791,82,193,275,121,75,102,31,205,973,1999/2000
"Nesterović,Rasho",206,433,.476,0,2,.000,206,431,.478,59,103,.573,135,244,379,93,21,71,85,262,471,1999/2000
"Newman,Johnny",278,623,.446,72,190,.379,206,433,.476,192,229,.838,39,115,154,65,53,89,11,207,820,1999/2000
"Norris,Moochie",69,159,.434,12,29,.414,57,130,.438,57,73,.781,16,52,68,94,23,30,1,32,207,1999/2000
"Nowitzki,Dirk",515,1118,.461,116,306,.379,399,812,.491,289,348,.830,102,430,532,203,63,141,68,256,1435,1999/2000
"O'Neal,Jermaine",108,222,.486,0,1,.000,108,221,.489,57,98,.582,97,132,229,18,11,47,55,127,273,1999/2000
"O'Neal,Shaquille",956,1665,.574,0,1,.000,956,1664,.575,432,824,.524,336,742,1078,299,36,223,239,255,2344,1999/2000
"Oakley,Charles",234,560,.418,14,41,.341,220,519,.424,66,85,.776,117,423,540,253,102,154,45,294,548,1999/2000
"Odom,Lamar",449,1024,.438,59,164,.360,390,860,.453,302,420,.719,159,436,595,317,91,258,95,291,1259,1999/2000
"Olajuwon,Hakeem",193,421,.458,0,2,.000,193,419,.461,69,112,.616,65,209,274,61,41,73,70,88,455,1999/2000
"Ollie,Kevin",22,49,.449,0,0,,22,49,.449,28,37,.757,4,27,31,46,10,10,0,27,72,1999/2000
"Olowokandi,Michael",330,756,.437,0,0,,330,756,.437,123,189,.651,194,462,656,38,35,177,140,304,783,1999/2000
"Ostertag,Greg",124,267,.464,0,1,.000,124,266,.466,119,187,.636,172,310,482,18,20,79,172,196,367,1999/2000
"Outlaw,Bo",204,339,.602,0,3,.000,204,336,.607,82,162,.506,202,323,525,245,113,133,148,203,490,1999/2000
"Overton,Doug",61,154,.396,10,28,.357,51,126,.405,20,21,.952,14,19,33,53,10,20,0,46,152,1999/2000
"Owens,Billy",150,358,.419,11,34,.324,139,324,.429,63,106,.594,99,202,301,97,33,85,21,166,374,1999/2000
"Owens,Billy",112,258,.434,9,27,.333,103,231,.446,38,64,.594,63,129,192,59,26,61,16,119,271,1999/2000
"Owens,Billy",38,100,.380,2,7,.286,36,93,.387,25,42,.595,36,73,109,38,7,24,5,47,103,1999/2000
"Pack,Robert",96,230,.417,4,11,.364,92,219,.420,63,78,.808,7,35,42,168,31,76,3,44,259,1999/2000
"Padgett,Scott",44,140,.314,13,44,.295,31,96,.323,19,27,.704,24,64,88,25,14,22,8,55,120,1999/2000
"Palacio,Milt",43,98,.439,0,2,.000,43,96,.448,22,37,.595,17,34,51,48,20,44,0,32,108,1999/2000
"Parker,Anthony",24,57,.421,1,14,.071,23,43,.535,8,11,.727,5,22,27,10,8,11,4,13,57,1999/2000
"Parks,Cherokee",72,145,.497,0,1,.000,72,144,.500,24,37,.649,55,128,183,35,29,28,45,115,168,1999/2000
"Patterson,Andrae",3,4,.750,0,0,,3,4,.750,0,0,,1,1,2,1,1,1,0,4,6,1999/2000
"Patterson,Ruben",354,661,.536,12,27,.444,342,634,.539,222,321,.692,218,216,434,126,94,144,40,190,942,1999/2000
"Payton,Gary",747,1666,.448,177,520,.340,570,1146,.497,311,423,.735,100,429,529,732,153,224,18,178,1982,1999/2000
"Peeler,Anthony",316,725,.436,85,255,.333,231,470,.491,87,109,.798,58,174,232,195,62,85,10,171,804,1999/2000
"Perdue,Will",59,168,.351,0,0,,59,168,.351,50,105,.476,88,174,262,65,14,78,42,126,168,1999/2000
"Perkins,Sam",184,441,.417,89,218,.408,95,223,.426,80,97,.825,64,225,289,68,31,63,33,136,537,1999/2000
"Perry,Elliot",128,294,.435,11,39,.282,117,255,.459,50,62,.806,13,48,61,139,39,60,1,47,317,1999/2000
"Person,Chuck",37,123,.301,24,95,.253,13,28,.464,4,8,.500,6,47,53,22,5,12,2,56,102,1999/2000
"Person,Wesley",280,654,.428,106,250,.424,174,404,.431,61,77,.792,44,223,267,146,40,60,19,119,727,1999/2000
"Phills,Bobby",152,335,.454,30,91,.330,122,244,.500,47,65,.723,17,54,71,79,41,48,8,72,381,1999/2000
"Piatkowski,Eric",238,573,.415,93,243,.383,145,330,.439,85,100,.850,74,148,222,81,44,57,13,140,654,1999/2000
"Pierce,Paul",486,1099,.442,96,280,.343,390,819,.476,359,450,.798,83,313,396,221,152,178,62,237,1427,1999/2000
"Pippen,Scottie",388,860,.451,86,263,.327,302,597,.506,160,223,.717,114,399,513,406,117,208,41,208,1022,1999/2000
"Pollard,Scot",149,283,.527,0,0,,149,283,.527,114,159,.717,168,236,404,43,55,50,59,213,412,1999/2000
"Polynice,Olden",203,398,.510,1,2,.500,202,396,.510,28,90,.311,166,287,453,37,30,70,84,260,435,1999/2000
"Porter,Terry",207,463,.447,90,207,.435,117,256,.457,137,170,.806,24,167,191,221,50,100,9,79,641,1999/2000
"Posey,James",230,536,.429,82,220,.373,148,316,.468,120,150,.800,85,232,317,146,98,95,33,207,662,1999/2000
"Potapenko,Vitaly",307,615,.499,0,1,.000,307,614,.500,109,160,.681,182,317,499,77,41,145,29,239,723,1999/2000
"Price,Brent",41,119,.345,25,68,.368,16,51,.314,34,39,.872,8,29,37,69,17,47,1,63,141,1999/2000
"Profit,Laron",21,59,.356,3,17,.176,18,42,.429,4,10,.400,2,24,26,25,7,19,4,26,49,1999/2000
"Radojević,Aleksandar",2,7,.286,0,0,,2,7,.286,3,6,.500,2,6,8,1,2,5,1,5,7,1999/2000
"Ratliff,Theo",247,491,.503,0,0,,247,491,.503,182,236,.771,140,295,435,36,32,108,171,185,676,1999/2000
"Recasner,Eldridge",3,7,.429,1,4,.250,2,3,.667,0,0,,0,4,4,5,0,0,0,1,7,1999/2000
"Reeves,Bryant",252,562,.448,0,4,.000,252,558,.452,107,165,.648,126,264,390,82,33,119,38,245,611,1999/2000
"Reeves,Khalid",3,12,.250,0,3,.000,3,9,.333,5,5,1.000,2,2,4,13,2,6,0,8,11,1999/2000
"Reid,Don",60,112,.536,0,0,,60,112,.536,24,34,.706,31,71,102,11,24,23,31,118,144,1999/2000
"Reid,Don",16,34,.471,0,0,,16,34,.471,3,6,.500,5,20,25,1,5,11,12,45,35,1999/2000
"Reid,Don",44,78,.564,0,0,,44,78,.564,21,28,.750,26,51,77,10,19,12,19,73,109,1999/2000
"Reid,J.R.",53,127,.417,1,7,.143,52,120,.433,43,56,.768,29,88,117,18,19,20,5,81,150,1999/2000
"Rhodes,Rodrick",0,3,.000,0,0,,0,3,.000,0,0,,1,0,1,0,2,2,0,0,0,1999/2000
"Rice,Glen",421,980,.430,84,229,.367,337,751,.449,346,396,.874,56,271,327,176,47,114,12,179,1272,1999/2000
"Richmond,Mitch",447,1049,.426,93,241,.386,354,808,.438,298,340,.876,37,176,213,185,110,154,13,191,1285,1999/2000
"Rider,Isaiah",449,1072,.419,56,180,.311,393,892,.441,204,260,.785,63,195,258,219,41,168,6,132,1158,1999/2000
"Roberts,Stanley",5,16,.313,0,1,.000,5,15,.333,0,3,.000,6,9,15,3,1,2,1,15,10,1999/2000
"Robertson,Ryan",2,6,.333,0,2,.000,2,4,.500,1,1,1.000,0,0,0,0,0,0,0,0,5,1999/2000
"Robinson,Clifford",530,1142,.464,120,324,.370,410,818,.501,298,381,.782,105,254,359,224,90,166,61,239,1478,1999/2000
"Robinson,David",528,1031,.512,0,2,.000,528,1029,.513,371,511,.726,193,577,770,142,97,164,183,247,1427,1999/2000
"Robinson,Eddie",212,386,.549,0,4,.000,212,382,.555,47,64,.734,54,130,184,32,48,39,25,67,471,1999/2000
"Robinson,Glenn",690,1461,.472,86,237,.363,604,1224,.493,227,283,.802,107,378,485,193,78,223,41,212,1693,1999/2000
"Rodman,Dennis",12,31,.387,0,1,.000,12,30,.400,10,14,.714,48,123,171,14,2,19,1,41,34,1999/2000
"Rogers,Carlos",170,324,.525,1,14,.071,169,310,.545,81,137,.591,98,177,275,42,14,63,34,77,422,1999/2000
"Rogers,Rodney",428,881,.486,115,262,.439,313,619,.506,159,249,.639,138,309,447,170,94,163,47,290,1130,1999/2000
"Rogers,Roy",35,88,.398,0,1,.000,35,87,.402,19,41,.463,33,47,80,9,2,10,38,36,89,1999/2000
"Rooks,Sean",122,283,.431,0,0,,122,283,.431,65,89,.730,82,166,248,68,29,70,52,169,309,1999/2000
"Rose,Jalen",563,1196,.471,77,196,.393,486,1000,.486,254,307,.827,42,345,387,320,84,188,49,234,1457,1999/2000
"Rose,Malik",176,385,.457,1,3,.333,175,382,.458,143,198,.722,133,202,335,47,35,99,52,232,496,1999/2000
"Ruffin,Michael",58,138,.420,0,0,,58,138,.420,43,88,.489,117,133,250,44,26,59,26,170,159,1999/2000
"Russell,Bryon",408,914,.446,106,268,.396,302,646,.467,237,316,.750,99,328,427,158,128,101,23,255,1159,1999/2000
"Sabonis,Arvydas",302,598,.505,7,19,.368,295,579,.509,167,198,.843,97,416,513,118,43,97,78,184,778,1999/2000
"Salley,John",25,69,.362,0,0,,25,69,.362,21,28,.750,20,45,65,26,8,18,14,67,71,1999/2000
"Schrempf,Detlef",187,433,.432,21,52,.404,166,381,.436,179,215,.833,79,253,332,197,37,100,17,182,574,1999/2000
"Scott,Dennis",125,333,.375,71,189,.376,54,144,.375,48,57,.842,16,90,106,69,28,30,9,104,369,1999/2000
"Sealy,Malik",371,780,.476,10,35,.286,361,745,.485,177,218,.812,119,233,352,197,76,110,19,197,929,1999/2000
"Shaw,Brian",123,322,.382,18,58,.310,105,264,.398,41,54,.759,45,171,216,201,35,75,14,105,305,1999/2000
"Simpkins,Dickey",111,274,.405,0,1,.000,111,273,.407,65,120,.542,124,248,372,100,22,128,22,217,287,1999/2000
"Skinner,Brian",68,134,.507,0,0,,68,134,.507,43,65,.662,63,138,201,11,16,37,44,75,179,1999/2000
"Smith,Joe",289,623,.464,1,1,1.000,288,622,.463,195,258,.756,186,298,484,88,45,119,85,302,774,1999/2000
"Smith,Michael",108,192,.563,0,1,.000,108,191,.565,73,101,.723,121,210,331,56,27,45,23,127,289,1999/2000
"Smith,Steve",420,900,.467,96,241,.398,324,659,.492,289,340,.850,123,190,313,209,71,117,31,214,1225,1999/2000
"Smits,Rik",431,890,.484,0,1,.000,431,889,.485,156,211,.739,94,307,401,85,20,108,100,249,1018,1999/2000
"Snow,Eric",257,597,.430,11,45,.244,246,552,.446,126,177,.712,42,219,261,624,140,162,8,243,651,1999/2000
"Spencer,Felton",15,33,.455,0,0,,15,33,.455,20,30,.667,15,24,39,3,6,9,8,32,50,1999/2000
"Sprewell,Latrell",568,1305,.435,44,127,.346,524,1178,.445,344,397,.866,49,300,349,332,109,226,22,184,1524,1999/2000
"Stack,Ryan",17,51,.333,0,1,.000,17,50,.340,18,27,.667,15,30,45,5,4,17,11,47,52,1999/2000
"Stackhouse,Jerry",619,1447,.428,83,288,.288,536,1159,.462,618,758,.815,118,197,315,365,103,311,36,188,1939,1999/2000
"Starks,John",203,542,.375,59,171,.345,144,371,.388,50,59,.847,10,91,101,181,42,67,4,102,515,1999/2000
"Starks,John",192,508,.378,56,161,.348,136,347,.392,45,54,.833,10,81,91,170,37,64,3,93,485,1999/2000
"Starks,John",11,34,.324,3,10,.300,8,24,.333,5,5,1.000,0,10,10,11,5,3,1,9,30,1999/2000
"Stepania,Vladimir",29,79,.367,0,6,.000,29,73,.397,17,36,.472,21,26,47,3,10,22,11,44,75,1999/2000
"Stephens,Joe",19,51,.373,0,8,.000,19,43,.442,3,4,.750,13,23,36,11,7,6,3,9,41,1999/2000
"Stewart,Michael",20,53,.377,0,0,,20,53,.377,18,32,.563,33,61,94,6,5,17,19,81,58,1999/2000
"Stith,Bryant",86,189,.455,17,56,.304,69,133,.519,64,77,.831,23,61,84,61,18,33,12,56,253,1999/2000
"Stockton,John",363,725,.501,43,121,.355,320,604,.530,221,257,.860,45,170,215,703,143,179,15,192,990,1999/2000
"Stojaković,Peja",321,717,.448,100,267,.375,221,450,.491,135,153,.882,74,202,276,106,52,88,7,97,877,1999/2000
"Stoudamire,Damon",386,894,.432,80,212,.377,306,682,.449,122,145,.841,61,182,243,405,77,149,1,173,974,1999/2000
"Strickland,Erick",316,730,.433,73,186,.392,243,544,.447,162,195,.831,69,254,323,211,105,102,13,190,867,1999/2000
"Strickland,Mark",122,224,.545,0,0,,122,224,.545,40,56,.714,44,96,140,22,15,24,18,68,284,1999/2000
"Strickland,Rod",327,762,.429,1,21,.048,326,741,.440,214,305,.702,73,186,259,519,94,187,18,147,869,1999/2000
"Strong,Derek",21,48,.438,1,4,.250,20,44,.455,11,14,.786,11,33,44,4,5,12,2,15,54,1999/2000
"Šundov,Bruno",12,31,.387,0,0,,12,31,.387,2,2,1.000,5,7,12,2,2,4,2,16,26,1999/2000
"Sura,Bob",356,815,.437,122,332,.367,234,483,.484,175,251,.697,50,238,288,284,91,148,19,201,1009,1999/2000
"Szczerbiak,Wally",342,669,.511,28,78,.359,314,591,.531,133,161,.826,89,183,272,201,58,83,23,175,845,1999/2000
"Tabak,Žan",16,34,.471,0,0,,16,34,.471,5,8,.625,16,16,32,4,3,11,9,13,37,1999/2000
"Taylor,Johnny",5,14,.357,1,1,1.000,4,13,.308,0,0,,2,4,6,1,1,2,1,5,11,1999/2000
"Taylor,Johnny",0,2,.000,0,0,,0,2,.000,0,0,,0,1,1,0,0,0,0,1,0,1999/2000
"Taylor,Johnny",5,12,.417,1,1,1.000,4,11,.364,0,0,,2,3,5,1,1,2,1,4,11,1999/2000
"Taylor,Maurice",458,988,.464,1,8,.125,457,980,.466,143,201,.711,96,304,400,101,51,169,48,217,1060,1999/2000
"Terry,Jason",249,600,.415,46,157,.293,203,443,.458,113,140,.807,24,142,166,346,90,156,10,133,657,1999/2000
"Thomas,Jamel",8,18,.444,0,3,.000,8,15,.533,1,1,1.000,1,4,5,6,1,5,0,2,17,1999/2000
"Thomas,Jamel",5,10,.500,0,1,.000,5,9,.556,1,1,1.000,0,2,2,2,0,1,0,0,11,1999/2000
"Thomas,Jamel",3,8,.375,0,2,.000,3,6,.500,0,0,,1,2,3,4,1,4,0,2,6,1999/2000
"Thomas,John",49,107,.458,0,1,.000,49,106,.462,16,41,.390,37,38,75,9,12,14,14,106,114,1999/2000
"Thomas,Kenny",212,531,.399,32,122,.262,180,409,.440,138,209,.660,147,290,437,113,54,112,22,167,594,1999/2000
"Thomas,Kurt",270,535,.505,1,3,.333,269,532,.506,100,128,.781,144,361,505,82,51,105,42,278,641,1999/2000
"Thomas,Tim",347,753,.461,63,182,.346,284,571,.497,188,243,.774,100,232,332,113,59,129,31,227,945,1999/2000
"Thorpe,Otis",125,243,.514,0,3,.000,125,240,.521,29,48,.604,56,110,166,33,26,59,9,136,279,1999/2000
"Traylor,Robert",58,122,.475,0,4,.000,58,118,.492,41,68,.603,50,65,115,20,25,27,25,79,157,1999/2000
"Trent,Gary",70,142,.493,0,2,.000,70,140,.500,11,21,.524,20,32,52,22,8,25,3,28,151,1999/2000
"Türkcan,Mirsad",14,38,.368,0,6,.000,14,32,.438,5,8,.625,13,20,33,5,3,8,1,14,33,1999/2000
"Türkcan,Mirsad",2,10,.200,0,2,.000,2,8,.250,0,0,,2,8,10,1,2,1,0,4,4,1999/2000
"Türkcan,Mirsad",12,28,.429,0,4,.000,12,24,.500,5,8,.625,11,12,23,4,1,7,1,10,29,1999/2000
"Turner,Wayne",1,6,.167,0,0,,1,6,.167,2,6,.333,1,2,3,5,0,3,0,4,4,1999/2000
"Van Exel,Nick",473,1213,.390,133,401,.332,340,812,.419,196,240,.817,34,277,311,714,68,221,11,148,1275,1999/2000
"Van Horn,Keith",559,1257,.445,84,228,.368,475,1029,.462,333,393,.847,200,476,676,158,64,245,60,258,1535,1999/2000
"Vaughn,Jacque",109,262,.416,14,34,.412,95,228,.417,57,76,.750,11,54,65,121,32,77,0,92,289,1999/2000
"Vaught,Loy",32,89,.360,0,3,.000,32,86,.372,11,16,.688,26,65,91,11,6,11,4,45,75,1999/2000
"Vinson,Fred",5,17,.294,2,7,.286,3,10,.300,1,2,.500,0,1,1,0,3,4,0,2,13,1999/2000
"Walker,Antoine",648,1506,.430,73,285,.256,575,1221,.471,311,445,.699,199,453,652,305,117,259,32,263,1680,1999/2000
"Walker,Samaki",137,305,.449,0,0,,137,305,.449,86,126,.683,77,195,272,38,10,64,35,108,360,1999/2000
"Wallace,Ben",168,334,.503,0,0,,168,334,.503,54,114,.474,211,454,665,67,72,67,130,162,390,1999/2000
"Wallace,John",155,332,.467,0,3,.000,155,329,.471,82,102,.804,42,93,135,22,10,63,14,103,392,1999/2000
"Wallace,Rasheed",542,1045,.519,8,50,.160,534,995,.537,233,331,.704,129,437,566,142,87,157,107,216,1325,1999/2000
"Walters,Rex",38,91,.418,5,20,.250,33,71,.465,12,16,.750,8,28,36,65,6,29,0,44,93,1999/2000
"Ward,Charlie",189,447,.423,102,264,.386,87,183,.475,48,58,.828,22,206,228,300,95,102,16,176,528,1999/2000
"Weatherspoon,Clarence",215,419,.513,0,0,,215,419,.513,135,183,.738,128,321,449,93,51,100,49,165,565,1999/2000
"Webber,Chris",748,1548,.483,27,95,.284,721,1453,.496,311,414,.751,189,598,787,345,120,218,128,264,1834,1999/2000
"Wells,Bonzi",236,480,.492,20,53,.377,216,427,.506,88,129,.682,78,104,182,97,69,97,12,153,580,1999/2000
"Wennington,Bill",6,19,.316,0,0,,6,19,.316,2,2,1.000,5,14,19,1,2,1,2,13,14,1999/2000
"Wesley,David",407,955,.426,88,248,.355,319,707,.451,214,275,.778,39,186,225,463,109,159,11,186,1116,1999/2000
"West,Doug",59,145,.407,0,3,.000,59,142,.415,34,40,.850,18,53,71,43,12,19,8,80,152,1999/2000
"West,Mark",5,12,.417,0,0,,5,12,.417,5,8,.625,6,25,31,2,2,6,4,23,15,1999/2000
"White,Jahidi",228,450,.507,0,0,,228,450,.507,113,211,.536,202,351,553,15,31,94,83,234,569,1999/2000
"Whitney,Chris",217,521,.417,96,255,.376,121,266,.455,112,132,.848,20,114,134,313,55,107,5,166,642,1999/2000
"Williams,Aaron",235,450,.522,0,3,.000,235,447,.526,146,201,.726,159,250,409,58,41,80,92,234,616,1999/2000
"Williams,Alvin",114,287,.397,16,55,.291,98,232,.422,48,65,.738,27,58,85,126,34,47,11,78,292,1999/2000
"Williams,Eric",165,386,.427,25,72,.347,140,314,.446,134,169,.793,55,101,156,93,44,66,16,165,489,1999/2000
"Williams,Jason",363,973,.373,145,505,.287,218,468,.466,128,170,.753,22,208,230,589,117,296,8,140,999,1999/2000
"Williams,Jerome",257,456,.564,0,3,.000,257,453,.567,175,284,.616,277,512,789,68,95,105,21,196,689,1999/2000
"Williams,Lorenzo",7,9,.778,0,0,,7,9,.778,0,0,,12,13,25,1,3,3,6,13,14,1999/2000
"Williams,Monty",263,538,.489,2,5,.400,261,533,.490,123,166,.741,96,154,250,106,46,109,17,187,651,1999/2000
"Williams,Scott",213,426,.500,0,0,,213,426,.500,94,129,.729,177,271,448,28,40,65,66,230,520,1999/2000
"Williams,Shammond",84,225,.373,24,81,.296,60,144,.417,33,51,.647,12,40,52,78,18,40,0,39,225,1999/2000
"Williams,Walt",312,681,.458,102,261,.391,210,420,.500,101,123,.821,69,237,306,157,49,113,44,190,827,1999/2000
"Williamson,Corliss",311,622,.500,0,0,,311,622,.500,163,212,.769,122,168,290,82,38,110,19,192,785,1999/2000
"Willis,Kevin",236,569,.415,1,3,.333,235,566,.415,131,164,.799,201,281,482,49,36,98,48,256,604,1999/2000
"Willoughby,Dedric",61,179,.341,29,98,.296,32,81,.395,39,51,.765,11,40,51,66,23,37,2,32,190,1999/2000
"Wingate,David",1,9,.111,0,0,,1,9,.111,0,0,,1,1,2,3,1,2,2,7,2,1999/2000
"Workman,Haywoode",31,90,.344,14,43,.326,17,47,.362,10,15,.667,1,25,26,61,20,18,0,37,86,1999/2000
"Workman,Haywoode",23,62,.371,11,29,.379,12,33,.364,9,13,.692,1,16,17,44,11,14,0,23,66,1999/2000
"Workman,Haywoode",8,28,.286,3,14,.214,5,14,.357,1,2,.500,0,9,9,17,9,4,0,14,20,1999/2000
"World Peace,Metta",309,759,.407,60,191,.314,249,568,.438,188,279,.674,62,246,308,202,119,166,39,159,866,1999/2000
"Wright,Lorenzen",180,361,.499,1,3,.333,179,358,.500,87,135,.644,117,188,305,21,29,66,40,203,448,1999/2000
"Young,Tim",13,39,.333,0,0,,13,39,.333,28,36,.778,13,22,35,5,2,9,1,18,54,1999/2000
"Abdul-Rauf,Mahmoud",120,246,.488,4,14,.286,116,232,.500,22,29,.759,5,20,25,76,9,26,1,50,266,2000/2001
"Abdul-Wahad,Tariq",43,111,.387,4,10,.400,39,101,.386,21,36,.583,14,45,59,22,14,34,13,54,111,2000/2001
"Abdur-Rahim,Shareef",604,1280,.472,12,64,.188,592,1216,.487,443,531,.834,175,560,735,250,90,231,77,238,1663,2000/2001
"Alexander,Cory",18,56,.321,4,16,.250,14,40,.350,12,18,.667,0,25,25,36,16,25,0,29,52,2000/2001
"Alexander,Courtney",239,573,.417,17,46,.370,222,527,.421,123,150,.820,42,101,143,62,45,75,5,139,618,2000/2001
"Alexander,Courtney",62,178,.348,3,10,.300,59,168,.351,33,45,.733,20,43,63,21,16,21,3,76,160,2000/2001
"Alexander,Courtney",177,395,.448,14,36,.389,163,359,.454,90,105,.857,22,58,80,41,29,54,2,63,458,2000/2001
"Allen,Ray",628,1309,.480,202,467,.433,426,842,.506,348,392,.888,101,327,428,374,124,204,20,192,1806,2000/2001
"Alston,Rafer",30,84,.357,8,30,.267,22,54,.407,9,13,.692,4,27,31,68,13,20,0,27,77,2000/2001
"Amaechi,John",237,592,.400,0,7,.000,237,585,.405,176,279,.631,77,191,268,74,28,124,29,175,650,2000/2001
"Anderson,Derek",413,993,.416,101,253,.399,312,740,.422,342,402,.851,75,288,363,301,120,165,14,188,1269,2000/2001
"Anderson,Kenny",88,227,.388,11,33,.333,77,194,.397,59,71,.831,16,57,73,134,44,52,2,62,246,2000/2001
"Anderson,Nick",14,57,.246,10,39,.256,4,18,.222,0,0,,3,22,25,13,10,7,4,13,38,2000/2001
"Anderson,Shandon",263,590,.446,46,170,.271,217,420,.517,138,188,.734,72,261,333,189,82,131,40,202,710,2000/2001
"Anthony,Greg",97,253,.383,65,159,.409,32,94,.340,23,35,.657,21,40,61,82,40,43,3,63,282,2000/2001
"Armstrong,Darrell",413,1002,.412,143,403,.355,270,599,.451,220,249,.884,94,249,343,524,135,200,13,155,1189,2000/2001
"Atkins,Chucky",380,952,.399,121,339,.357,259,613,.423,90,130,.692,28,145,173,330,67,149,5,184,971,2000/2001
"Augmon,Stacey",127,266,.477,0,4,.000,127,262,.485,57,87,.655,60,99,159,98,48,48,21,105,311,2000/2001
"Austin,Isaac",96,270,.356,6,24,.250,90,246,.366,28,40,.700,50,172,222,58,20,54,23,94,226,2000/2001
"Avery,William",55,144,.382,16,59,.271,39,85,.459,28,36,.778,5,24,29,75,13,45,4,48,154,2000/2001
"Bagarić,Dalibor",17,65,.262,0,1,.000,17,64,.266,13,28,.464,22,34,56,10,9,21,16,44,47,2000/2001
"Baker,Vin",347,822,.422,1,16,.063,346,806,.429,232,321,.723,179,251,430,90,38,158,73,264,927,2000/2001
"Barkley,Erick",8,22,.364,3,8,.375,5,14,.357,0,0,,0,3,3,6,2,5,0,2,19,2000/2001
"Barros,Dana",183,412,.444,44,105,.419,139,307,.453,68,80,.850,6,88,94,110,30,60,2,63,478,2000/2001
"Barry,Brent",198,401,.494,109,229,.476,89,172,.517,84,103,.816,33,178,211,225,80,86,14,126,589,2000/2001
"Barry,Jon",103,255,.404,46,132,.348,57,123,.463,64,73,.877,16,78,94,130,28,53,6,66,316,2000/2001
"Battie,Tony",108,201,.537,0,3,.000,108,198,.545,44,69,.638,73,160,233,16,27,37,60,126,260,2000/2001
"Bell,Raja",2,7,.286,1,3,.333,1,4,.250,0,0,,0,1,1,0,1,2,0,1,5,2000/2001
"Bender,Jonathan",66,186,.355,11,41,.268,55,145,.379,50,68,.735,14,60,74,32,7,42,28,73,193,2000/2001
"Benjamin,Corey",115,302,.381,21,81,.259,94,221,.425,56,83,.675,38,62,100,69,28,63,16,128,307,2000/2001
"Benoit,David",71,147,.483,5,13,.385,66,134,.493,31,39,.795,20,61,81,22,6,28,6,75,178,2000/2001
"Best,Travis",347,788,.440,37,97,.381,310,691,.449,187,226,.827,38,184,222,473,110,127,11,246,918,2000/2001
"Bibby,Mike",525,1157,.454,108,285,.379,417,872,.478,143,188,.761,47,257,304,685,107,248,12,148,1301,2000/2001
"Billups,Chauncey",248,587,.422,73,194,.376,175,393,.445,144,171,.842,32,126,158,260,51,111,11,178,713,2000/2001
"Blaylock,Mookie",317,801,.396,73,225,.324,244,576,.424,53,76,.697,71,201,272,462,163,128,20,134,760,2000/2001
"Blount,Corie",130,294,.442,2,8,.250,128,286,.448,51,83,.614,181,219,400,59,42,73,22,165,313,2000/2001
"Blount,Corie",23,47,.489,0,0,,23,47,.489,8,15,.533,35,50,85,8,13,18,5,75,54,2000/2001
"Blount,Corie",107,247,.433,2,8,.250,105,239,.439,43,68,.632,146,169,315,51,29,55,17,90,259,2000/2001
"Blount,Mark",101,200,.505,0,0,,101,200,.505,46,66,.697,97,134,231,32,39,62,76,183,248,2000/2001
"Bogues,Muggsy",0,2,.000,0,1,.000,0,1,.000,0,0,,0,3,3,5,2,4,0,3,0,2000/2001
"Bohannon,Etdrick",2,4,.500,0,0,,2,4,.500,4,4,1.000,3,4,7,0,0,1,2,4,8,2000/2001
"Booth,Calvin",120,252,.476,0,0,,120,252,.476,53,78,.679,77,169,246,42,29,53,111,146,293,2000/2001
"Booth,Calvin",74,168,.440,0,0,,74,168,.440,33,45,.733,53,121,174,23,17,36,81,91,181,2000/2001
"Booth,Calvin",46,84,.548,0,0,,46,84,.548,20,33,.606,24,48,72,19,12,17,30,55,112,2000/2001
"Bowdler,Cal",53,114,.465,1,5,.200,52,109,.477,33,40,.825,30,47,77,4,10,11,21,45,140,2000/2001
"Bowen,Bruce",211,581,.363,103,307,.336,108,274,.394,98,161,.609,45,200,245,132,83,74,53,269,623,2000/2001
"Bowen,Ryan",80,144,.556,4,11,.364,76,133,.571,27,44,.614,62,51,113,30,37,24,12,95,191,2000/2001
"Bowman,Ira",0,2,.000,0,0,,0,2,.000,0,0,,1,1,2,7,0,1,0,0,0,2000/2001
"Boykins,Earl",25,63,.397,1,8,.125,24,55,.436,14,17,.824,4,7,11,32,5,9,0,9,65,2000/2001
"Bradley,Shawn",219,447,.490,1,6,.167,218,441,.494,140,178,.787,160,448,608,38,36,88,228,256,579,2000/2001
"Brand,Elton",578,1215,.476,0,2,.000,578,1213,.477,334,472,.708,285,461,746,240,71,219,118,243,1490,2000/2001
"Brandon,Terrell",511,1134,.451,33,91,.363,478,1043,.458,195,224,.871,60,238,298,583,161,155,21,138,1250,2000/2001
"Brown,Chucky",40,95,.421,0,3,.000,40,92,.435,22,34,.647,8,46,54,11,9,8,7,37,102,2000/2001
"Brown,Chucky",9,20,.450,0,2,.000,9,18,.500,6,10,.600,3,15,18,5,3,2,1,10,24,2000/2001
"Brown,Chucky",31,75,.413,0,1,.000,31,74,.419,16,24,.667,5,31,36,6,6,6,6,27,78,2000/2001
"Brown,Dee",16,44,.364,12,32,.375,4,12,.333,4,5,.800,0,11,11,12,4,7,0,10,48,2000/2001
"Brown,P.J.",249,561,.444,0,4,.000,249,557,.447,178,209,.852,257,485,742,127,78,108,92,260,676,2000/2001
"Brown,Randy",100,237,.422,0,3,.000,100,234,.427,23,40,.575,23,76,99,154,62,56,10,132,223,2000/2001
"Brunson,Rick",18,54,.333,2,14,.143,16,40,.400,8,15,.533,5,16,21,31,8,17,1,21,46,2000/2001
"Brunson,Rick",10,35,.286,2,11,.182,8,24,.333,4,9,.444,2,7,9,24,7,9,1,16,26,2000/2001
"Brunson,Rick",8,19,.421,0,3,.000,8,16,.500,4,6,.667,3,9,12,7,1,8,0,5,20,2000/2001
"Bryant,Kobe",701,1510,.464,61,200,.305,640,1310,.489,475,557,.853,104,295,399,338,114,220,43,222,1938,2000/2001
"Bryant,Mark",8,20,.400,0,0,,8,20,.400,3,5,.600,4,17,21,3,1,5,2,29,19,2000/2001
"Buckner,Greg",84,192,.438,2,7,.286,82,185,.443,59,81,.728,60,97,157,49,33,27,9,118,229,2000/2001
"Buechler,Jud",76,164,.463,32,77,.416,44,87,.506,9,12,.750,20,74,94,39,21,25,10,83,193,2000/2001
"Buford,Rodney",104,241,.432,16,38,.421,88,203,.433,24,29,.828,16,58,74,17,17,29,6,68,248,2000/2001
"Bullard,Matt",129,305,.423,86,213,.404,43,92,.467,10,14,.714,22,108,130,42,10,12,9,76,354,2000/2001
"Burrell,Scott",7,15,.467,2,6,.333,5,9,.556,1,4,.250,1,2,3,1,3,0,0,8,17,2000/2001
"Caffey,Jason",179,367,.488,0,0,,179,367,.488,142,211,.673,135,218,353,53,38,77,25,184,500,2000/2001
"Camby,Marcus",304,580,.524,1,8,.125,303,572,.530,150,225,.667,196,527,723,52,66,63,136,205,759,2000/2001
"Campbell,Elden",367,834,.440,0,6,.000,367,828,.443,288,406,.709,157,451,608,104,60,144,140,280,1022,2000/2001
"Cardinal,Brian",10,31,.323,0,5,.000,10,26,.385,11,18,.611,8,15,23,3,7,9,2,27,31,2000/2001
"Carr,Chris",53,112,.473,17,37,.459,36,75,.480,46,60,.767,11,33,44,11,4,19,3,45,169,2000/2001
"Carter,Anthony",195,480,.406,6,40,.150,189,440,.430,65,103,.631,46,134,180,268,73,119,10,154,461,2000/2001
"Carter,Vince",762,1656,.460,162,397,.408,600,1259,.477,384,502,.765,176,240,416,291,114,167,82,205,2070,2000/2001
"Cassell,Sam",537,1132,.474,30,98,.306,507,1034,.490,277,323,.858,46,244,290,580,88,220,8,214,1381,2000/2001
"Cato,Kelvin",64,111,.577,0,0,,64,111,.577,37,57,.649,47,94,141,11,13,25,31,89,165,2000/2001
"Causwell,Duane",32,85,.376,0,0,,32,85,.376,12,25,.480,23,60,83,5,8,23,18,67,76,2000/2001
"Ceballos,Cedric",101,229,.441,22,73,.301,79,156,.506,37,43,.860,34,72,106,20,16,32,7,61,261,2000/2001
"Ceballos,Cedric",28,71,.394,11,40,.275,17,31,.548,8,10,.800,7,19,26,7,6,9,3,19,75,2000/2001
"Ceballos,Cedric",73,158,.462,11,33,.333,62,125,.496,29,33,.879,27,53,80,13,10,23,4,42,186,2000/2001
"Cheaney,Calbert",10,30,.333,0,0,,10,30,.333,1,2,.500,5,15,20,9,4,5,2,14,21,2000/2001
"Childs,Chris",135,335,.403,32,106,.302,103,229,.450,60,71,.845,24,178,202,355,59,156,15,242,362,2000/2001
"Childs,Chris",93,222,.419,20,64,.313,73,158,.462,39,46,.848,14,124,138,236,37,98,7,160,245,2000/2001
"Childs,Chris",42,113,.372,12,42,.286,30,71,.423,21,25,.840,10,54,64,119,22,58,8,82,117,2000/2001
"Christie,Doug",311,788,.395,94,250,.376,217,538,.403,280,312,.897,95,260,355,289,183,154,45,224,996,2000/2001
"Clark,Keon",249,519,.480,0,1,.000,249,518,.481,142,240,.592,136,298,434,72,32,90,154,244,640,2000/2001
"Clark,Keon",82,199,.412,0,0,,82,199,.412,63,105,.600,58,128,186,34,16,48,44,101,227,2000/2001
"Clark,Keon",167,320,.522,0,1,.000,167,319,.524,79,135,.585,78,170,248,38,16,42,110,143,413,2000/2001
"Cleaves,Mateen",160,400,.400,5,17,.294,155,383,.405,97,137,.708,26,106,132,207,49,139,1,153,422,2000/2001
"Coker,John",1,8,.125,0,0,,1,8,.125,0,0,,3,2,5,2,1,2,0,4,2,2000/2001
"Coleman,Derrick",97,255,.380,20,51,.392,77,204,.377,63,92,.685,46,138,184,39,10,42,21,53,277,2000/2001
"Coles,Bimbo",91,239,.381,2,16,.125,89,223,.399,48,56,.857,9,39,48,138,27,59,6,87,232,2000/2001
"Collier,Jason",27,71,.380,0,1,.000,27,70,.386,17,24,.708,12,25,37,6,2,11,3,27,71,2000/2001
"Colson,Sean",6,24,.250,1,5,.200,5,19,.263,2,4,.500,2,4,6,10,1,2,0,6,15,2000/2001
"Colson,Sean",0,5,.000,0,1,.000,0,4,.000,0,0,,0,3,3,3,0,2,0,0,0,2000/2001
"Colson,Sean",6,19,.316,1,4,.250,5,15,.333,2,4,.500,2,1,3,7,1,0,0,6,15,2000/2001
"Corbin,Tyrone",9,38,.237,0,5,.000,9,33,.273,2,4,.500,3,10,13,4,2,3,0,18,20,2000/2001
"Crawford,Chris",122,270,.452,6,22,.273,116,248,.468,68,83,.819,28,82,110,37,21,62,16,117,318,2000/2001
"Crawford,Jamal",107,304,.352,41,117,.350,66,187,.353,27,34,.794,9,80,89,141,43,85,14,68,282,2000/2001
"Croshere,Austin",276,701,.394,70,207,.338,206,494,.417,200,231,.866,123,264,387,92,36,136,50,180,822,2000/2001
"Crotty,John",22,65,.338,4,7,.571,18,58,.310,17,19,.895,13,15,28,34,6,19,0,32,65,2000/2001
"Cummings,Vonteego",178,517,.344,48,143,.336,130,374,.348,79,116,.681,47,90,137,227,67,91,14,160,483,2000/2001
"Curley,Bill",25,47,.532,1,2,.500,24,45,.533,12,19,.632,21,16,37,3,7,16,9,45,63,2000/2001
"Curley,Bill",1,4,.250,0,1,.000,1,3,.333,1,4,.250,0,0,0,0,1,2,1,4,3,2000/2001
"Curley,Bill",24,43,.558,1,1,1.000,23,42,.548,11,15,.733,21,16,37,3,6,14,8,41,60,2000/2001
"Curry,Dell",162,382,.424,62,145,.428,100,237,.422,43,51,.843,16,69,85,75,27,39,8,66,429,2000/2001
"Curry,Michael",145,319,.455,4,9,.444,141,310,.455,62,73,.849,21,100,121,132,27,61,3,173,356,2000/2001
"Dampier,Erick",126,314,.401,0,2,.000,126,312,.404,67,126,.532,97,153,250,59,17,82,58,123,319,2000/2001
"Daniels,Antonio",275,588,.468,74,183,.404,201,405,.496,121,156,.776,26,137,163,304,61,109,14,120,745,2000/2001
"Dávid,Kornél",25,51,.490,0,0,,25,51,.490,12,13,.923,15,37,52,7,6,11,4,28,62,2000/2001
"Dávid,Kornél",15,29,.517,0,0,,15,29,.517,12,13,.923,9,24,33,4,2,7,3,20,42,2000/2001
"Dávid,Kornél",10,22,.455,0,0,,10,22,.455,0,0,,6,13,19,3,4,4,1,8,20,2000/2001
"Davis,Antonio",375,866,.433,0,1,.000,375,865,.434,319,423,.754,274,513,787,106,22,135,151,230,1069,2000/2001
"Davis,Baron",409,957,.427,85,274,.310,324,683,.474,228,337,.677,129,279,408,598,170,226,36,267,1131,2000/2001
"Davis,Dale",242,487,.497,0,4,.000,242,483,.501,96,152,.632,233,373,606,103,44,67,76,199,580,2000/2001
"Davis,Emanual",133,318,.418,50,127,.394,83,191,.435,45,55,.818,28,126,154,137,64,77,12,101,361,2000/2001
"Davis,Hubert",196,433,.453,78,171,.456,118,262,.450,54,62,.871,28,111,139,110,35,81,1,121,524,2000/2001
"Davis,Hubert",139,314,.443,58,133,.436,81,181,.448,35,41,.854,18,91,109,61,29,56,1,92,371,2000/2001
"Davis,Hubert",57,119,.479,20,38,.526,37,81,.457,19,21,.905,10,20,30,49,6,25,0,29,153,2000/2001
"Davis,Ricky",12,29,.414,1,1,1.000,11,28,.393,7,8,.875,1,6,7,11,5,5,2,7,32,2000/2001
"Davis,Terry",12,25,.480,0,0,,12,25,.480,9,22,.409,24,29,53,7,1,5,1,34,33,2000/2001
"Day,Todd",44,118,.373,26,69,.377,18,49,.367,18,23,.783,10,27,37,28,10,24,7,52,132,2000/2001
"DeClercq,Andrew",107,193,.554,0,0,,107,193,.554,47,82,.573,91,145,236,32,41,51,33,198,261,2000/2001
"Del Negro,Vinny",106,234,.453,1,13,.077,105,221,.475,41,44,.932,12,70,82,126,26,34,3,78,254,2000/2001
"Del Negro,Vinny",30,90,.333,1,9,.111,29,81,.358,16,16,1.000,4,27,31,62,6,15,0,36,77,2000/2001
"Del Negro,Vinny",76,144,.528,0,4,.000,76,140,.543,25,28,.893,8,43,51,64,20,19,3,42,177,2000/2001
"Delk,Tony",383,923,.415,54,168,.321,329,755,.436,185,235,.787,76,185,261,160,75,101,17,171,1005,2000/2001
"Dial,Derrick",36,83,.434,2,10,.200,34,73,.466,12,21,.571,12,26,38,21,4,12,6,22,86,2000/2001
"Dickerson,Michael",425,1020,.417,86,230,.374,339,790,.429,206,270,.763,70,159,229,233,62,162,27,207,1142,2000/2001
"Divac,Vlade",364,755,.482,4,14,.286,360,741,.486,242,350,.691,207,466,673,231,87,192,93,242,974,2000/2001
"Doleac,Michael",220,527,.417,0,3,.000,220,524,.420,50,59,.847,70,203,273,65,37,59,41,239,490,2000/2001
"Dooling,Keyon",148,362,.409,28,80,.350,120,282,.426,125,179,.698,8,81,89,177,41,94,11,107,449,2000/2001
"Douglas,Sherman",122,303,.403,8,40,.200,114,263,.433,86,115,.748,21,53,74,144,36,79,4,93,338,2000/2001
"Drew,Bryce",124,327,.379,40,105,.381,84,222,.378,14,19,.737,12,57,69,185,32,68,3,99,302,2000/2001
"Dudley,Chris",29,73,.397,0,0,,29,73,.397,14,36,.389,64,119,183,18,14,26,29,111,72,2000/2001
"Duncan,Tim",702,1406,.499,7,27,.259,695,1379,.504,409,662,.618,259,738,997,245,70,242,192,247,1820,2000/2001
"Edney,Tyus",35,91,.385,1,6,.167,34,85,.400,35,39,.897,5,19,24,54,17,25,0,17,106,2000/2001
"Edwards,Kevin",56,170,.329,5,19,.263,51,151,.338,43,53,.811,23,59,82,52,29,37,8,46,160,2000/2001
"Eisley,Howard",265,675,.393,107,269,.398,158,406,.389,104,126,.825,23,174,197,295,99,102,12,218,741,2000/2001
"Ekezie,Obinna",32,81,.395,0,0,,32,81,.395,37,53,.698,31,47,78,9,5,14,5,48,101,2000/2001
"Ekezie,Obinna",32,77,.416,0,0,,32,77,.416,37,53,.698,31,45,76,9,5,14,5,46,101,2000/2001
"Ekezie,Obinna",0,4,.000,0,0,,0,4,.000,0,0,,0,2,2,0,0,0,0,2,0,2000/2001
"El-Amin,Khalid",115,311,.370,28,84,.333,87,227,.383,56,72,.778,21,60,81,145,48,54,2,99,314,2000/2001
"Elie,Mario",104,246,.423,36,100,.360,68,146,.466,55,69,.797,38,117,155,131,58,60,12,112,299,2000/2001
"Elliott,Sean",147,339,.434,55,129,.426,92,210,.438,60,84,.714,17,153,170,81,23,51,25,80,409,2000/2001
"Ellis,LaPhonso",298,642,.464,7,22,.318,291,620,.469,169,214,.790,199,295,494,93,67,108,74,290,772,2000/2001
"Ellison,Pervis",2,7,.286,0,0,,2,7,.286,2,2,1.000,2,10,12,3,0,3,2,13,6,2000/2001
"Eschmeyer,Evan",92,200,.460,0,0,,92,200,.460,67,102,.657,135,231,366,40,41,53,58,220,251,2000/2001
"Ewing,Patrick",294,684,.430,0,2,.000,294,682,.431,172,251,.685,124,461,585,92,53,151,91,229,760,2000/2001
"Feick,Jamie",8,23,.348,0,0,,8,23,.348,6,12,.500,12,44,56,5,8,7,3,15,22,2000/2001
"Ferry,Danny",178,375,.475,70,156,.449,108,219,.493,22,30,.733,55,168,223,71,28,50,21,169,448,2000/2001
"Finley,Michael",711,1552,.458,91,263,.346,620,1289,.481,252,325,.775,109,316,425,360,118,190,32,174,1765,2000/2001
"Fisher,Derek",77,187,.412,25,63,.397,52,124,.419,50,62,.806,5,54,59,87,39,29,2,50,229,2000/2001
"Fizer,Marcus",278,646,.430,10,39,.256,268,607,.442,117,161,.727,76,237,313,76,30,124,19,175,683,2000/2001
"Fortson,Danny",29,50,.580,0,0,,29,50,.580,42,54,.778,29,69,98,5,2,10,0,22,100,2000/2001
"Foster,Greg",56,133,.421,3,9,.333,53,124,.427,10,14,.714,29,83,112,32,9,25,12,76,125,2000/2001
"Foster,Jeff",100,213,.469,2,7,.286,98,206,.476,47,91,.516,144,245,389,33,39,52,28,152,249,2000/2001
"Fox,Rick",287,646,.444,118,300,.393,169,346,.488,95,122,.779,80,245,325,262,70,136,29,225,787,2000/2001
"Foyle,Adonal",156,375,.416,0,0,,156,375,.416,30,68,.441,156,249,405,48,31,79,156,136,342,2000/2001
"Francis,Steve",550,1219,.451,133,336,.396,417,883,.472,358,438,.817,190,363,553,517,141,265,31,274,1591,2000/2001
"Fuller,Todd",10,35,.286,0,0,,10,35,.286,8,8,1.000,7,11,18,1,3,3,2,10,28,2000/2001
"Funderburke,Lawrence",120,242,.496,0,0,,120,242,.496,48,77,.623,74,122,196,17,9,32,13,44,288,2000/2001
"Garcés,Rubén",7,22,.318,0,0,,7,22,.318,2,8,.250,16,13,29,5,3,5,2,14,16,2000/2001
"Garcés,Rubén",7,15,.467,0,0,,7,15,.467,2,8,.250,12,10,22,4,2,5,1,14,16,2000/2001
"Garcés,Rubén",0,7,.000,0,0,,0,7,.000,0,0,,4,3,7,1,1,0,1,0,0,2000/2001
"Garner,Chris",7,37,.189,0,7,.000,7,30,.233,5,6,.833,2,10,12,18,7,9,1,18,19,2000/2001
"Garnett,Kevin",704,1475,.477,19,66,.288,685,1409,.486,357,467,.764,219,702,921,401,111,230,145,204,1784,2000/2001
"Garrett,Dean",75,156,.481,0,0,,75,156,.481,27,39,.692,65,152,217,24,26,25,49,93,177,2000/2001
"Garrity,Pat",223,576,.387,97,224,.433,126,352,.358,85,98,.867,51,159,210,51,40,68,15,241,628,2000/2001
"Gatling,Chris",329,733,.449,28,92,.304,301,641,.470,156,228,.684,99,292,391,61,52,119,27,185,842,2000/2001
"Geiger,Matt",88,224,.393,0,2,.000,88,222,.396,37,54,.685,50,89,139,14,12,25,8,73,213,2000/2001
"George,Devean",64,207,.309,15,68,.221,49,139,.353,39,55,.709,35,75,110,19,15,34,15,87,182,2000/2001
"Gill,Eddie",16,41,.390,3,9,.333,13,32,.406,4,5,.800,0,9,9,24,4,10,1,9,39,2000/2001
"Gill,Kendall",107,323,.331,4,14,.286,103,309,.333,65,90,.722,32,99,131,87,47,48,7,64,283,2000/2001
"Glover,Dion",141,336,.420,9,46,.196,132,290,.455,47,69,.681,39,92,131,69,49,54,10,92,338,2000/2001
"Goldwire,Anthony",30,80,.375,9,34,.265,21,46,.457,13,17,.765,1,11,12,34,9,15,0,13,82,2000/2001
"Goodrich,Steve",7,18,.389,1,3,.333,6,15,.400,4,7,.571,7,14,21,6,2,8,1,14,19,2000/2001
"Grant,Brian",484,1010,.479,0,1,.000,484,1009,.480,282,354,.797,217,501,718,101,60,170,71,293,1250,2000/2001
"Grant,Gary",5,7,.714,0,0,,5,7,.714,0,0,,0,0,0,1,0,0,0,1,10,2000/2001
"Grant,Horace",263,569,.462,0,3,.000,263,566,.465,131,169,.775,220,325,545,121,51,48,61,181,657,2000/2001
"Green,A.C.",144,324,.444,0,6,.000,144,318,.453,79,111,.712,107,206,313,39,30,45,8,119,367,2000/2001
"Griffin,Adrian",33,97,.340,9,26,.346,24,71,.338,18,24,.750,27,60,87,27,18,18,5,45,93,2000/2001
"Gugliotta,Tom",149,380,.392,3,12,.250,146,368,.397,61,77,.792,76,179,255,55,47,51,21,110,362,2000/2001
"Guyton,A.J.",78,192,.406,27,69,.391,51,123,.415,15,18,.833,10,26,36,64,9,24,5,35,198,2000/2001
"Ham,Darvin",39,80,.488,2,3,.667,37,77,.481,29,49,.592,56,65,121,25,17,33,21,85,109,2000/2001
"Hamilton,Richard",547,1249,.438,40,146,.274,507,1103,.460,277,319,.868,75,163,238,224,75,201,10,203,1411,2000/2001
"Hamilton,Zendon",2,9,.222,0,0,,2,9,.222,5,8,.625,3,5,8,0,0,2,0,4,9,2000/2001
"Hammonds,Tom",3,10,.300,0,0,,3,10,.300,1,2,.500,2,2,4,1,0,3,0,8,7,2000/2001
"Hardaway,Anfernee",15,36,.417,2,8,.250,13,28,.464,7,11,.636,5,13,18,15,6,3,1,6,39,2000/2001
"Hardaway,Tim",408,1042,.392,189,517,.366,219,525,.417,145,181,.801,26,178,204,483,90,189,6,155,1150,2000/2001
"Harper,Ron",127,271,.469,19,72,.264,108,199,.543,34,48,.708,46,120,166,113,39,62,25,70,307,2000/2001
"Harpring,Matt",238,524,.454,13,52,.250,225,472,.477,134,165,.812,90,152,242,102,42,90,17,161,623,2000/2001
"Harrington,Al",241,543,.444,1,7,.143,240,536,.448,103,157,.656,119,262,381,130,63,148,18,223,586,2000/2001
"Harrington,Othella",247,507,.487,0,3,.000,247,504,.490,171,224,.763,139,249,388,56,34,145,45,237,665,2000/2001
"Harrington,Othella",180,386,.466,0,3,.000,180,383,.470,120,154,.779,102,187,289,36,19,104,26,136,480,2000/2001
"Harrington,Othella",67,121,.554,0,0,,67,121,.554,51,70,.729,37,62,99,20,15,41,19,101,185,2000/2001
"Harris,Lucious",265,624,.425,46,132,.348,219,492,.445,107,139,.770,71,217,288,135,74,64,16,127,683,2000/2001
"Hart,Jason",1,1,1.000,0,0,,1,1,1.000,0,0,,0,0,0,1,0,2,0,0,2,2000/2001
"Harvey,Antonio",13,28,.464,0,0,,13,28,.464,5,6,.833,5,9,14,4,1,3,6,10,31,2000/2001
"Harvey,Donnell",8,14,.571,0,0,,8,14,.571,6,16,.375,6,14,20,2,3,7,1,15,22,2000/2001
"Hawkins,Hersey",56,137,.409,17,46,.370,39,91,.429,54,63,.857,17,63,80,72,33,19,9,45,183,2000/2001
"Hawkins,Michael",3,9,.333,2,4,.500,1,5,.200,0,0,,2,3,5,13,2,6,0,13,8,2000/2001
"Henderson,Alan",298,671,.444,0,1,.000,298,670,.445,173,271,.638,180,226,406,50,51,126,29,164,769,2000/2001
"Henderson,Cedric",102,262,.389,1,8,.125,101,254,.398,30,46,.652,19,71,90,79,29,63,23,101,235,2000/2001
"Herren,Chris",29,96,.302,16,55,.291,13,41,.317,9,12,.750,4,17,21,56,14,20,0,43,83,2000/2001
"Hill,Grant",19,43,.442,1,1,1.000,18,42,.429,16,26,.615,8,17,25,25,5,11,2,9,55,2000/2001
"Hill,Tyrone",278,587,.474,0,1,.000,278,586,.474,172,273,.630,239,448,687,48,37,127,27,242,728,2000/2001
"Hoiberg,Fred",217,495,.438,103,250,.412,114,245,.465,136,157,.866,21,287,308,263,98,74,12,155,673,2000/2001
"Horry,Robert",147,380,.387,54,156,.346,93,224,.415,59,83,.711,93,203,296,128,54,79,54,210,407,2000/2001
"House,Eddie",104,247,.421,19,55,.345,85,192,.443,24,35,.686,5,37,42,52,13,35,0,58,251,2000/2001
"Houston,Allan",542,1208,.449,96,252,.381,446,956,.467,279,307,.909,20,263,283,173,52,161,10,190,1459,2000/2001
"Howard,Juwan",583,1218,.479,0,3,.000,583,1215,.480,296,383,.773,171,401,572,224,75,242,37,292,1462,2000/2001
"Howard,Juwan",392,827,.474,0,0,,392,827,.474,197,256,.770,121,258,379,154,46,169,21,186,981,2000/2001
"Howard,Juwan",191,391,.488,0,3,.000,191,388,.492,99,127,.780,50,143,193,70,29,73,16,106,481,2000/2001
"Hudson,Troy",125,372,.336,22,109,.202,103,263,.392,85,104,.817,38,67,105,162,37,92,3,82,357,2000/2001
"Hughes,Larry",308,805,.383,14,75,.187,294,730,.403,193,252,.766,76,200,276,223,96,152,29,147,823,2000/2001
"Hunter,Lindsey",298,783,.381,152,407,.373,146,376,.388,77,96,.802,32,137,169,222,102,68,12,172,825,2000/2001
"Ilgauskas,Zydrunas",114,234,.487,0,2,.000,114,232,.491,53,78,.679,65,95,160,18,15,60,37,78,281,2000/2001
"Iverson,Allen",762,1813,.420,98,306,.320,664,1507,.441,585,719,.814,50,223,273,325,178,237,20,147,2207,2000/2001
"Jackson,Bobby",231,526,.439,39,104,.375,192,422,.455,65,88,.739,74,172,246,161,87,103,7,139,566,2000/2001
"Jackson,Jaren",16,40,.400,7,18,.389,9,22,.409,0,2,.000,1,11,12,7,5,3,0,13,39,2000/2001
"Jackson,Jim",239,632,.378,26,80,.325,213,552,.386,139,169,.822,53,171,224,163,53,130,10,139,643,2000/2001
"Jackson,Jim",77,217,.355,16,38,.421,61,179,.341,73,85,.859,17,62,79,50,19,48,4,42,243,2000/2001
"Jackson,Jim",162,415,.390,10,42,.238,152,373,.408,66,84,.786,36,109,145,113,34,82,6,97,400,2000/2001
"Jackson,Marc",237,508,.467,5,23,.217,232,485,.478,154,192,.802,119,242,361,59,34,93,27,138,633,2000/2001
"Jackson,Mark",244,583,.419,70,207,.338,174,376,.463,73,93,.785,63,242,305,661,84,175,7,139,631,2000/2001
"Jackson,Mark",170,403,.422,57,165,.345,113,238,.475,64,76,.842,42,143,185,498,63,117,7,83,461,2000/2001
"Jackson,Mark",74,180,.411,13,42,.310,61,138,.442,9,17,.529,21,99,120,163,21,58,0,56,170,2000/2001
"Jackson,Stephen",243,572,.425,52,155,.335,191,417,.458,97,135,.719,41,167,208,140,86,130,14,166,635,2000/2001
"Jacobson,Sam",9,18,.500,0,0,,9,18,.500,2,3,.667,3,3,6,4,3,0,0,19,20,2000/2001
"James,Tim",16,52,.308,1,3,.333,15,49,.306,12,14,.857,15,20,35,8,2,8,5,27,45,2000/2001
"Jamison,Antawn",800,1812,.442,62,205,.302,738,1607,.459,382,534,.715,280,435,715,164,114,199,28,225,2044,2000/2001
"Johnson,Anthony",53,152,.349,1,5,.200,52,147,.354,23,33,.697,10,34,44,78,23,34,6,62,130,2000/2001
"Johnson,Anthony",26,71,.366,0,3,.000,26,68,.382,12,17,.706,3,20,23,34,17,20,5,41,64,2000/2001
"Johnson,Anthony",27,81,.333,1,2,.500,26,79,.329,11,16,.688,7,14,21,44,6,14,1,21,66,2000/2001
"Johnson,Avery",134,300,.447,1,6,.167,133,294,.452,41,60,.683,21,64,85,237,33,60,4,90,310,2000/2001
"Johnson,DerMarr",146,390,.374,41,127,.323,105,263,.399,64,87,.736,56,122,178,64,43,93,30,134,397,2000/2001
"Johnson,Ervin",108,198,.545,0,0,,108,198,.545,50,93,.538,205,408,613,40,44,47,97,257,266,2000/2001
"Johnson,Larry",246,598,.411,51,163,.313,195,435,.448,102,128,.797,90,273,363,127,39,97,29,209,645,2000/2001
"Jones,Damon",170,416,.409,84,231,.364,86,185,.465,37,52,.712,16,108,124,224,36,76,1,58,461,2000/2001
"Jones,Eddie",388,871,.445,90,238,.378,298,633,.471,228,270,.844,75,217,292,171,110,135,58,183,1094,2000/2001
"Jones,Jumaine",122,275,.444,20,60,.333,102,215,.474,40,53,.755,63,126,189,32,30,39,15,68,304,2000/2001
"Jones,Popeye",60,153,.392,1,6,.167,59,147,.401,41,55,.745,83,137,220,31,19,21,8,95,162,2000/2001
"Joseph,Garth",1,5,.200,0,0,,1,5,.200,0,2,.000,2,0,2,1,0,2,1,1,2,2000/2001
"Joseph,Garth",1,2,.500,0,0,,1,2,.500,0,0,,2,0,2,1,0,1,0,1,2,2000/2001
"Joseph,Garth",0,3,.000,0,0,,0,3,.000,0,2,.000,0,0,0,0,0,1,1,0,0,2000/2001
"Keefe,Adam",64,159,.403,1,3,.333,63,156,.404,39,63,.619,90,119,209,36,28,40,20,102,168,2000/2001
"Kemp,Shawn",168,413,.407,4,11,.364,164,402,.408,101,131,.771,63,196,259,65,45,99,23,184,441,2000/2001
"Kerr,Steve",67,159,.421,33,77,.429,34,82,.415,14,15,.933,6,29,35,57,16,21,1,30,181,2000/2001
"Kersey,Jerome",32,69,.464,0,1,.000,32,68,.471,8,16,.500,8,37,45,15,14,6,8,36,72,2000/2001
"Ketner,Lari",0,0,,0,0,,0,0,,0,0,,0,0,0,1,0,2,0,0,0,2000/2001
"Kidd,Jason",451,1097,.411,69,232,.297,382,865,.442,328,403,.814,91,403,494,753,166,286,23,171,1299,2000/2001
"King,Gerard",90,176,.511,0,0,,90,176,.511,36,45,.800,39,90,129,31,14,47,11,94,216,2000/2001
"Knight,Brevin",139,371,.375,1,10,.100,138,361,.382,54,66,.818,23,145,168,311,101,91,4,155,333,2000/2001
"Knight,Brevin",2,15,.133,0,0,,2,15,.133,5,6,.833,1,6,7,25,6,7,1,17,9,2000/2001
"Knight,Brevin",137,356,.385,1,10,.100,136,346,.393,49,60,.817,22,139,161,286,95,84,3,138,324,2000/2001
"Knight,Travis",10,53,.189,0,1,.000,10,52,.192,9,18,.500,19,34,53,5,5,10,11,47,29,2000/2001
"Kukoč,Toni",275,582,.473,70,157,.446,205,425,.482,101,160,.631,66,193,259,199,48,111,11,98,721,2000/2001
"Kukoč,Toni",151,330,.458,32,78,.410,119,252,.472,52,88,.591,47,115,162,93,35,60,6,62,386,2000/2001
"Kukoč,Toni",124,252,.492,38,79,.481,86,173,.497,49,72,.681,19,78,97,106,13,51,5,36,335,2000/2001
"Laettner,Christian",277,551,.503,4,13,.308,273,538,.507,170,204,.833,118,247,365,124,71,137,46,242,728,2000/2001
"Laettner,Christian",165,323,.511,1,3,.333,164,320,.513,67,82,.817,75,137,212,67,40,70,27,159,398,2000/2001
"Laettner,Christian",112,228,.491,3,10,.300,109,218,.500,103,122,.844,43,110,153,57,31,67,19,83,330,2000/2001
"LaFrentz,Raef",387,812,.477,51,139,.367,336,673,.499,183,262,.698,173,434,607,107,37,97,206,290,1008,2000/2001
"Langdon,Trajan",135,313,.431,51,124,.411,84,189,.444,68,76,.895,12,77,89,81,38,52,9,114,389,2000/2001
"Langhi,Dan",37,99,.374,0,1,.000,37,98,.378,16,29,.552,13,28,41,4,7,8,1,16,90,2000/2001
"Lenard,Voshon",336,846,.397,147,382,.385,189,464,.407,153,192,.797,47,184,231,190,65,102,18,170,972,2000/2001
"Lewis,Quincy",50,123,.407,9,25,.360,41,98,.418,15,21,.714,14,33,47,18,10,17,10,78,124,2000/2001
"Lewis,Rashard",426,887,.480,123,285,.432,303,602,.503,176,213,.826,143,398,541,125,91,129,45,191,1151,2000/2001
"Livingston,Randy",0,2,.000,0,1,.000,0,1,.000,0,0,,0,1,1,1,0,0,0,0,0,2000/2001
"Long,Art",0,4,.000,0,0,,0,4,.000,0,2,.000,2,6,8,1,0,2,3,5,0,2000/2001
"Long,Grant",140,319,.439,4,15,.267,136,304,.447,112,157,.713,76,198,274,83,72,62,15,160,396,2000/2001
"Longley,Luc",18,54,.333,0,0,,18,54,.333,13,17,.765,26,40,66,7,3,22,9,51,49,2000/2001
"López,Felipe",211,478,.441,19,52,.365,192,426,.451,109,156,.699,55,179,234,107,62,83,30,156,550,2000/2001
"López,Felipe",142,326,.436,6,29,.207,136,297,.458,90,123,.732,30,130,160,73,41,56,18,110,380,2000/2001
"López,Felipe",69,152,.454,13,23,.565,56,129,.434,19,33,.576,25,49,74,34,21,27,12,46,170,2000/2001
"Lue,Tyronn",50,117,.427,11,34,.324,39,83,.470,19,24,.792,5,27,32,45,19,27,0,54,130,2000/2001
"Lynch,George",274,616,.445,15,57,.263,259,559,.463,123,171,.719,200,390,590,139,99,109,30,222,686,2000/2001
"MacCulloch,Todd",109,185,.589,0,0,,109,185,.589,42,66,.636,69,99,168,10,7,27,19,96,260,2000/2001
"MacLean,Don",10,20,.500,2,2,1.000,8,18,.444,9,12,.750,7,11,18,4,5,10,1,9,31,2000/2001
"Madsen,Mark",55,113,.487,1,1,1.000,54,112,.482,26,37,.703,74,78,152,24,8,27,8,111,137,2000/2001
"Maggette,Corey",225,487,.462,17,56,.304,208,431,.483,223,288,.774,88,203,291,82,35,106,9,140,690,2000/2001
"Magloire,Jamaal",122,271,.450,0,2,.000,122,269,.454,95,145,.655,103,192,295,27,18,61,78,139,339,2000/2001
"Majerle,Dan",87,259,.336,57,181,.315,30,78,.385,36,44,.818,20,146,166,88,53,35,15,98,267,2000/2001
"Malone,Karl",670,1345,.498,2,5,.400,668,1340,.499,536,676,.793,114,555,669,361,93,244,62,216,1878,2000/2001
"Maloney,Matt",146,348,.420,51,142,.359,95,206,.461,26,34,.765,14,103,117,154,56,70,5,94,369,2000/2001
"Manning,Danny",247,500,.494,7,28,.250,240,472,.508,102,140,.729,66,148,214,92,47,96,29,219,603,2000/2001
"Marbury,Stephon",563,1277,.441,110,335,.328,453,942,.481,362,458,.790,53,152,205,506,79,197,5,150,1598,2000/2001
"Marion,Shawn",557,1160,.480,21,82,.256,536,1078,.497,234,289,.810,220,628,848,160,132,129,108,211,1369,2000/2001
"Marshall,Donyell",427,849,.503,41,128,.320,386,721,.535,205,273,.751,172,394,566,133,85,128,78,196,1100,2000/2001
"Martin,Darrick",29,76,.382,14,27,.519,15,49,.306,31,35,.886,2,14,16,14,7,10,0,27,103,2000/2001
"Martin,Kenyon",346,777,.445,1,11,.091,345,766,.450,121,192,.630,137,365,502,131,78,138,113,281,814,2000/2001
"Mashburn,Jamal",573,1388,.413,103,289,.356,470,1099,.428,279,364,.766,92,484,576,411,85,211,13,185,1528,2000/2001
"Mason,Anthony",460,954,.482,0,0,,460,954,.482,370,474,.781,169,601,770,248,80,179,25,231,1290,2000/2001
"Mason,Desmond",189,439,.431,18,67,.269,171,372,.460,67,91,.736,72,177,249,63,39,53,20,146,463,2000/2001
"Massenburg,Tony",92,199,.462,0,0,,92,199,.462,49,70,.700,75,135,210,9,10,48,28,122,233,2000/2001
"Maxwell,Vernon",73,223,.327,34,111,.306,39,112,.348,21,32,.656,4,62,66,49,21,35,3,64,201,2000/2001
"Maxwell,Vernon",42,125,.336,21,64,.328,21,61,.344,15,22,.682,3,34,37,29,12,18,0,33,120,2000/2001
"Maxwell,Vernon",31,98,.316,13,47,.277,18,51,.353,6,10,.600,1,28,29,20,9,17,3,31,81,2000/2001
"McCarty,Walter",45,126,.357,19,56,.339,26,70,.371,22,28,.786,24,57,81,39,14,20,7,82,131,2000/2001
"McClintock,Dan",9,18,.500,0,0,,9,18,.500,0,5,.000,10,7,17,1,0,3,2,11,18,2000/2001
"McCloud,George",250,655,.382,77,234,.329,173,421,.411,152,181,.840,55,169,224,279,53,117,27,165,729,2000/2001
"McCoy,Jelani",138,264,.523,0,0,,138,264,.523,41,93,.441,92,159,251,57,18,75,49,141,317,2000/2001
"McDyess,Antonio",577,1165,.495,0,0,,577,1165,.495,304,434,.700,240,605,845,146,43,162,102,220,1458,2000/2001
"McGrady,Tracy",788,1724,.457,59,166,.355,729,1558,.468,430,587,.733,192,388,580,352,116,198,118,160,2065,2000/2001
"McIlvaine,Jim",10,28,.357,0,0,,10,28,.357,8,12,.667,8,27,35,4,7,9,15,35,28,2000/2001
"McInnis,Jeff",432,933,.463,52,144,.361,380,789,.482,130,161,.807,41,179,220,447,75,113,7,199,1046,2000/2001
"McKey,Derrick",60,136,.441,4,20,.200,56,116,.483,21,27,.778,49,127,176,74,48,47,13,136,145,2000/2001
"McKie,Aaron",338,714,.473,53,170,.312,285,544,.524,149,194,.768,33,278,311,377,106,203,8,178,878,2000/2001
"McLeod,Roshown",145,332,.437,2,22,.091,143,310,.461,45,51,.882,38,82,120,58,23,58,8,90,337,2000/2001
"McLeod,Roshown",144,330,.436,2,21,.095,142,309,.460,45,51,.882,37,81,118,58,23,57,8,88,335,2000/2001
"McLeod,Roshown",1,2,.500,0,1,.000,1,1,1.000,0,0,,1,1,2,0,0,1,0,2,2,2000/2001
"McPherson,Paul",109,216,.505,2,12,.167,107,204,.525,42,58,.724,40,39,79,38,25,47,4,80,262,2000/2001
"McPherson,Paul",47,96,.490,0,6,.000,47,90,.522,18,24,.750,20,28,48,16,12,23,3,48,112,2000/2001
"McPherson,Paul",62,120,.517,2,6,.333,60,114,.526,24,34,.706,20,11,31,22,13,24,1,32,150,2000/2001
"Medvedenko,Stanislav",12,25,.480,1,1,1.000,11,24,.458,7,12,.583,1,8,9,2,1,3,1,9,32,2000/2001
"Mercer,Ron",500,1121,.446,14,46,.304,486,1075,.452,188,228,.825,72,164,236,201,78,129,27,148,1202,2000/2001
"Mihm,Chris",173,391,.442,0,1,.000,173,390,.444,100,126,.794,106,174,280,16,20,80,53,156,446,2000/2001
"Miles,Darius",318,630,.505,1,19,.053,317,611,.519,124,238,.521,127,350,477,99,51,147,125,191,761,2000/2001
"Miller,Andre",452,999,.452,17,64,.266,435,935,.465,375,450,.833,94,266,360,657,119,265,28,229,1296,2000/2001
"Miller,Anthony",1,2,.500,0,0,,1,2,.500,0,0,,0,2,2,0,0,1,0,1,2,2000/2001
"Miller,Anthony",1,2,.500,0,0,,1,2,.500,0,0,,0,2,2,0,0,1,0,0,2,2000/2001
"Miller,Anthony",0,0,,0,0,,0,0,,0,0,,0,0,0,0,0,0,0,1,0,2000/2001
"Miller,Anthony",0,0,,0,0,,0,0,,0,0,,0,0,0,0,0,0,0,0,0,2000/2001
"Miller,Brad",168,386,.435,1,5,.200,167,381,.438,168,226,.743,144,275,419,107,33,73,38,176,505,2000/2001
"Miller,Mike",368,845,.436,148,364,.407,220,481,.457,91,128,.711,66,261,327,140,51,97,19,200,975,2000/2001
"Miller,Reggie",517,1176,.440,170,464,.366,347,712,.487,323,348,.928,38,247,285,260,81,133,15,162,1527,2000/2001
"Mills,Chris",71,191,.372,7,25,.280,64,166,.386,31,36,.861,24,69,93,18,9,20,5,43,180,2000/2001
"Mills,Terry",11,34,.324,3,17,.176,8,17,.471,0,0,,4,17,21,5,3,10,1,20,25,2000/2001
"Mitchell,Sam",118,289,.408,9,43,.209,109,246,.443,40,55,.727,28,95,123,57,26,36,10,117,285,2000/2001
"Mobley,Cuttino",527,1214,.434,90,252,.357,437,962,.454,394,474,.831,83,314,397,195,84,165,26,169,1538,2000/2001
"Mohammed,Nazr",176,369,.477,0,1,.000,176,368,.478,89,126,.706,115,192,307,19,29,64,35,113,441,2000/2001
"Mohammed,Nazr",41,88,.466,0,0,,41,88,.466,14,28,.500,18,37,55,2,6,9,7,40,96,2000/2001
"Mohammed,Nazr",135,281,.480,0,1,.000,135,280,.482,75,98,.765,97,155,252,17,23,55,28,73,345,2000/2001
"Moïso,Jérôme",12,30,.400,0,1,.000,12,29,.414,11,26,.423,12,30,42,3,3,18,4,29,35,2000/2001
"Montross,Eric",56,138,.406,0,0,,56,138,.406,8,31,.258,52,121,173,19,11,41,26,115,120,2000/2001
"Montross,Eric",50,121,.413,0,0,,50,121,.413,7,26,.269,43,101,144,15,8,37,23,100,107,2000/2001
"Montross,Eric",6,17,.353,0,0,,6,17,.353,1,5,.200,9,20,29,4,3,4,3,15,13,2000/2001
"Moore,Mikki",132,268,.493,0,1,.000,132,267,.494,95,130,.731,121,195,316,33,24,74,61,202,359,2000/2001
"Möttölä,Hanno",123,277,.444,0,3,.000,123,274,.449,73,90,.811,49,125,174,25,11,67,9,163,319,2000/2001
"Mourning,Alonzo",73,141,.518,0,1,.000,73,140,.521,31,55,.564,35,66,101,12,4,28,31,24,177,2000/2001
"Mullin,Chris",36,106,.340,19,52,.365,17,54,.315,24,28,.857,10,31,41,19,16,19,10,28,115,2000/2001
"Murray,Lamond",391,925,.423,61,165,.370,330,760,.434,155,211,.735,104,236,340,124,83,141,27,173,998,2000/2001
"Murray,Tracy",94,248,.379,36,103,.350,58,145,.400,33,42,.786,22,59,81,23,12,26,7,53,257,2000/2001
"Murray,Tracy",17,55,.309,7,23,.304,10,32,.313,9,10,.900,4,18,22,9,4,6,1,8,50,2000/2001
"Murray,Tracy",77,193,.399,29,80,.363,48,113,.425,24,32,.750,18,41,59,14,8,20,6,45,207,2000/2001
"Mutombo,Dikembe",269,556,.484,0,0,,269,556,.484,211,291,.725,307,708,1015,76,29,144,203,204,749,2000/2001
"Mutombo,Dikembe",169,354,.477,0,0,,169,354,.477,107,154,.695,188,505,693,54,20,92,137,139,445,2000/2001
"Mutombo,Dikembe",100,202,.495,0,0,,100,202,.495,104,137,.759,119,203,322,22,9,52,66,65,304,2000/2001
"N'Diaye,Mamadou",1,4,.250,0,0,,1,4,.250,2,2,1.000,1,1,2,0,0,0,0,3,4,2000/2001
"Nailon,Lee",66,136,.485,0,1,.000,66,135,.489,32,43,.744,29,63,92,24,9,27,5,60,164,2000/2001
"Nájera,Eduardo",58,111,.523,1,3,.333,57,108,.528,14,33,.424,41,54,95,27,13,17,8,48,131,2000/2001
"Nash,Steve",386,792,.487,89,219,.406,297,573,.518,231,258,.895,46,177,223,509,72,205,5,158,1092,2000/2001
"Nesby,Tyrone",189,530,.357,49,180,.272,140,350,.400,85,106,.802,51,122,173,76,51,65,20,155,512,2000/2001
"Nesby,Tyrone",40,123,.325,10,46,.217,30,77,.390,18,23,.783,16,26,42,11,10,10,4,28,108,2000/2001
"Nesby,Tyrone",149,407,.366,39,134,.291,110,273,.403,67,83,.807,35,96,131,65,41,55,16,127,404,2000/2001
"Nesterović,Rasho",147,319,.461,0,1,.000,147,318,.462,34,65,.523,99,187,286,45,25,55,63,189,328,2000/2001
"Newble,Ira",21,55,.382,4,9,.444,17,46,.370,8,16,.500,13,22,35,6,2,7,4,18,54,2000/2001
"Newman,Johnny",291,695,.419,59,176,.335,232,519,.447,254,297,.855,34,142,176,115,63,106,10,229,895,2000/2001
"Norris,Moochie",184,413,.446,25,89,.281,159,324,.491,151,194,.778,44,154,198,283,69,107,2,84,544,2000/2001
"Nowitzki,Dirk",591,1247,.474,151,390,.387,440,857,.513,451,538,.838,119,635,754,173,79,156,101,245,1784,2000/2001
"O'Neal,Jermaine",404,868,.465,0,5,.000,404,863,.468,233,388,.601,249,545,794,98,49,161,228,280,1041,2000/2001
"O'Neal,Shaquille",813,1422,.572,0,2,.000,813,1420,.573,499,972,.513,291,649,940,277,47,218,204,256,2125,2000/2001
"Oakley,Charles",305,786,.388,11,49,.224,294,737,.399,127,152,.836,142,599,741,264,76,139,48,258,748,2000/2001
"Odom,Lamar",481,1046,.460,80,253,.316,401,793,.506,262,386,.679,110,482,592,392,74,264,122,236,1304,2000/2001
"Olajuwon,Hakeem",283,568,.498,0,1,.000,283,567,.499,123,198,.621,124,307,431,72,70,81,88,141,689,2000/2001
"Ollie,Kevin",76,192,.396,1,3,.333,75,189,.397,63,89,.708,16,79,95,146,30,49,1,84,216,2000/2001
"Ollie,Kevin",5,27,.185,0,0,,5,27,.185,12,19,.632,3,20,23,25,5,9,0,14,22,2000/2001
"Ollie,Kevin",71,165,.430,1,3,.333,70,162,.432,51,70,.729,13,59,72,121,25,40,1,70,194,2000/2001
"Olowokandi,Michael",308,708,.435,0,0,,308,708,.435,85,156,.545,168,357,525,46,30,169,108,250,701,2000/2001
"Ostertag,Greg",139,281,.495,1,2,.500,138,279,.495,84,151,.556,164,251,415,22,22,63,142,215,363,2000/2001
"Outlaw,Bo",226,368,.614,1,2,.500,225,366,.615,129,225,.573,211,408,619,225,105,141,137,241,582,2000/2001
"Overton,Doug",52,139,.374,11,36,.306,41,103,.398,10,16,.625,4,35,39,72,8,31,0,37,125,2000/2001
"Overton,Doug",15,44,.341,1,4,.250,14,40,.350,7,11,.636,3,12,15,19,4,13,0,15,38,2000/2001
"Overton,Doug",2,2,1.000,0,0,,2,2,1.000,0,0,,0,0,0,0,1,3,0,2,4,2000/2001
"Overton,Doug",35,93,.376,10,32,.313,25,61,.410,3,5,.600,1,23,24,53,3,15,0,20,83,2000/2001
"Owens,Billy",88,230,.383,3,20,.150,85,210,.405,19,40,.475,84,121,205,55,32,39,12,93,198,2000/2001
"Oyedeji,Olumide",18,37,.486,0,0,,18,37,.486,9,12,.750,24,43,67,2,7,11,10,40,45,2000/2001
"Pack,Robert",181,426,.425,12,31,.387,169,395,.428,105,137,.766,30,107,137,293,65,135,1,114,479,2000/2001
"Padgett,Scott",18,43,.419,5,9,.556,13,34,.382,15,20,.750,19,20,39,5,6,10,3,21,56,2000/2001
"Palacio,Milt",126,267,.472,12,36,.333,114,231,.494,78,92,.848,25,77,102,151,48,80,0,83,342,2000/2001
"Panko,Andy",0,0,,0,0,,0,0,,0,0,,0,0,0,0,0,0,0,0,0,2000/2001
"Parks,Cherokee",134,274,.489,0,6,.000,134,268,.500,31,44,.705,71,158,229,46,25,41,36,122,299,2000/2001
"Parks,Cherokee",18,38,.474,0,0,,18,38,.474,12,17,.706,13,27,40,7,6,10,11,20,48,2000/2001
"Parks,Cherokee",116,236,.492,0,6,.000,116,230,.504,19,27,.704,58,131,189,39,19,31,25,102,251,2000/2001
"Patterson,Ruben",370,749,.494,2,36,.056,368,713,.516,246,361,.681,183,199,382,161,103,155,45,176,988,2000/2001
"Payton,Gary",725,1591,.456,102,272,.375,623,1319,.472,271,354,.766,73,288,361,642,127,209,26,184,1823,2000/2001
"Peeler,Anthony",308,732,.421,100,256,.391,208,476,.437,75,87,.862,44,148,192,192,91,105,18,166,791,2000/2001
"Penberthy,Mike",92,222,.414,55,139,.396,37,83,.446,28,31,.903,10,53,63,71,22,34,2,57,267,2000/2001
"Perdue,Will",6,9,.667,0,0,,6,9,.667,2,4,.500,6,12,18,2,3,0,2,8,14,2000/2001
"Perkins,Sam",86,226,.381,38,110,.345,48,116,.414,32,38,.842,32,136,168,41,33,19,18,61,242,2000/2001
"Perry,Elliot",65,140,.464,1,5,.200,64,135,.474,16,22,.727,9,37,46,79,22,38,1,29,147,2000/2001
"Perry,Elliot",5,11,.455,0,1,.000,5,10,.500,0,0,,1,3,4,5,3,6,0,1,10,2000/2001
"Perry,Elliot",60,129,.465,1,4,.250,59,125,.472,16,22,.727,8,34,42,74,19,32,1,28,137,2000/2001
"Person,Wesley",128,292,.438,34,84,.405,94,208,.452,24,30,.800,11,119,130,64,27,40,11,62,314,2000/2001
"Peterson,Morris",290,673,.431,63,165,.382,227,508,.447,104,145,.717,112,147,259,105,63,78,20,164,747,2000/2001
"Piatkowski,Eric",291,672,.433,120,297,.404,171,375,.456,158,181,.873,54,187,241,96,46,76,19,123,860,2000/2001
"Pierce,Paul",687,1513,.454,147,384,.383,540,1129,.478,550,738,.745,94,428,522,253,138,262,69,251,2071,2000/2001
"Pippen,Scottie",269,596,.451,64,186,.344,205,410,.500,119,161,.739,70,263,333,294,94,154,35,158,721,2000/2001
"Pollard,Scot",185,395,.468,0,2,.000,185,393,.471,128,171,.749,173,292,465,47,48,66,97,206,498,2000/2001
"Polynice,Olden",206,415,.496,0,1,.000,206,414,.498,17,65,.262,157,221,378,31,27,78,77,241,429,2000/2001
"Pope,Mark",62,142,.437,5,24,.208,57,118,.483,22,35,.629,56,91,147,38,16,17,26,140,151,2000/2001
"Porter,Chris",173,445,.389,0,5,.000,173,440,.393,94,141,.667,89,100,189,61,45,59,6,111,440,2000/2001
"Porter,Terry",197,440,.448,87,205,.424,110,235,.468,92,116,.793,24,177,201,251,52,104,11,88,573,2000/2001
"Posey,James",243,590,.412,65,217,.300,178,373,.477,115,141,.816,125,306,431,163,93,102,40,226,666,2000/2001
"Postell,Lavor",17,54,.315,3,11,.273,14,43,.326,22,27,.815,8,17,25,5,4,17,2,12,59,2000/2001
"Potapenko,Vitaly",248,521,.476,0,0,,248,521,.476,115,158,.728,206,289,495,64,52,105,23,228,611,2000/2001
"Price,Brent",3,11,.273,1,4,.250,2,7,.286,6,7,.857,1,3,4,5,2,4,0,8,13,2000/2001
"Profit,Laron",56,142,.394,7,26,.269,49,116,.422,33,45,.733,18,46,64,89,36,46,11,43,152,2000/2001
"Przybilla,Joel",12,35,.343,0,0,,12,35,.343,3,11,.273,29,42,71,2,3,13,30,56,27,2000/2001
"Ratliff,Theo",228,457,.499,0,0,,228,457,.499,165,217,.760,125,288,413,58,30,126,187,165,621,2000/2001
"Recasner,Eldridge",38,114,.333,13,39,.333,25,75,.333,14,18,.778,13,37,50,39,6,27,1,30,103,2000/2001
"Redd,Michael",5,19,.263,0,3,.000,5,16,.313,3,6,.500,3,1,4,1,1,1,0,2,13,2000/2001
"Reeves,Bryant",254,552,.460,1,4,.250,253,548,.462,113,142,.796,132,320,452,80,43,90,54,243,622,2000/2001
"Reid,Don",82,145,.566,0,0,,82,145,.566,46,75,.613,84,158,242,21,23,48,54,190,210,2000/2001
"Reid,J.R.",2,5,.400,0,0,,2,5,.400,6,8,.750,5,3,8,1,2,1,1,4,10,2000/2001
"Rice,Glen",331,752,.440,82,211,.389,249,541,.460,155,182,.852,61,246,307,89,41,96,13,179,899,2000/2001
"Richardson,Quentin",232,525,.442,50,151,.331,182,374,.487,99,158,.627,105,152,257,62,42,64,7,98,613,2000/2001
"Richmond,Mitch",205,504,.407,45,133,.338,160,371,.431,143,160,.894,15,94,109,111,43,84,7,86,598,2000/2001
"Rider,Isaiah",201,472,.426,34,92,.370,167,380,.439,71,83,.855,44,112,156,111,27,98,7,105,507,2000/2001
"Roberson,Terrance",0,2,.000,0,1,.000,0,1,.000,0,0,,0,1,1,1,0,2,0,3,0,2000/2001
"Robinson,Clifford",501,1186,.422,90,249,.361,411,937,.439,253,357,.709,105,229,334,237,87,186,82,258,1345,2000/2001
"Robinson,David",400,823,.486,0,1,.000,400,822,.487,351,470,.747,208,483,691,116,80,122,197,212,1151,2000/2001
"Robinson,Eddie",216,407,.531,2,4,.500,214,403,.531,64,88,.727,60,138,198,59,50,43,32,66,498,2000/2001
"Robinson,Glenn",684,1460,.468,55,184,.299,629,1276,.493,251,306,.820,124,402,526,252,86,219,62,191,1674,2000/2001
"Robinson,Jamal",3,22,.136,0,2,.000,3,20,.150,0,0,,3,8,11,2,6,3,0,7,6,2000/2001
"Robinson,James",4,11,.364,2,5,.400,2,6,.333,0,0,,0,8,8,0,4,4,1,5,10,2000/2001
"Robinson,Larry",67,184,.364,44,116,.379,23,68,.338,21,24,.875,23,64,87,36,28,25,2,46,199,2000/2001
"Robinson,Larry",0,0,,0,0,,0,0,,0,0,,0,0,0,0,0,1,0,0,0,2000/2001
"Robinson,Larry",67,184,.364,44,116,.379,23,68,.338,21,24,.875,23,64,87,36,28,24,2,46,199,2000/2001
"Rogers,Carlos",75,110,.682,0,1,.000,75,109,.688,29,52,.558,48,91,139,9,10,17,18,33,179,2000/2001
"Rogers,Rodney",377,876,.430,56,189,.296,321,687,.467,188,247,.761,94,265,359,180,97,157,47,269,998,2000/2001
"Rooks,Sean",169,395,.428,1,2,.500,168,393,.427,107,143,.748,91,212,303,77,34,73,64,197,446,2000/2001
"Rose,Jalen",567,1242,.457,59,174,.339,508,1068,.476,285,344,.828,37,322,359,435,65,211,43,230,1478,2000/2001
"Rose,Malik",160,368,.435,3,17,.176,157,351,.447,114,160,.713,95,213,308,48,59,74,40,148,437,2000/2001
"Ruffin,Michael",40,90,.444,0,0,,40,90,.444,39,77,.506,101,161,262,39,30,46,38,131,119,2000/2001
"Russell,Bryon",308,700,.440,95,230,.413,213,470,.453,222,285,.779,94,236,330,160,96,113,20,229,933,2000/2001
"Sabonis,Arvydas",247,516,.479,1,15,.067,246,501,.491,121,156,.776,51,280,331,91,40,85,62,137,616,2000/2001
"Samake,Soumaila",18,48,.375,0,0,,18,48,.375,10,24,.417,22,31,53,1,2,4,14,23,46,2000/2001
"Sánchez,Pepe",9,28,.321,0,1,.000,9,27,.333,2,2,1.000,3,12,15,41,11,6,1,21,20,2000/2001
"Sánchez,Pepe",0,7,.000,0,0,,0,7,.000,0,0,,1,0,1,5,2,3,0,3,0,2000/2001
"Sánchez,Pepe",9,21,.429,0,1,.000,9,20,.450,2,2,1.000,2,12,14,36,9,3,1,18,20,2000/2001
"Santiago,Daniel",64,134,.478,0,0,,64,134,.478,42,61,.689,35,67,102,11,17,47,21,101,170,2000/2001
"Schrempf,Detlef",39,95,.411,3,8,.375,36,87,.414,23,27,.852,17,61,78,44,7,28,3,43,104,2000/2001
"Scott,Shawnelle",17,41,.415,0,0,,17,41,.415,9,22,.409,23,27,50,4,5,11,6,23,43,2000/2001
"Shaw,Brian",164,411,.399,42,135,.311,122,276,.442,51,64,.797,48,256,304,258,49,97,27,159,421,2000/2001
"Skinner,Brian",64,161,.398,0,0,,64,161,.398,32,59,.542,55,113,168,18,14,32,11,61,160,2000/2001
"Slater,Reggie",90,175,.514,0,0,,90,175,.514,74,110,.673,78,108,186,26,18,43,9,126,254,2000/2001
"Smith,Jabari",11,22,.500,0,0,,11,22,.500,4,6,.667,1,7,8,6,4,3,0,7,26,2000/2001
"Smith,Joe",308,765,.403,0,5,.000,308,760,.405,231,287,.805,160,331,491,79,47,88,50,258,847,2000/2001
"Smith,Michael",106,218,.486,0,1,.000,106,217,.488,89,154,.578,172,390,562,101,57,62,37,156,301,2000/2001
"Smith,Mike",19,59,.322,3,18,.167,16,41,.390,10,16,.625,10,12,22,10,5,7,3,8,51,2000/2001
"Smith,Steve",359,788,.456,78,230,.339,281,558,.504,309,347,.890,87,185,272,213,48,137,24,203,1105,2000/2001
"Smith,Tony",8,23,.348,0,2,.000,8,21,.381,1,2,.500,2,1,3,10,7,9,0,12,17,2000/2001
"Snow,Eric",182,435,.418,5,19,.263,177,416,.425,122,154,.792,27,139,166,369,77,124,7,123,491,2000/2001
"Spencer,Felton",12,20,.600,0,0,,12,20,.600,15,25,.600,16,19,35,2,2,11,2,24,39,2000/2001
"Sprewell,Latrell",524,1219,.430,41,135,.304,483,1084,.446,275,351,.783,49,298,347,269,106,218,28,159,1364,2000/2001
"Stackhouse,Jerry",774,1927,.402,166,473,.351,608,1454,.418,666,810,.822,99,216,315,410,97,326,54,160,2380,2000/2001
"Starks,John",273,686,.398,64,182,.352,209,504,.415,89,111,.802,29,125,154,178,73,94,10,217,699,2000/2001
"Stepania,Vladimir",28,88,.318,1,4,.250,27,84,.321,25,34,.735,35,74,109,16,10,19,11,47,82,2000/2001
"Stevenson,DeShawn",31,91,.341,1,12,.083,30,79,.380,26,38,.684,9,19,28,18,10,28,2,29,89,2000/2001
"Stewart,Michael",11,34,.324,0,0,,11,34,.324,11,18,.611,16,13,29,2,4,5,3,19,33,2000/2001
"Stith,Bryant",245,611,.401,91,242,.376,154,369,.417,175,207,.845,65,219,284,168,93,90,14,182,756,2000/2001
"Stockton,John",328,651,.504,61,132,.462,267,519,.514,227,278,.817,54,173,227,713,132,203,21,194,944,2000/2001
"Stojaković,Peja",559,1189,.470,144,360,.400,415,829,.501,267,312,.856,93,341,434,164,91,146,13,144,1529,2000/2001
"Stoudamire,Damon",406,935,.434,82,219,.374,324,716,.453,172,207,.831,69,234,303,468,106,191,8,202,1066,2000/2001
"Strickland,Erick",81,267,.303,30,95,.316,51,172,.297,68,79,.861,18,110,128,95,44,48,2,88,260,2000/2001
"Strickland,Erick",40,131,.305,16,47,.340,24,84,.286,24,28,.857,9,43,52,29,22,21,1,46,120,2000/2001
"Strickland,Erick",41,136,.301,14,48,.292,27,88,.307,44,51,.863,9,67,76,66,22,27,1,42,140,2000/2001
"Strickland,Mark",103,239,.431,1,2,.500,102,237,.430,45,70,.643,54,107,161,24,16,34,22,72,252,2000/2001
"Strickland,Mark",82,185,.443,0,1,.000,82,184,.446,37,59,.627,43,77,120,17,12,24,19,58,201,2000/2001
"Strickland,Mark",21,54,.389,1,1,1.000,20,53,.377,8,11,.727,11,30,41,7,4,10,3,14,51,2000/2001
"Strickland,Rod",182,429,.424,4,17,.235,178,412,.432,130,173,.751,36,104,140,303,53,107,5,76,498,2000/2001
"Strickland,Rod",141,331,.426,4,16,.250,137,315,.435,115,147,.782,25,80,105,231,43,83,4,55,401,2000/2001
"Strickland,Rod",41,98,.418,0,1,.000,41,97,.423,15,26,.577,11,24,35,72,10,24,1,21,97,2000/2001
"Strong,Derek",45,117,.385,0,1,.000,45,116,.388,28,37,.757,34,74,108,7,14,22,1,30,118,2000/2001
"Šundov,Bruno",20,41,.488,0,4,.000,20,37,.541,3,5,.600,4,19,23,2,2,3,4,21,43,2000/2001
"Sura,Bob",202,518,.390,47,172,.273,155,346,.448,135,189,.714,54,173,227,242,54,160,8,127,586,2000/2001
"Swift,Stromile",153,339,.451,0,4,.000,153,335,.457,85,141,.603,109,175,284,28,62,64,82,160,391,2000/2001
"Szczerbiak,Wally",469,920,.510,26,77,.338,443,843,.526,181,208,.870,133,314,447,260,59,138,33,226,1145,2000/2001
"Tabak,Žan",98,186,.527,0,0,,98,186,.527,20,47,.426,65,148,213,33,10,57,30,125,216,2000/2001
"Tarlać,Dragan",39,99,.394,0,0,,39,99,.394,25,33,.758,37,85,122,31,7,38,19,95,103,2000/2001
"Taylor,Maurice",390,797,.489,0,4,.000,390,793,.492,119,162,.735,109,269,378,104,28,125,38,208,899,2000/2001
"Terry,Jason",596,1367,.436,124,314,.395,472,1053,.448,303,358,.846,42,227,269,403,104,239,12,204,1619,2000/2001
"Thomas,Jamel",6,19,.316,1,3,.333,5,16,.313,0,0,,4,5,9,0,3,6,0,6,13,2000/2001
"Thomas,Kenny",206,465,.443,25,92,.272,181,373,.485,91,126,.722,122,295,417,77,40,116,43,178,528,2000/2001
"Thomas,Kurt",314,614,.511,1,3,.333,313,611,.512,171,210,.814,172,343,515,63,61,99,69,287,800,2000/2001
"Thomas,Tim",326,758,.430,107,260,.412,219,498,.440,195,253,.771,79,234,313,138,78,114,45,194,954,2000/2001
"Thorpe,Otis",59,131,.450,0,0,,59,131,.450,20,24,.833,50,95,145,29,12,32,7,108,138,2000/2001
"Traylor,Robert",161,324,.497,0,2,.000,161,322,.500,80,141,.567,124,176,300,63,49,98,76,204,402,2000/2001
"Trent,Gary",57,130,.438,0,1,.000,57,129,.442,19,36,.528,39,53,92,10,13,22,8,52,133,2000/2001
"Tsakalidis,Jake",101,215,.470,0,0,,101,215,.470,54,91,.593,83,159,242,19,10,66,55,137,256,2000/2001
"Türkoğlu,Hedo",138,335,.412,28,86,.326,110,249,.442,87,112,.777,49,161,210,69,52,55,24,139,391,2000/2001
"Van Exel,Nick",460,1112,.414,135,358,.377,325,754,.431,204,249,.819,44,197,241,600,61,165,18,109,1259,2000/2001
"Van Horn,Keith",308,708,.435,65,170,.382,243,538,.452,150,186,.806,78,269,347,82,40,103,20,150,831,2000/2001
"Vanterpool,David",46,110,.418,0,6,.000,46,104,.442,30,50,.600,15,22,37,66,23,37,3,44,122,2000/2001
"Vaughn,Jacque",170,393,.433,30,78,.385,140,315,.444,128,164,.780,18,132,150,323,48,129,3,145,498,2000/2001
"Vaught,Loy",80,169,.473,0,0,,80,169,.473,8,10,.800,51,122,173,23,21,26,7,74,168,2000/2001
"Vaught,Loy",55,121,.455,0,0,,55,121,.455,4,6,.667,35,88,123,16,15,18,5,61,114,2000/2001
"Vaught,Loy",25,48,.521,0,0,,25,48,.521,4,4,1.000,16,34,50,7,6,8,2,13,54,2000/2001
"Voskuhl,Jake",11,25,.440,0,0,,11,25,.440,8,14,.571,12,22,34,5,5,12,6,38,30,2000/2001
"Walker,Antoine",711,1720,.413,221,603,.367,490,1117,.439,249,348,.716,151,568,719,445,138,301,49,251,1892,2000/2001
"Walker,Samaki",121,252,.480,1,3,.333,120,249,.482,78,124,.629,67,176,243,29,10,68,41,103,321,2000/2001
"Wallace,Ben",215,439,.490,1,4,.250,214,435,.492,80,238,.336,303,749,1052,123,107,117,186,192,511,2000/2001
"Wallace,John",100,236,.424,2,15,.133,98,221,.443,35,45,.778,25,58,83,23,13,36,16,72,237,2000/2001
"Wallace,Rasheed",590,1178,.501,52,162,.321,538,1016,.530,245,320,.766,147,455,602,212,90,158,135,206,1477,2000/2001
"Ward,Charlie",155,373,.416,67,175,.383,88,198,.444,56,70,.800,32,127,159,273,70,112,10,132,433,2000/2001
"Weatherspoon,Clarence",347,692,.501,0,0,,347,692,.501,230,291,.790,223,573,796,103,85,112,105,171,924,2000/2001
"Webber,Chris",786,1635,.481,2,28,.071,784,1607,.488,324,461,.703,179,598,777,294,93,195,118,226,1898,2000/2001
"Wells,Bonzi",387,726,.533,17,50,.340,370,676,.547,159,240,.663,120,247,367,208,94,169,20,203,950,2000/2001
"Wesley,David",523,1239,.422,97,258,.376,426,981,.434,271,339,.799,64,160,224,361,128,171,16,220,1414,2000/2001
"West,Doug",11,38,.289,0,2,.000,11,36,.306,6,7,.857,4,11,15,14,3,4,4,21,28,2000/2001
"White,Jahidi",203,408,.498,0,1,.000,203,407,.499,177,312,.567,178,343,521,20,32,136,111,211,583,2000/2001
"Whitney,Chris",182,470,.387,93,248,.375,89,222,.401,101,113,.894,12,94,106,248,55,103,3,150,558,2000/2001
"Williams,Aaron",297,650,.457,0,2,.000,297,648,.458,244,310,.787,211,379,590,88,59,132,113,319,838,2000/2001
"Williams,Alvin",330,767,.430,33,108,.306,297,659,.451,109,145,.752,50,162,212,407,123,103,26,171,802,2000/2001
"Williams,Eric",162,448,.362,46,139,.331,116,309,.375,165,231,.714,64,143,207,112,64,76,13,179,535,2000/2001
"Williams,Jason",281,690,.407,98,311,.315,183,379,.483,60,76,.789,19,166,185,416,94,160,9,114,720,2000/2001
"Williams,Jerome",136,294,.463,0,3,.000,136,291,.467,100,135,.741,133,249,382,45,57,63,20,124,372,2000/2001
"Williams,Jerome",88,201,.438,0,2,.000,88,199,.442,65,90,.722,98,180,278,32,39,47,10,81,241,2000/2001
"Williams,Jerome",48,93,.516,0,1,.000,48,92,.522,35,45,.778,35,69,104,13,18,16,10,43,131,2000/2001
"Williams,Monty",162,364,.445,1,13,.077,161,351,.459,85,133,.639,86,157,243,79,29,85,16,136,410,2000/2001
"Williams,Scott",171,361,.474,1,4,.250,170,357,.476,60,70,.857,97,267,364,35,48,41,32,178,403,2000/2001
"Williams,Shammond",161,368,.438,61,133,.459,100,235,.426,84,96,.875,34,98,132,190,31,82,4,83,467,2000/2001
"Williams,Walt",202,513,.394,98,248,.395,104,265,.392,97,126,.770,31,214,245,97,30,73,28,153,599,2000/2001
"Williamson,Corliss",325,647,.502,0,2,.000,325,645,.504,151,237,.637,110,211,321,61,50,110,21,185,801,2000/2001
"Williamson,Corliss",153,325,.471,0,2,.000,153,323,.474,84,130,.646,57,96,153,33,15,65,13,98,390,2000/2001
"Williamson,Corliss",172,322,.534,0,0,,172,322,.534,67,107,.626,53,115,168,28,35,45,8,87,411,2000/2001
"Willis,Kevin",304,690,.441,1,6,.167,303,684,.443,113,147,.769,177,355,532,50,57,87,52,216,722,2000/2001
"Willis,Kevin",124,269,.461,0,2,.000,124,267,.464,61,81,.753,68,155,223,21,19,40,21,78,309,2000/2001
"Willis,Kevin",180,421,.428,1,4,.250,179,417,.429,52,66,.788,109,200,309,29,38,47,31,138,413,2000/2001
"Wingate,David",3,3,1.000,0,0,,3,3,1.000,0,0,,0,0,0,2,0,0,0,1,6,2000/2001
"Wolkowyski,Rubén",25,79,.316,0,2,.000,25,77,.325,25,34,.735,12,34,46,3,6,12,18,38,75,2000/2001
"World Peace,Metta",327,815,.401,43,148,.291,284,667,.426,210,280,.750,59,235,294,228,152,159,45,254,907,2000/2001
"Wright,Lorenzen",363,811,.448,0,2,.000,363,809,.449,155,216,.718,180,355,535,87,42,125,63,232,881,2000/2001
"Zhizhi,Wang",8,19,.421,0,2,.000,8,17,.471,8,10,.800,1,6,7,0,0,1,0,8,24,2000/2001
"Abdul-Wahad,Tariq",55,147,.374,1,2,.500,54,145,.372,24,33,.727,41,43,84,24,20,27,10,56,135,2001/2002
"Abdul-Wahad,Tariq",55,145,.379,1,2,.500,54,143,.378,24,32,.750,39,39,78,22,18,24,9,51,135,2001/2002
"Abdul-Wahad,Tariq",0,2,.000,0,0,,0,2,.000,0,1,.000,2,4,6,2,2,3,1,5,0,2001/2002
"Abdur-Rahim,Shareef",598,1297,.461,21,70,.300,577,1227,.470,419,523,.801,198,498,696,239,98,250,81,214,1636,2001/2002
"Alexander,Courtney",223,474,.470,5,18,.278,218,456,.478,98,121,.810,43,105,148,86,35,60,7,113,549,2001/2002
"Alexander,Victor",18,51,.353,0,2,.000,18,49,.367,4,8,.500,7,22,29,6,0,5,1,6,40,2001/2002
"Allen,Malik",22,51,.431,0,1,.000,22,50,.440,8,10,.800,15,23,38,5,3,2,8,16,52,2001/2002
"Allen,Ray",530,1148,.462,229,528,.434,301,620,.485,214,245,.873,81,231,312,271,88,159,18,157,1503,2001/2002
"Alston,Rafer",66,191,.346,27,71,.380,39,120,.325,18,29,.621,10,62,72,143,32,40,2,42,177,2001/2002
"Amaechi,John",54,166,.325,0,0,,54,166,.325,67,105,.638,52,57,109,29,7,55,10,64,175,2001/2002
"Andersen,Chris",25,74,.338,0,4,.000,25,70,.357,22,28,.786,38,38,76,7,7,13,28,35,72,2001/2002
"Anderson,Derek",247,612,.404,85,228,.373,162,384,.422,178,208,.856,47,142,189,216,68,87,8,113,757,2001/2002
"Anderson,Kenny",312,716,.436,9,33,.273,303,683,.444,98,132,.742,57,218,275,403,141,119,10,210,731,2001/2002
"Anderson,Nick",21,76,.276,13,48,.271,8,28,.286,5,9,.556,1,32,33,14,6,14,6,17,60,2001/2002
"Anderson,Shandon",149,373,.399,39,141,.277,110,232,.474,74,107,.692,57,192,249,76,48,97,15,134,411,2001/2002
"Anthony,Greg",183,475,.385,48,163,.294,135,312,.433,60,91,.659,22,110,132,282,77,94,5,114,474,2001/2002
"Anthony,Greg",113,287,.394,29,90,.322,84,197,.426,47,70,.671,16,72,88,203,49,58,4,72,302,2001/2002
"Anthony,Greg",70,188,.372,19,73,.260,51,115,.443,13,21,.619,6,38,44,79,28,36,1,42,172,2001/2002
"Arenas,Gilbert",174,384,.453,39,113,.345,135,271,.498,124,160,.775,41,91,132,174,69,97,11,115,511,2001/2002
"Armstrong,Brandon",27,85,.318,5,17,.294,22,68,.324,5,10,.500,10,6,16,8,7,8,1,26,64,2001/2002
"Armstrong,Darrell",347,828,.419,139,398,.349,208,430,.484,182,205,.888,83,236,319,453,157,175,10,166,1015,2001/2002
"Arroyo,Carlos",49,111,.441,0,2,.000,49,109,.450,13,18,.722,12,28,40,70,11,23,1,30,111,2001/2002
"Arroyo,Carlos",13,29,.448,0,0,,13,29,.448,4,6,.667,3,9,12,21,6,12,0,12,30,2001/2002
"Arroyo,Carlos",36,82,.439,0,2,.000,36,80,.450,9,12,.750,9,19,28,49,5,11,1,18,81,2001/2002
"Atkins,Chucky",368,790,.466,138,336,.411,230,454,.507,83,120,.692,31,127,158,263,72,128,11,177,957,2001/2002
"Augmon,Stacey",140,328,.427,0,3,.000,140,325,.431,77,101,.762,59,166,225,103,56,54,12,115,357,2001/2002
"Austin,Isaac",36,92,.391,0,3,.000,36,89,.404,4,4,1.000,11,60,71,13,9,11,5,36,76,2001/2002
"Avery,William",26,90,.289,6,35,.171,20,55,.364,13,19,.684,4,20,24,36,7,19,0,17,71,2001/2002
"Bagarić,Dalibor",72,178,.404,0,1,.000,72,177,.407,41,70,.586,55,107,162,23,17,46,24,108,185,2001/2002
"Baker,Vin",315,649,.485,1,8,.125,314,641,.490,143,226,.633,168,182,350,72,22,127,36,197,774,2001/2002
"Barkley,Erick",24,68,.353,1,7,.143,23,61,.377,9,10,.900,5,13,18,34,17,12,1,29,58,2001/2002
"Barros,Dana",74,192,.385,24,71,.338,50,121,.413,21,27,.778,1,56,57,78,14,33,2,37,193,2001/2002
"Barry,Brent",401,790,.508,164,387,.424,237,403,.588,198,234,.846,58,383,441,426,147,165,37,182,1164,2001/2002
"Barry,Jon",255,522,.489,121,258,.469,134,264,.508,108,116,.931,42,192,234,274,94,111,20,134,739,2001/2002
"Bateer,Mengke",53,132,.402,4,12,.333,49,120,.408,29,37,.784,32,64,96,22,10,32,5,94,139,2001/2002
"Battie,Tony",211,390,.541,0,2,.000,211,388,.544,88,130,.677,184,297,481,35,60,51,67,219,510,2001/2002
"Battier,Shane",412,961,.429,103,276,.373,309,685,.451,198,283,.700,180,238,418,216,121,155,81,215,1125,2001/2002
"Bell,Charlie",3,11,.273,0,6,.000,3,5,.600,2,2,1.000,2,3,5,2,0,5,0,3,8,2001/2002
"Bell,Charlie",3,11,.273,0,6,.000,3,5,.600,2,2,1.000,2,2,4,2,0,5,0,3,8,2001/2002
"Bell,Charlie",0,0,,0,0,,0,0,,0,0,,0,1,1,0,0,0,0,0,0,2001/2002
"Bell,Raja",103,240,.429,12,44,.273,91,196,.464,36,48,.750,31,80,111,71,21,48,4,109,254,2001/2002
"Bender,Jonathan",198,460,.430,45,125,.360,153,335,.457,140,181,.773,64,180,244,62,19,96,49,147,581,2001/2002
"Best,Travis",228,518,.440,21,59,.356,207,459,.451,104,116,.897,20,131,151,324,89,99,7,173,581,2001/2002
"Best,Travis",116,264,.439,13,34,.382,103,230,.448,57,65,.877,10,60,70,175,57,59,6,101,302,2001/2002
"Best,Travis",112,254,.441,8,25,.320,104,229,.454,47,51,.922,10,71,81,149,32,40,1,72,279,2001/2002
"Bibby,Mike",446,985,.453,51,138,.370,395,847,.466,155,193,.803,37,185,222,403,87,134,15,133,1098,2001/2002
"Billups,Chauncey",348,823,.423,124,315,.394,224,508,.441,207,234,.885,35,191,226,450,66,138,17,169,1027,2001/2002
"Blaylock,Mookie",50,146,.342,15,42,.357,35,104,.337,4,8,.500,8,44,52,114,24,37,4,20,119,2001/2002
"Blount,Corie",115,251,.458,0,1,.000,115,250,.460,29,45,.644,149,219,368,44,49,52,26,176,259,2001/2002
"Blount,Mark",32,76,.421,0,0,,32,76,.421,30,37,.811,26,59,85,10,16,23,19,59,94,2001/2002
"Booth,Calvin",35,82,.427,0,0,,35,82,.427,23,24,.958,20,34,54,16,6,16,13,47,93,2001/2002
"Boumtje-Boumtje,Ruben",13,32,.406,0,0,,13,32,.406,13,25,.520,21,34,55,4,3,14,16,38,39,2001/2002
"Bowdler,Cal",61,174,.351,1,5,.200,60,169,.355,39,47,.830,38,72,110,11,18,11,15,64,162,2001/2002
"Bowen,Bruce",155,398,.389,56,148,.378,99,250,.396,46,96,.479,42,120,162,88,62,66,25,116,412,2001/2002
"Bowen,Ryan",147,307,.479,1,12,.083,146,295,.495,69,92,.750,134,165,299,52,75,41,41,171,364,2001/2002
"Bowman,Ira",5,7,.714,0,1,.000,5,6,.833,0,0,,0,1,1,1,2,0,0,3,10,2001/2002
"Boykins,Earl",110,275,.400,13,42,.310,97,233,.416,47,61,.770,27,27,54,145,20,44,2,44,280,2001/2002
"Bradley,Michael",13,25,.520,0,2,.000,13,23,.565,4,8,.500,7,17,24,3,0,6,6,10,30,2001/2002
"Bradley,Shawn",78,163,.479,0,1,.000,78,162,.481,59,64,.922,53,123,176,20,28,25,64,128,215,2001/2002
"Brand,Elton",532,1010,.527,0,0,,532,1010,.527,389,524,.742,396,529,925,191,80,173,163,254,1453,2001/2002
"Brandon,Terrell",155,365,.425,4,23,.174,151,342,.442,83,84,.988,17,76,93,264,52,43,6,49,397,2001/2002
"Brewer,Jamison",2,5,.400,0,1,.000,2,4,.500,0,0,,2,6,8,9,2,3,0,3,4,2001/2002
"Brezec,Primož",14,29,.483,0,0,,14,29,.483,15,25,.600,16,12,28,6,0,6,7,28,43,2001/2002
"Brown,Chucky",10,27,.370,0,0,,10,27,.370,1,2,.500,10,23,33,6,2,5,4,12,21,2001/2002
"Brown,Damone",8,21,.381,0,1,.000,8,20,.400,7,8,.875,2,2,4,2,1,9,1,11,23,2001/2002
"Brown,Dee",3,20,.150,1,12,.083,2,8,.250,0,0,,0,9,9,2,3,4,1,4,7,2001/2002
"Brown,Ernest",1,6,.167,0,0,,1,6,.167,1,4,.250,1,5,6,0,0,3,1,4,3,2001/2002
"Brown,Kedrick",23,70,.329,5,27,.185,18,43,.419,12,20,.600,11,39,50,15,18,7,7,18,63,2001/2002
"Brown,Kwame",94,243,.387,0,1,.000,94,242,.388,70,99,.707,63,135,198,43,16,43,26,105,258,2001/2002
"Brown,P.J.",250,527,.474,0,0,,250,527,.474,169,197,.858,273,513,786,107,59,85,78,222,669,2001/2002
"Brown,Randy",0,1,.000,0,0,,0,1,.000,0,0,,0,0,0,2,0,0,1,1,0,2001/2002
"Brown,Tierre",49,115,.426,4,12,.333,45,103,.437,21,28,.750,12,30,42,70,19,40,3,26,123,2001/2002
"Brunson,Rick",45,113,.398,6,11,.545,39,102,.382,29,41,.707,23,45,68,114,25,47,2,51,125,2001/2002
"Bryant,Kobe",749,1597,.469,33,132,.250,716,1465,.489,488,589,.829,112,329,441,438,118,223,35,228,2019,2001/2002
"Bryant,Mark",25,55,.455,0,0,,25,55,.455,6,8,.750,25,19,44,10,7,6,2,38,56,2001/2002
"Buckner,Greg",104,198,.525,5,16,.313,99,182,.544,40,58,.690,67,106,173,48,31,27,19,124,253,2001/2002
"Buechler,Jud",44,118,.373,21,60,.350,23,58,.397,2,4,.500,29,87,116,32,21,15,8,53,111,2001/2002
"Buechler,Jud",2,6,.333,2,6,.333,0,0,,0,0,,2,6,8,3,1,1,0,7,6,2001/2002
"Buechler,Jud",42,112,.375,19,54,.352,23,58,.397,2,4,.500,27,81,108,29,20,14,8,46,105,2001/2002
"Buford,Rodney",258,593,.435,17,70,.243,241,523,.461,58,80,.725,52,220,272,71,42,63,12,110,591,2001/2002
"Bullard,Matt",39,115,.339,16,57,.281,23,58,.397,11,12,.917,10,37,47,16,2,12,2,29,105,2001/2002
"Butler,Mitchell",10,23,.435,1,3,.333,9,20,.450,8,12,.667,6,8,14,5,0,5,1,10,29,2001/2002
"Caffey,Jason",36,72,.500,0,1,.000,36,71,.507,27,43,.628,24,26,50,12,4,19,5,39,99,2001/2002
"Camby,Marcus",130,290,.448,0,1,.000,130,289,.450,62,99,.626,89,233,322,33,34,42,50,107,322,2001/2002
"Campbell,Elden",384,794,.484,0,2,.000,384,792,.485,306,384,.797,133,397,530,102,60,138,137,264,1074,2001/2002
"Cardinal,Brian",6,13,.462,3,7,.429,3,6,.500,2,2,1.000,2,4,6,2,1,0,0,5,17,2001/2002
"Carter,Anthony",89,260,.342,1,19,.053,88,241,.365,19,36,.528,19,98,117,214,50,72,3,85,198,2001/2002
"Carter,Vince",559,1307,.428,121,313,.387,438,994,.441,245,307,.798,138,175,313,239,94,154,43,191,1484,2001/2002
"Cassell,Sam",554,1197,.463,71,204,.348,483,993,.486,282,328,.860,54,258,312,493,90,177,12,208,1461,2001/2002
"Cato,Kelvin",190,326,.583,0,1,.000,190,325,.585,113,194,.582,176,349,525,29,40,53,95,208,493,2001/2002
"Chandler,Tyson",151,304,.497,0,0,,151,304,.497,134,222,.604,114,229,343,54,28,99,93,179,436,2001/2002
"Cheaney,Calbert",224,466,.481,0,4,.000,224,462,.485,46,67,.687,57,183,240,110,34,70,21,156,494,2001/2002
"Childs,Chris",97,296,.328,33,120,.275,64,176,.364,58,71,.817,18,136,154,351,56,123,5,177,285,2001/2002
"Christie,Doug",338,735,.460,90,256,.352,248,479,.518,206,242,.851,74,300,374,340,160,164,25,209,972,2001/2002
"Clark,Keon",380,775,.490,0,5,.000,380,770,.494,155,230,.674,182,421,603,88,58,140,122,258,915,2001/2002
"Claxton,Speedy",181,452,.400,4,33,.121,177,419,.422,114,136,.838,46,114,160,198,95,95,6,145,480,2001/2002
"Cleaves,Mateen",30,68,.441,2,8,.250,28,60,.467,8,9,.889,1,7,8,25,7,27,0,9,70,2001/2002
"Coleman,Derrick",331,735,.450,28,83,.337,303,652,.465,185,227,.815,167,342,509,98,42,119,51,158,875,2001/2002
"Coles,Bimbo",56,146,.384,4,20,.200,52,126,.413,33,37,.892,12,43,55,107,13,31,4,59,149,2001/2002
"Collier,Jason",41,95,.432,0,1,.000,41,94,.436,24,32,.750,31,51,82,9,6,13,4,40,106,2001/2002
"Collins,Jarron",158,343,.461,0,1,.000,158,342,.462,134,181,.740,138,158,296,58,29,56,22,234,450,2001/2002
"Collins,Jason",117,278,.421,1,2,.500,116,276,.420,115,164,.701,132,169,301,81,29,72,47,173,350,2001/2002
"Crawford,Chris",21,45,.467,0,1,.000,21,44,.477,11,15,.733,9,16,25,5,2,10,5,21,53,2001/2002
"Crawford,Jamal",89,187,.476,26,58,.448,63,129,.488,10,13,.769,5,29,34,55,18,32,5,18,214,2001/2002
"Crispin,Joe",26,68,.382,15,39,.385,11,29,.379,12,13,.923,2,9,11,26,5,10,0,10,79,2001/2002
"Crispin,Joe",3,12,.250,0,4,.000,3,8,.375,4,5,.800,0,1,1,2,1,1,0,2,10,2001/2002
"Crispin,Joe",23,56,.411,15,35,.429,8,21,.381,8,8,1.000,2,8,10,24,4,9,0,8,69,2001/2002
"Croshere,Austin",185,448,.413,49,145,.338,136,303,.449,97,114,.851,74,220,294,77,26,67,29,106,516,2001/2002
"Crotty,John",98,208,.471,31,69,.449,67,139,.482,57,66,.864,16,59,75,141,19,51,1,77,284,2001/2002
"Cummings,Vonteego",78,187,.417,12,46,.261,66,141,.468,24,32,.750,14,38,52,60,18,36,5,53,192,2001/2002
"Curry,Dell",141,347,.406,45,131,.344,96,216,.444,33,37,.892,23,58,81,61,22,41,6,50,360,2001/2002
"Curry,Eddy",189,377,.501,0,0,,189,377,.501,105,160,.656,111,161,272,25,16,69,53,173,483,2001/2002
"Curry,Michael",125,276,.453,7,26,.269,118,250,.472,72,91,.791,15,153,168,127,47,60,10,207,329,2001/2002
"Dalembert,Samuel",22,50,.440,0,0,,22,50,.440,7,18,.389,25,43,68,5,6,14,13,30,51,2001/2002
"Dampier,Erick",209,480,.435,0,0,,209,480,.435,136,211,.645,167,220,387,87,17,156,167,235,554,2001/2002
"Daniels,Antonio",269,612,.440,57,196,.291,212,416,.510,158,210,.752,23,153,176,228,48,70,12,104,753,2001/2002
"Davis,Antonio",410,963,.426,0,1,.000,410,962,.426,293,358,.818,254,486,740,155,54,159,83,225,1113,2001/2002
"Davis,Baron",559,1341,.417,170,478,.356,389,863,.451,196,338,.580,93,256,349,698,172,246,47,241,1484,2001/2002
"Davis,Dale",296,580,.510,0,0,,296,580,.510,150,212,.708,262,426,688,96,62,62,83,193,742,2001/2002
"Davis,Emanual",70,198,.354,29,85,.341,41,113,.363,16,18,.889,19,55,74,68,27,52,5,68,185,2001/2002
"Davis,Hubert",146,326,.448,57,126,.452,89,200,.445,16,21,.762,7,70,77,107,28,44,3,58,365,2001/2002
"Davis,Ricky",376,781,.481,11,35,.314,365,746,.489,196,248,.790,63,180,243,178,69,148,23,145,959,2001/2002
"DeClercq,Andrew",67,149,.450,0,0,,67,149,.450,28,50,.560,74,89,163,22,23,34,24,130,162,2001/2002
"Del Negro,Vinny",1,4,.250,0,0,,1,4,.250,0,0,,0,0,0,2,0,0,0,0,2,2001/2002
"Delk,Tony",226,588,.384,67,214,.313,159,374,.425,78,97,.804,58,145,203,132,53,59,10,98,597,2001/2002
"Delk,Tony",166,416,.399,47,147,.320,119,269,.442,56,67,.836,38,86,124,81,31,40,4,60,435,2001/2002
"Delk,Tony",60,172,.349,20,67,.299,40,105,.381,22,30,.733,20,59,79,51,22,19,6,38,162,2001/2002
"Dial,Derrick",41,120,.342,1,11,.091,40,109,.367,18,24,.750,14,42,56,35,10,16,4,13,101,2001/2002
"Dial,Derrick",30,94,.319,0,7,.000,30,87,.345,13,18,.722,12,33,45,31,8,13,4,12,73,2001/2002
"Dial,Derrick",11,26,.423,1,4,.250,10,22,.455,5,6,.833,2,9,11,4,2,3,0,1,28,2001/2002
"Dickerson,Michael",15,48,.313,8,21,.381,7,27,.259,5,6,.833,3,9,12,9,3,8,1,12,43,2001/2002
"Diop,DeSagana",12,29,.414,0,0,,12,29,.414,1,5,.200,5,12,17,5,1,12,10,19,25,2001/2002
"Divac,Vlade",338,716,.472,3,13,.231,335,703,.477,209,340,.615,205,466,671,297,79,158,94,229,888,2001/2002
"Doleac,Michael",78,187,.417,0,0,,78,187,.417,38,46,.826,47,121,168,25,15,37,11,98,194,2001/2002
"Dooling,Keyon",22,57,.386,4,14,.286,18,43,.419,10,12,.833,0,3,3,12,4,10,3,20,58,2001/2002
"Drew,Bryce",78,182,.429,31,73,.425,47,109,.431,23,29,.793,14,58,72,101,32,33,2,49,210,2001/2002
"Drobnjak,Predrag",191,414,.461,0,2,.000,191,412,.464,55,73,.753,75,144,219,51,20,51,31,109,437,2001/2002
"Dudley,Chris",20,50,.400,0,2,.000,20,48,.417,8,15,.533,27,53,80,13,3,14,14,42,48,2001/2002
"Duncan,Tim",764,1504,.508,1,10,.100,763,1494,.511,560,701,.799,268,774,1042,307,61,263,203,217,2089,2001/2002
"Eisley,Howard",59,175,.337,14,58,.241,45,117,.385,39,49,.796,9,40,49,100,24,53,3,55,171,2001/2002
"Ekezie,Obinna",13,39,.333,0,0,,13,39,.333,28,40,.700,12,22,34,3,2,10,6,16,54,2001/2002
"Ellis,LaPhonso",189,452,.418,38,124,.306,151,328,.460,53,84,.631,107,180,287,56,30,73,37,196,469,2001/2002
"Eschmeyer,Evan",21,50,.420,0,0,,21,50,.420,20,33,.606,35,63,98,9,10,16,9,60,62,2001/2002
"Evans,Maurice",9,19,.474,0,3,.000,9,16,.563,3,4,.750,3,1,4,4,0,2,0,9,21,2001/2002
"Ewing,Patrick",148,333,.444,0,1,.000,148,332,.446,94,134,.701,60,203,263,35,22,65,45,129,390,2001/2002
"Ferry,Danny",76,177,.429,43,99,.434,33,78,.423,34,36,.944,15,75,90,48,16,22,9,70,229,2001/2002
"Finley,Michael",569,1228,.463,76,224,.339,493,1004,.491,210,251,.837,90,270,360,230,65,117,25,144,1424,2001/2002
"Fisher,Derek",274,666,.411,144,349,.413,130,317,.410,94,111,.847,15,131,146,181,66,62,9,121,786,2001/2002
"Fizer,Marcus",371,848,.438,7,41,.171,364,807,.451,189,283,.668,128,299,427,120,49,131,24,186,938,2001/2002
"Fontaine,Isaac",3,14,.214,1,5,.200,2,9,.222,4,6,.667,0,5,5,4,0,4,0,6,11,2001/2002
"Ford,Alton",61,118,.517,0,0,,61,118,.517,42,57,.737,32,75,107,7,6,32,7,99,164,2001/2002
"Forte,Joseph",1,12,.083,0,3,.000,1,9,.111,4,4,1.000,1,5,6,6,2,3,0,1,6,2001/2002
"Fortson,Danny",309,722,.428,1,4,.250,308,718,.429,245,308,.795,290,609,899,127,44,160,17,255,864,2001/2002
"Foster,Greg",2,9,.222,0,4,.000,2,5,.400,3,4,.750,0,8,8,1,0,0,0,4,7,2001/2002
"Foster,Jeff",177,394,.449,2,15,.133,175,379,.462,111,182,.610,206,350,556,70,71,79,38,232,467,2001/2002
"Fotsis,Antonis",42,104,.404,7,23,.304,35,81,.432,17,20,.850,25,37,62,10,9,21,11,22,108,2001/2002
"Fowlkes,Tremaine",25,64,.391,0,0,,25,64,.391,24,31,.774,32,32,64,17,11,13,1,39,74,2001/2002
"Fox,Rick",255,605,.421,65,208,.313,190,397,.479,70,85,.824,90,299,389,283,67,132,21,244,645,2001/2002
"Foyle,Adonal",171,385,.444,0,0,,171,385,.444,37,93,.398,150,234,384,41,36,76,168,179,379,2001/2002
"Francis,Steve",420,1007,.417,68,210,.324,352,797,.442,326,422,.773,102,299,401,362,71,221,25,172,1234,2001/2002
"Funderburke,Lawrence",115,245,.469,0,3,.000,115,242,.475,34,56,.607,76,122,198,32,11,33,18,65,264,2001/2002
"Garnett,Kevin",659,1401,.470,37,116,.319,622,1285,.484,359,448,.801,243,738,981,422,96,229,126,184,1714,2001/2002
"Garrett,Dean",18,55,.327,0,0,,18,55,.327,0,3,.000,16,41,57,5,7,10,10,32,36,2001/2002
"Garrett,Dean",14,40,.350,0,0,,14,40,.350,0,3,.000,13,34,47,4,5,7,9,26,28,2001/2002
"Garrett,Dean",4,15,.267,0,0,,4,15,.267,0,0,,3,7,10,1,2,3,1,6,8,2001/2002
"Garrity,Pat",327,767,.426,169,396,.427,158,371,.426,61,73,.836,77,261,338,99,61,68,28,230,884,2001/2002
"Gasol,Pau",551,1064,.518,1,5,.200,550,1059,.519,338,477,.709,238,492,730,223,41,224,169,195,1441,2001/2002
"Gatling,Chris",131,293,.447,1,8,.125,130,285,.456,82,117,.701,71,135,206,25,17,58,11,109,345,2001/2002
"Geiger,Matt",1,8,.125,0,0,,1,8,.125,1,2,.500,3,3,6,0,0,2,2,2,3,2001/2002
"George,Devean",215,523,.411,66,178,.371,149,345,.432,85,126,.675,78,225,303,111,71,66,42,190,581,2001/2002
"Gill,Eddie",39,92,.424,7,22,.318,32,70,.457,31,39,.795,7,21,28,49,11,34,3,38,116,2001/2002
"Gill,Kendall",162,422,.384,6,44,.136,156,378,.413,42,62,.677,29,155,184,100,44,55,8,140,372,2001/2002
"Glover,Dion",192,456,.421,30,91,.330,162,365,.444,78,103,.757,36,133,169,84,45,76,14,89,492,2001/2002
"Goodrich,Steve",2,10,.200,0,0,,2,10,.200,1,2,.500,1,4,5,5,1,3,2,10,5,2001/2002
"Grant,Brian",286,610,.469,0,2,.000,286,608,.470,101,119,.849,168,407,575,137,48,122,31,236,673,2001/2002
"Grant,Horace",264,515,.513,0,0,,264,515,.513,80,111,.721,159,322,481,104,57,51,49,118,608,2001/2002
"Griffin,Adrian",179,359,.499,16,54,.296,163,305,.534,41,49,.837,68,161,229,106,75,42,12,142,415,2001/2002
"Griffin,Eddie",244,666,.366,90,273,.330,154,393,.392,64,86,.744,117,299,416,53,17,47,134,117,642,2001/2002
"Gugliotta,Tom",127,301,.422,3,9,.333,124,292,.425,28,37,.757,59,162,221,77,39,61,30,116,285,2001/2002
"Guyton,A.J.",88,244,.361,46,123,.374,42,121,.347,22,27,.815,12,32,44,81,10,37,7,23,244,2001/2002
"Ham,Darvin",120,211,.569,1,7,.143,119,204,.583,62,123,.504,91,111,202,73,25,83,37,175,303,2001/2002
"Hamilton,Richard",472,1084,.435,16,42,.381,456,1042,.438,300,337,.890,73,143,216,171,38,132,14,136,1260,2001/2002
"Hamilton,Tang",10,19,.526,0,1,.000,10,18,.556,0,1,.000,6,12,18,5,4,2,0,10,20,2001/2002
"Hamilton,Zendon",103,245,.420,0,0,,103,245,.420,118,181,.652,110,143,253,14,21,60,18,104,324,2001/2002
"Hardaway,Anfernee",389,931,.418,23,83,.277,366,848,.432,158,195,.810,98,252,350,324,122,189,32,184,959,2001/2002
"Hardaway,Tim",226,620,.365,123,354,.347,103,266,.387,77,97,.794,14,110,124,278,57,111,10,109,652,2001/2002
"Hardaway,Tim",179,494,.362,95,279,.341,84,215,.391,65,78,.833,13,84,97,201,40,73,8,84,518,2001/2002
"Hardaway,Tim",47,126,.373,28,75,.373,19,51,.373,12,19,.632,1,26,27,77,17,38,2,25,134,2001/2002
"Harpring,Matt",386,838,.461,21,69,.304,365,769,.475,165,222,.743,203,370,573,107,70,127,5,201,958,2001/2002
"Harrington,Al",230,484,.475,1,3,.333,229,481,.476,115,144,.799,96,180,276,54,41,78,21,166,576,2001/2002
"Harrington,Othella",237,450,.527,0,2,.000,237,448,.529,122,172,.709,125,224,349,37,30,95,36,250,596,2001/2002
"Harris,Lucious",249,537,.464,44,118,.373,205,419,.489,133,158,.842,49,158,207,116,53,61,6,99,675,2001/2002
"Hart,Jason",10,19,.526,0,2,.000,10,17,.588,6,6,1.000,4,9,13,12,7,8,1,16,26,2001/2002
"Harvey,Antonio",4,12,.333,0,0,,4,12,.333,1,2,.500,5,4,9,5,1,3,3,8,9,2001/2002
"Harvey,Donnell",108,217,.498,0,0,,108,217,.498,54,90,.600,80,147,227,37,21,33,24,115,270,2001/2002
"Harvey,Donnell",14,26,.538,0,0,,14,26,.538,10,22,.455,12,34,46,5,4,8,5,27,38,2001/2002
"Harvey,Donnell",94,191,.492,0,0,,94,191,.492,44,68,.647,68,113,181,32,17,25,19,88,232,2001/2002
"Hassell,Trenton",267,628,.425,60,165,.364,207,463,.447,87,114,.763,65,190,255,172,55,101,44,184,681,2001/2002
"Haston,Kirk",11,39,.282,0,3,.000,11,36,.306,4,8,.500,5,15,20,5,0,3,1,9,26,2001/2002
"Haywood,Brendan",109,221,.493,0,0,,109,221,.493,97,160,.606,143,179,322,29,21,50,91,158,315,2001/2002
"Henderson,Alan",59,116,.509,1,1,1.000,58,115,.504,24,45,.533,31,66,97,11,11,21,15,40,143,2001/2002
"Henderson,Cedric",15,31,.484,2,4,.500,13,27,.481,4,7,.571,1,2,3,4,6,8,2,4,36,2001/2002
"Hill,Grant",83,195,.426,0,2,.000,83,193,.430,69,80,.863,29,96,125,64,8,37,4,40,235,2001/2002
"Hill,Tyrone",71,182,.390,0,1,.000,71,181,.392,67,103,.650,79,195,274,23,17,48,13,102,209,2001/2002
"Hoiberg,Fred",121,291,.416,24,92,.261,97,199,.487,79,94,.840,18,192,210,136,61,32,5,87,345,2001/2002
"Horry,Robert",183,460,.398,76,203,.374,107,257,.416,108,138,.783,130,349,479,232,77,88,89,208,550,2001/2002
"House,Eddie",209,524,.399,54,157,.344,155,367,.422,42,49,.857,17,93,110,123,43,80,5,98,514,2001/2002
"Houston,Allan",568,1301,.437,136,346,.393,432,955,.452,295,339,.870,37,215,252,190,54,170,10,182,1567,2001/2002
"Howard,Juwan",462,1005,.460,0,2,.000,462,1003,.461,261,343,.761,223,389,612,169,46,152,47,265,1185,2001/2002
"Howard,Juwan",270,585,.462,0,1,.000,270,584,.462,144,191,.754,138,252,390,93,28,78,30,170,684,2001/2002
"Howard,Juwan",192,420,.457,0,1,.000,192,419,.458,117,152,.770,85,137,222,76,18,74,17,95,501,2001/2002
"Hudson,Troy",354,815,.434,66,187,.353,288,628,.459,176,201,.876,30,115,145,255,57,163,6,119,950,2001/2002
"Hughes,Larry",343,810,.423,18,93,.194,325,717,.453,191,259,.737,83,162,245,316,113,171,23,150,895,2001/2002
"Hunter,Lindsey",187,490,.382,79,208,.380,108,282,.383,20,40,.500,18,103,121,129,66,55,19,120,473,2001/2002
"Hunter,Steven",67,147,.456,0,0,,67,147,.456,55,94,.585,40,57,97,5,5,16,43,81,189,2001/2002
"Ilgauskas,Zydrunas",241,567,.425,0,5,.000,241,562,.429,208,276,.754,136,198,334,70,17,94,84,187,690,2001/2002
"Iverson,Allen",665,1669,.398,78,268,.291,587,1401,.419,475,585,.812,44,225,269,331,168,237,13,102,1883,2001/2002
"Jackson,Bobby",334,754,.443,79,219,.361,255,535,.477,149,184,.810,82,169,251,164,73,93,11,145,896,2001/2002
"Jackson,Jaren",15,37,.405,7,20,.350,8,17,.471,2,4,.500,1,16,17,8,5,8,0,13,39,2001/2002
"Jackson,Jermaine",20,42,.476,1,2,.500,19,40,.475,16,24,.667,3,24,27,57,9,14,1,24,57,2001/2002
"Jackson,Jim",238,538,.442,38,81,.469,200,457,.438,75,87,.862,54,236,290,140,42,106,14,145,589,2001/2002
"Jackson,Marc",60,164,.366,0,1,.000,60,163,.368,66,80,.825,48,80,128,14,11,30,6,69,186,2001/2002
"Jackson,Marc",22,65,.338,0,0,,22,65,.338,40,48,.833,17,26,43,7,5,12,3,25,84,2001/2002
"Jackson,Marc",38,99,.384,0,1,.000,38,98,.388,26,32,.813,31,54,85,7,6,18,3,44,102,2001/2002
"Jackson,Mark",260,592,.439,79,195,.405,181,397,.456,87,110,.791,56,253,309,605,74,150,1,162,686,2001/2002
"Jackson,Stephen",34,91,.374,9,36,.250,25,55,.455,12,17,.706,3,23,26,11,15,23,3,29,89,2001/2002
"James,Jerome",134,273,.491,0,0,,134,273,.491,30,60,.500,89,143,232,24,25,74,86,174,298,2001/2002
"James,Mike",15,43,.349,8,21,.381,7,22,.318,4,7,.571,2,12,14,19,6,13,1,17,42,2001/2002
"James,Tim",5,13,.385,0,0,,5,13,.385,2,6,.333,5,2,7,1,0,3,1,5,12,2001/2002
"Jamison,Antawn",614,1375,.447,68,210,.324,546,1165,.469,323,440,.734,211,345,556,161,70,161,45,187,1619,2001/2002
"Jamison,Harold",22,43,.512,0,0,,22,43,.512,10,15,.667,24,15,39,6,5,6,1,23,54,2001/2002
"Jefferson,Richard",270,591,.457,13,56,.232,257,535,.480,189,265,.713,85,208,293,140,64,107,48,211,742,2001/2002
"Johnson,Anthony",37,90,.411,4,12,.333,33,78,.423,16,25,.640,10,19,29,48,31,20,1,30,94,2001/2002
"Johnson,Avery",207,432,.479,0,5,.000,207,427,.485,121,163,.742,14,55,69,286,40,76,9,86,535,2001/2002
"Johnson,Avery",186,383,.486,0,5,.000,186,378,.492,109,146,.747,14,50,64,258,35,67,8,69,481,2001/2002
"Johnson,Avery",21,49,.429,0,0,,21,49,.429,12,17,.706,0,5,5,28,5,9,1,17,54,2001/2002
"Johnson,DerMarr",214,540,.396,89,247,.360,125,293,.427,85,105,.810,59,188,247,81,62,102,56,163,602,2001/2002
"Johnson,Ervin",89,193,.461,0,1,.000,89,192,.464,30,66,.455,142,324,466,27,37,52,82,219,208,2001/2002
"Johnson,Joe",251,584,.430,38,130,.292,213,454,.469,41,53,.774,75,182,257,179,59,71,20,114,581,2001/2002
"Johnson,Joe",130,296,.439,24,88,.273,106,208,.510,20,26,.769,40,99,139,74,33,28,9,59,304,2001/2002
"Johnson,Joe",121,288,.420,14,42,.333,107,246,.435,21,27,.778,35,83,118,105,26,43,11,55,277,2001/2002
"Jones,Alvin",8,20,.400,0,0,,8,20,.400,10,20,.500,13,23,36,3,3,11,9,35,26,2001/2002
"Jones,Damon",114,284,.401,69,186,.371,45,98,.459,43,59,.729,13,90,103,140,23,61,1,83,340,2001/2002
"Jones,Eddie",517,1198,.432,149,382,.390,368,816,.451,297,355,.837,61,317,378,262,117,148,77,258,1480,2001/2002
"Jones,Jumaine",287,640,.448,52,168,.310,235,472,.498,45,68,.662,125,365,490,116,75,79,46,184,671,2001/2002
"Jones,Popeye",222,508,.437,4,11,.364,218,497,.439,106,130,.815,233,345,578,127,50,88,19,209,554,2001/2002
"Jordan,Michael",551,1324,.416,10,53,.189,541,1271,.426,263,333,.790,50,289,339,310,85,162,26,119,1375,2001/2002
"Kemp,Shawn",175,407,.430,0,4,.000,175,403,.434,104,131,.794,90,198,288,52,43,81,33,184,454,2001/2002
"Kerr,Steve",102,217,.470,26,66,.394,76,151,.503,39,40,.975,6,54,60,63,13,24,1,49,269,2001/2002
"Kidd,Jason",445,1138,.391,117,364,.321,328,774,.424,201,247,.814,130,465,595,808,175,286,20,136,1208,2001/2002
"Kirilenko,Andrei",285,633,.450,25,100,.250,260,533,.488,285,371,.768,149,253,402,94,116,108,159,156,880,2001/2002
"Kittles,Kerry",438,940,.466,98,242,.405,340,698,.487,128,172,.744,68,207,275,216,130,109,31,108,1102,2001/2002
"Knight,Brevin",141,334,.422,2,8,.250,139,326,.426,87,115,.757,11,98,109,302,79,111,7,135,371,2001/2002
"Knight,Travis",41,113,.363,0,0,,41,113,.363,16,21,.762,48,56,104,8,11,27,10,95,98,2001/2002
"Kukoč,Toni",211,504,.419,53,171,.310,158,333,.474,109,153,.712,43,175,218,210,48,113,17,91,584,2001/2002
"Laettner,Christian",168,362,.464,2,10,.200,166,352,.472,66,76,.868,74,227,301,151,60,85,25,129,404,2001/2002
"LaFrentz,Raef",421,920,.458,104,268,.388,317,652,.486,105,151,.695,176,403,579,89,55,94,213,281,1051,2001/2002
"LaFrentz,Raef",307,659,.466,75,173,.434,232,486,.477,70,105,.667,117,262,379,60,31,60,153,173,759,2001/2002
"LaFrentz,Raef",114,261,.437,29,95,.305,85,166,.512,35,46,.761,59,141,200,29,24,34,60,108,292,2001/2002
"Langdon,Trajan",70,176,.398,27,74,.365,43,102,.422,42,46,.913,13,42,55,60,13,40,5,49,209,2001/2002
"Langhi,Dan",49,125,.392,1,4,.250,48,121,.397,8,11,.727,22,45,67,14,8,9,5,25,107,2001/2002
"LaRue,Rusty",73,185,.395,17,50,.340,56,135,.415,30,35,.857,11,38,49,71,17,43,7,58,193,2001/2002
"Lenard,Voshon",315,769,.410,89,240,.371,226,529,.427,94,120,.783,38,145,183,130,59,91,25,105,813,2001/2002
"Lewis,Quincy",64,143,.448,3,18,.167,61,125,.488,13,20,.650,10,33,43,36,23,32,9,89,144,2001/2002
"Lewis,Rashard",455,972,.468,123,316,.389,332,656,.506,162,200,.810,139,359,498,123,104,97,40,174,1195,2001/2002
"Livingston,Randy",15,54,.278,1,8,.125,14,46,.304,10,11,.909,9,16,25,26,9,2,2,11,41,2001/2002
"Long,Art",120,244,.492,0,0,,120,244,.492,45,85,.529,107,144,251,41,22,63,28,180,285,2001/2002
"Long,Grant",164,385,.426,3,17,.176,161,368,.438,86,123,.699,31,200,231,136,63,103,12,123,417,2001/2002
"López,Felipe",59,156,.378,14,33,.424,45,123,.366,37,55,.673,29,51,80,39,18,36,1,73,169,2001/2002
"Lue,Tyronn",222,520,.427,63,141,.447,159,379,.420,48,63,.762,14,108,122,246,49,96,0,120,555,2001/2002
"Lynch,George",73,198,.369,1,6,.167,72,192,.375,25,40,.625,70,116,186,54,40,41,14,75,172,2001/2002
"MacCulloch,Todd",247,465,.531,0,0,,247,465,.531,110,164,.671,157,221,378,78,24,66,89,181,604,2001/2002
"Mack,Sam",14,49,.286,7,28,.250,7,21,.333,5,7,.714,2,12,14,4,5,7,1,17,40,2001/2002
"Madsen,Mark",66,146,.452,0,2,.000,66,144,.458,35,54,.648,89,73,162,44,16,22,13,104,167,2001/2002
"Maggette,Corey",235,530,.443,46,139,.331,189,391,.483,201,251,.801,54,177,231,112,41,116,19,155,717,2001/2002
"Magloire,Jamaal",228,414,.551,0,1,.000,228,413,.552,243,333,.730,153,308,461,31,27,118,86,201,699,2001/2002
"Majerle,Dan",99,289,.343,79,235,.336,20,54,.370,23,39,.590,28,148,176,90,48,35,15,104,300,2001/2002
"Malone,Karl",635,1399,.454,9,25,.360,626,1374,.456,509,639,.797,142,544,686,341,152,263,59,229,1788,2001/2002
"Manning,Danny",71,149,.477,1,7,.143,70,142,.493,22,33,.667,25,83,108,30,21,25,21,80,165,2001/2002
"Marbury,Stephon",625,1413,.442,71,248,.286,554,1165,.476,353,452,.781,75,191,266,666,77,284,13,186,1674,2001/2002
"Marion,Shawn",654,1395,.469,48,122,.393,606,1273,.476,191,226,.845,211,592,803,162,149,144,86,214,1547,2001/2002
"Marks,Sean",38,88,.432,0,0,,38,88,.432,20,34,.588,19,56,75,8,5,19,10,40,96,2001/2002
"Marshall,Donny",8,29,.276,2,4,.500,6,25,.240,12,18,.667,8,13,21,5,3,2,0,14,30,2001/2002
"Marshall,Donyell",343,661,.519,13,42,.310,330,619,.533,160,226,.708,158,285,443,101,50,124,67,150,859,2001/2002
"Martin,Darrick",0,10,.000,0,2,.000,0,8,.000,1,2,.500,0,1,1,3,2,1,0,4,1,2001/2002
"Martin,Kenyon",445,962,.463,15,67,.224,430,895,.480,181,267,.678,113,275,388,192,90,172,121,261,1086,2001/2002
"Mashburn,Jamal",303,744,.407,41,112,.366,262,632,.415,211,241,.876,31,211,242,171,45,110,6,80,858,2001/2002
"Mason,Anthony",316,626,.505,1,1,1.000,315,625,.504,154,221,.697,124,522,646,346,57,130,22,187,787,2001/2002
"Mason,Desmond",357,769,.464,16,59,.271,341,710,.480,201,237,.848,92,259,351,104,67,104,27,170,931,2001/2002
"Massenburg,Tony",159,349,.456,1,1,1.000,158,348,.454,84,117,.718,100,224,324,26,30,65,31,174,403,2001/2002
"McCarty,Walter",80,180,.444,39,99,.394,41,81,.506,13,19,.684,32,96,128,41,18,22,7,83,212,2001/2002
"McCaskill,Amal",20,49,.408,0,0,,20,49,.408,12,26,.462,16,20,36,4,6,14,10,23,52,2001/2002
"McCloud,George",206,576,.358,60,222,.270,146,354,.412,132,163,.810,67,184,251,204,58,144,19,175,604,2001/2002
"McCoy,Jelani",12,21,.571,0,0,,12,21,.571,2,8,.250,8,17,25,7,0,8,5,14,26,2001/2002
"McDyess,Antonio",43,75,.573,0,0,,43,75,.573,27,33,.818,18,37,55,18,10,20,8,20,113,2001/2002
"McGrady,Tracy",715,1586,.451,103,283,.364,612,1303,.470,415,555,.748,150,447,597,400,119,189,73,139,1948,2001/2002
"McInnis,Jeff",463,1121,.413,75,234,.321,388,887,.437,183,219,.836,45,168,213,500,63,147,6,202,1184,2001/2002
"McKey,Derrick",52,122,.426,5,12,.417,47,110,.427,10,14,.714,48,79,127,45,41,22,4,90,119,2001/2002
"McKie,Aaron",220,490,.449,51,128,.398,169,362,.467,96,122,.787,26,166,192,179,56,93,14,74,587,2001/2002
"Medvedenko,Stanislav",145,304,.477,0,4,.000,145,300,.483,41,62,.661,85,73,158,43,29,42,11,119,331,2001/2002
"Mercer,Ron",311,784,.397,18,62,.290,293,722,.406,95,119,.798,50,128,178,128,32,88,13,108,735,2001/2002
"Mercer,Ron",286,717,.399,17,57,.298,269,660,.408,84,108,.778,44,111,155,118,30,79,10,86,673,2001/2002
"Mercer,Ron",25,67,.373,1,5,.200,24,62,.387,11,11,1.000,6,17,23,10,2,9,3,22,62,2001/2002
"Mihm,Chris",221,526,.420,3,7,.429,218,519,.420,124,179,.693,133,259,392,24,18,97,89,260,569,2001/2002
"Miles,Darius",309,642,.481,3,19,.158,306,623,.491,158,255,.620,109,344,453,184,71,160,103,184,779,2001/2002
"Miller,Andre",474,1045,.454,22,87,.253,452,958,.472,365,447,.817,108,271,379,882,126,245,34,228,1335,2001/2002
"Miller,Brad",366,733,.499,3,7,.429,363,726,.500,297,383,.775,252,369,621,152,76,115,41,244,1032,2001/2002
"Miller,Brad",208,452,.460,2,4,.500,206,448,.460,190,253,.751,176,225,401,101,52,74,29,156,608,2001/2002
"Miller,Brad",158,281,.562,1,3,.333,157,278,.565,107,130,.823,76,144,220,51,24,41,12,88,424,2001/2002
"Miller,Mike",351,802,.438,116,303,.383,235,499,.471,138,181,.762,49,224,273,198,47,108,23,145,956,2001/2002
"Miller,Reggie",414,913,.453,180,443,.406,234,470,.498,296,325,.911,23,196,219,253,88,120,10,143,1304,2001/2002
"Mills,Chris",178,427,.417,48,127,.378,130,300,.433,85,107,.794,51,139,190,72,31,56,13,120,489,2001/2002
"Mitchell,Sam",98,227,.432,10,35,.286,88,192,.458,38,49,.776,18,64,82,45,12,26,4,79,244,2001/2002
"Mobley,Cuttino",595,1358,.438,149,377,.395,446,981,.455,267,314,.850,63,237,300,187,109,180,37,189,1606,2001/2002
"Mohammed,Nazr",329,713,.461,0,1,.000,329,712,.462,137,222,.617,242,409,651,33,63,118,61,252,795,2001/2002
"Moïso,Jérôme",8,20,.400,0,0,,8,20,.400,0,0,,4,21,25,4,3,8,2,12,16,2001/2002
"Montross,Eric",53,132,.402,0,1,.000,53,131,.405,10,31,.323,36,104,140,16,12,25,23,92,116,2001/2002
"Moore,Mikki",29,61,.475,1,2,.500,28,59,.475,20,26,.769,22,31,53,11,7,14,9,35,79,2001/2002
"Morris,Terence",111,289,.384,15,78,.192,96,211,.455,18,28,.643,77,134,211,64,21,45,27,72,255,2001/2002
"Möttölä,Hanno",169,384,.440,1,13,.077,168,371,.453,57,76,.750,81,187,268,50,20,70,19,174,396,2001/2002
"Mourning,Alonzo",447,866,.516,1,3,.333,446,863,.517,283,431,.657,182,450,632,87,27,182,186,258,1178,2001/2002
"Murphy,Troy",178,423,.421,3,9,.333,175,414,.423,121,156,.776,99,223,322,70,36,84,21,217,480,2001/2002
"Murray,Lamond",430,986,.436,101,238,.424,329,748,.440,215,263,.817,81,291,372,157,70,141,43,148,1176,2001/2002
"Murray,Tracy",85,207,.411,40,104,.385,45,103,.437,17,21,.810,18,35,53,19,11,25,8,38,227,2001/2002
"Mutombo,Dikembe",321,641,.501,0,0,,321,641,.501,278,364,.764,254,609,863,83,29,156,190,242,920,2001/2002
"N'Diaye,Mamadou",6,10,.600,0,0,,6,10,.600,8,10,.800,6,5,11,0,0,1,2,6,20,2001/2002
"Nailon,Lee",369,764,.483,1,2,.500,368,762,.483,112,150,.747,103,188,291,94,59,96,17,175,851,2001/2002
"Nájera,Eduardo",150,300,.500,0,2,.000,150,298,.503,100,148,.676,149,193,342,38,56,40,30,156,400,2001/2002
"Nash,Steve",525,1088,.483,156,343,.455,369,745,.495,260,293,.887,50,204,254,634,53,229,4,164,1466,2001/2002
"Nesby,Tyrone",183,421,.435,13,47,.277,170,374,.455,64,93,.688,105,213,318,91,61,49,22,164,443,2001/2002
"Nesterović,Rasho",324,657,.493,0,1,.000,324,656,.494,39,71,.549,200,334,534,75,45,94,109,262,687,2001/2002
"Newble,Ira",131,263,.498,1,7,.143,130,256,.508,75,88,.852,80,142,222,45,38,49,20,117,338,2001/2002
"Newman,Johnny",67,148,.453,22,57,.386,45,91,.495,42,58,.724,9,40,49,14,29,21,4,88,198,2001/2002
"Norris,Moochie",251,631,.398,36,134,.269,215,497,.433,127,169,.751,73,173,246,403,81,156,4,130,665,2001/2002
"Nowitzki,Dirk",600,1258,.477,139,350,.397,461,908,.508,440,516,.853,120,635,755,186,83,145,77,222,1779,2001/2002
"O'Neal,Jermaine",543,1133,.479,1,14,.071,542,1119,.484,284,413,.688,188,569,757,118,45,174,166,269,1371,2001/2002
"O'Neal,Shaquille",712,1229,.579,0,1,.000,712,1228,.580,398,717,.555,235,480,715,200,41,171,137,199,1822,2001/2002
"Oakley,Charles",97,263,.369,1,6,.167,96,257,.374,21,28,.750,72,271,343,114,49,87,11,175,216,2001/2002
"Odom,Lamar",151,360,.419,16,84,.190,135,276,.489,61,93,.656,31,145,176,171,23,97,36,91,379,2001/2002
"Olajuwon,Hakeem",194,418,.464,0,2,.000,194,416,.466,47,84,.560,98,268,366,66,74,98,90,147,435,2001/2002
"Oliver,Dean",17,46,.370,2,13,.154,15,33,.455,6,9,.667,0,8,8,21,3,11,0,16,42,2001/2002
"Ollie,Kevin",137,353,.388,1,2,.500,136,351,.387,187,227,.824,25,159,184,291,62,106,2,97,462,2001/2002
"Ollie,Kevin",97,253,.383,1,2,.500,96,251,.382,109,130,.838,18,110,128,193,36,80,1,64,304,2001/2002
"Ollie,Kevin",40,100,.400,0,0,,40,100,.400,78,97,.804,7,49,56,98,26,26,1,33,158,2001/2002
"Olowokandi,Michael",384,886,.433,0,0,,384,886,.433,117,188,.622,164,547,711,90,55,175,145,217,885,2001/2002
"Ostertag,Greg",91,201,.453,0,0,,91,201,.453,63,130,.485,125,188,313,50,15,51,109,152,245,2001/2002
"Outlaw,Bo",166,299,.555,1,2,.500,165,297,.556,43,102,.422,147,217,364,127,70,96,92,205,376,2001/2002
"Outlaw,Bo",13,21,.619,0,0,,13,21,.619,8,18,.444,15,14,29,5,9,11,9,23,34,2001/2002
"Outlaw,Bo",153,278,.550,1,2,.500,152,276,.551,35,84,.417,132,203,335,122,61,85,83,182,342,2001/2002
"Overton,Doug",14,44,.318,7,27,.259,7,17,.412,4,7,.571,1,11,12,13,3,12,1,10,39,2001/2002
"Oyedeji,Olumide",22,41,.537,0,0,,22,41,.537,11,18,.611,27,52,79,4,4,14,2,36,55,2001/2002
"Pack,Robert",25,68,.368,1,4,.250,24,64,.375,11,15,.733,7,16,23,49,13,20,0,32,62,2001/2002
"Padgett,Scott",188,395,.476,49,113,.434,139,282,.493,75,102,.735,111,174,285,82,43,69,13,140,500,2001/2002
"Palacio,Milt",82,214,.383,13,41,.317,69,173,.399,54,74,.730,11,62,73,83,30,40,4,61,231,2001/2002
"Palacio,Milt",52,135,.385,12,34,.353,40,101,.396,36,51,.706,8,42,50,54,21,24,3,38,152,2001/2002
"Palacio,Milt",30,79,.380,1,7,.143,29,72,.403,18,23,.783,3,20,23,29,9,16,1,23,79,2001/2002
"Parker,Tony",268,639,.419,61,189,.323,207,450,.460,108,160,.675,33,164,197,334,89,151,7,166,705,2001/2002
"Parks,Cherokee",30,83,.361,0,0,,30,83,.361,3,8,.375,24,34,58,10,7,14,8,34,63,2001/2002
"Patterson,Ruben",319,619,.515,9,36,.250,310,583,.532,192,274,.701,155,143,298,107,79,114,37,140,839,2001/2002
"Payton,Gary",737,1578,.467,74,236,.314,663,1342,.494,267,335,.797,80,316,396,737,131,209,26,179,1815,2001/2002
"Peeler,Anthony",288,684,.421,111,283,.392,177,401,.441,50,58,.862,37,169,206,177,61,76,11,137,737,2001/2002
"Penberthy,Mike",1,2,.500,0,0,,1,2,.500,3,4,.750,0,2,2,2,2,0,0,0,5,2001/2002
"Perry,Elliot",5,10,.500,0,0,,5,10,.500,1,2,.500,0,4,4,7,3,7,0,6,11,2001/2002
"Person,Wesley",467,944,.495,143,322,.444,324,622,.521,99,124,.798,50,244,294,173,77,74,37,93,1176,2001/2002
"Peterson,Morris",336,768,.438,84,231,.364,252,537,.469,127,169,.751,91,132,223,153,73,86,11,174,883,2001/2002
"Piatkowski,Eric",207,471,.439,111,238,.466,96,233,.412,101,113,.894,43,141,184,112,41,64,12,110,626,2001/2002
"Pierce,Paul",707,1598,.442,210,520,.404,497,1078,.461,520,643,.809,81,485,566,261,154,241,86,237,2144,2001/2002
"Pippen,Scottie",246,599,.411,54,177,.305,192,422,.455,113,146,.774,77,244,321,363,101,171,35,162,659,2001/2002
"Pollard,Scot",197,358,.550,0,0,,197,358,.550,115,166,.693,188,377,565,53,70,68,76,202,509,2001/2002
"Pope,Mark",36,91,.396,4,25,.160,32,66,.485,11,21,.524,20,53,73,17,11,15,11,47,87,2001/2002
"Porter,Terry",136,321,.424,59,142,.415,77,179,.430,68,83,.819,12,152,164,205,45,85,16,89,399,2001/2002
"Posey,James",277,736,.376,67,237,.283,210,499,.421,161,203,.793,109,320,429,180,114,127,39,224,782,2001/2002
"Postell,Lavor",28,84,.333,6,26,.231,22,58,.379,31,41,.756,2,14,16,5,6,11,0,7,93,2001/2002
"Potapenko,Vitaly",137,301,.455,0,0,,137,301,.455,89,120,.742,167,180,347,30,37,63,18,174,363,2001/2002
"Price,Brent",9,27,.333,4,15,.267,5,12,.417,9,13,.692,4,4,8,9,3,10,1,13,31,2001/2002
"Przybilla,Joel",76,142,.535,0,1,.000,76,141,.539,38,90,.422,78,205,283,21,20,43,118,199,190,2001/2002
"Radmanović,Vladimir",146,354,.412,66,157,.420,80,197,.406,49,72,.681,45,185,230,81,56,72,24,119,407,2001/2002
"Randolph,Zach",48,107,.449,0,0,,48,107,.449,18,27,.667,31,38,69,13,7,15,4,29,114,2001/2002
"Ratliff,Theo",10,20,.500,0,0,,10,20,.500,6,11,.545,5,11,16,1,1,7,8,8,26,2001/2002
"Rebrača,Željko",189,374,.505,0,0,,189,374,.505,135,175,.771,84,206,290,38,28,84,73,192,513,2001/2002
"Recasner,Eldridge",2,6,.333,0,1,.000,2,5,.400,1,1,1.000,0,0,0,5,1,1,0,4,5,2001/2002
"Recasner,Eldridge",0,0,,0,0,,0,0,,0,0,,0,0,0,0,0,0,0,1,0,2001/2002
"Recasner,Eldridge",2,6,.333,0,1,.000,2,5,.400,1,1,1.000,0,0,0,5,1,1,0,3,5,2001/2002
"Redd,Michael",294,609,.483,88,198,.444,206,411,.501,91,115,.791,77,147,224,91,42,57,7,96,767,2001/2002
"Reid,Don",90,190,.474,0,0,,90,190,.474,44,68,.647,65,111,176,27,20,54,44,180,224,2001/2002
"Rice,Glen",65,167,.389,18,64,.281,47,103,.456,24,30,.800,5,42,47,31,12,24,3,34,172,2001/2002
"Richardson,Jason",464,1090,.426,82,246,.333,382,844,.453,141,210,.671,124,216,340,236,106,160,31,195,1151,2001/2002
"Richardson,Norm",10,26,.385,4,8,.500,6,18,.333,6,9,.667,3,5,8,2,0,3,0,5,30,2001/2002
"Richardson,Norm",0,3,.000,0,0,,0,3,.000,0,0,,1,0,1,1,0,0,0,0,0,2001/2002
"Richardson,Norm",10,23,.435,4,8,.500,6,15,.400,6,9,.667,2,5,7,1,0,3,0,5,30,2001/2002
"Richardson,Quentin",400,926,.432,133,349,.381,267,577,.463,143,187,.765,113,221,334,128,78,102,21,142,1076,2001/2002
"Richmond,Mitch",100,247,.405,18,62,.290,82,185,.443,42,44,.955,14,80,94,57,18,40,6,61,260,2001/2002
"Rider,Isaiah",37,81,.457,6,15,.400,31,66,.470,13,17,.765,10,23,33,12,3,14,2,11,93,2001/2002
"Robinson,Clifford",454,1069,.425,115,304,.378,339,765,.443,143,206,.694,79,307,386,202,89,151,95,243,1166,2001/2002
"Robinson,David",341,672,.507,0,0,,341,672,.507,269,395,.681,191,456,647,94,86,104,140,193,951,2001/2002
"Robinson,Eddie",112,247,.453,2,5,.400,110,242,.455,36,48,.750,24,54,78,37,23,36,11,35,262,2001/2002
"Robinson,Glenn",536,1147,.467,58,178,.326,478,969,.493,236,282,.837,70,336,406,168,97,174,41,173,1366,2001/2002
"Robinson,Larry",1,4,.250,1,2,.500,0,2,.000,0,0,,0,2,2,0,0,0,0,1,3,2001/2002
"Rogers,Carlos",24,43,.558,1,6,.167,23,37,.622,10,19,.526,14,24,38,3,5,5,6,17,59,2001/2002
"Rogers,Rodney",356,756,.471,88,235,.374,268,521,.514,117,149,.785,129,219,348,112,66,108,29,226,917,2001/2002
"Rogers,Rodney",249,534,.466,49,140,.350,200,394,.508,82,99,.828,95,146,241,72,50,66,17,148,629,2001/2002
"Rogers,Rodney",107,222,.482,39,95,.411,68,127,.535,35,50,.700,34,73,107,40,16,42,12,78,288,2001/2002
"Rooks,Sean",81,194,.418,0,0,,81,194,.418,21,29,.724,32,92,124,25,12,20,21,114,183,2001/2002
"Rose,Jalen",663,1458,.455,89,246,.362,574,1212,.474,281,335,.839,43,330,373,355,78,201,45,251,1696,2001/2002
"Rose,Jalen",387,871,.444,52,146,.356,335,725,.462,156,186,.839,29,220,249,197,45,105,29,148,982,2001/2002
"Rose,Jalen",276,587,.470,37,100,.370,239,487,.491,125,149,.839,14,110,124,158,33,96,16,103,714,2001/2002
"Rose,Malik",293,633,.463,1,12,.083,292,621,.470,185,257,.720,172,320,492,61,70,140,42,208,772,2001/2002
"Ruffin,Michael",7,26,.269,0,0,,7,26,.269,2,8,.250,23,28,51,5,5,11,8,23,16,2001/2002
"Russell,Bryon",222,584,.380,77,226,.341,145,358,.405,115,140,.821,79,216,295,136,64,110,19,205,636,2001/2002
"Santiago,Daniel",4,8,.500,0,0,,4,8,.500,0,0,,0,7,7,2,0,2,1,4,8,2001/2002
"Sasser,Jeryl",3,14,.214,0,0,,3,14,.214,4,5,.800,3,4,7,2,3,2,0,3,10,2001/2002
"Satterfield,Kenny",73,199,.367,7,27,.259,66,172,.384,36,46,.783,17,35,52,108,31,53,1,43,189,2001/2002
"Scalabrine,Brian",23,67,.343,3,10,.300,20,57,.351,11,15,.733,12,39,51,21,9,24,2,39,60,2001/2002
"Scott,Shawnelle",37,75,.493,0,0,,37,75,.493,8,20,.400,53,50,103,8,3,15,6,49,82,2001/2002
"Sesay,Ansu",22,44,.500,0,0,,22,44,.500,14,20,.700,7,13,20,8,3,2,2,18,58,2001/2002
"Shaw,Brian",61,173,.353,29,88,.330,32,85,.376,18,26,.692,19,93,112,89,25,32,3,43,169,2001/2002
"Simmons,Bobby",43,95,.453,4,14,.286,39,81,.481,22,30,.733,25,27,52,17,13,14,5,31,112,2001/2002
"Simpkins,Dickey",0,0,,0,0,,0,0,,0,0,,0,0,0,1,0,0,0,0,0,2001/2002
"Skinner,Brian",88,162,.543,0,0,,88,162,.543,48,79,.608,93,188,281,17,24,42,61,130,224,2001/2002
"Slater,Reggie",7,15,.467,0,0,,7,15,.467,7,10,.700,5,4,9,1,1,1,1,3,21,2001/2002
"Slater,Reggie",2,2,1.000,0,0,,2,2,1.000,1,1,1.000,0,2,2,0,0,1,0,1,5,2001/2002
"Slater,Reggie",5,13,.385,0,0,,5,13,.385,6,9,.667,5,2,7,1,1,0,1,2,16,2001/2002
"Smith,Charles",182,428,.425,35,131,.267,147,297,.495,42,65,.646,34,99,133,80,52,59,44,114,441,2001/2002
"Smith,Jabari",26,63,.413,0,3,.000,26,60,.433,21,32,.656,8,20,28,11,6,5,6,31,73,2001/2002
"Smith,Jabari",6,21,.286,0,1,.000,6,20,.300,6,12,.500,2,12,14,6,2,2,4,12,18,2001/2002
"Smith,Jabari",20,42,.476,0,2,.000,20,40,.500,15,20,.750,6,8,14,5,4,3,2,19,55,2001/2002
"Smith,Joe",297,581,.511,2,3,.667,295,578,.510,171,206,.830,152,301,453,82,39,86,59,250,767,2001/2002
"Smith,Leon",10,26,.385,0,0,,10,26,.385,11,17,.647,10,21,31,3,5,3,1,12,31,2001/2002
"Smith,Steve",310,682,.455,116,246,.472,194,436,.445,159,181,.878,45,148,193,151,54,108,15,158,895,2001/2002
"Snow,Eric",276,624,.442,3,27,.111,273,597,.457,183,227,.806,33,182,215,400,95,138,9,167,738,2001/2002
"Solomon,Will",113,331,.341,46,162,.284,67,169,.396,49,73,.671,12,56,68,92,35,62,7,76,321,2001/2002
"Spencer,Felton",6,26,.231,0,0,,6,26,.231,17,33,.515,16,34,50,3,7,12,8,73,29,2001/2002
"Sprewell,Latrell",573,1419,.404,145,403,.360,428,1016,.421,284,346,.821,59,239,298,313,94,223,14,161,1575,2001/2002
"Stackhouse,Jerry",524,1319,.397,86,300,.287,438,1019,.430,495,577,.858,77,238,315,403,77,266,37,163,1629,2001/2002
"Starks,John",114,310,.368,29,95,.305,85,215,.395,33,41,.805,15,53,68,70,33,52,0,126,290,2001/2002
"Stepania,Vladimir",117,249,.470,1,2,.500,116,247,.470,50,104,.481,100,170,270,16,24,52,44,103,285,2001/2002
"Stevenson,DeShawn",143,371,.385,2,25,.080,141,346,.408,37,53,.698,44,87,131,116,29,68,24,82,325,2001/2002
"Stewart,Michael",8,23,.348,0,0,,8,23,.348,6,11,.545,12,13,25,3,4,4,3,22,22,2001/2002
"Stith,Bryant",70,188,.372,24,68,.353,46,120,.383,44,52,.846,20,65,85,42,29,30,6,42,208,2001/2002
"Stockton,John",401,775,.517,25,78,.321,376,697,.539,275,321,.857,59,204,263,674,152,208,24,209,1102,2001/2002
"Stojaković,Peja",547,1130,.484,129,310,.416,418,820,.510,283,323,.876,72,301,373,175,81,140,14,120,1506,2001/2002
"Stoudamire,Damon",369,918,.402,104,295,.353,265,623,.425,174,196,.888,78,214,292,490,67,149,7,153,1016,2001/2002
"Strickland,Erick",190,488,.389,95,247,.385,95,241,.394,131,155,.845,22,191,213,184,56,94,1,145,606,2001/2002
"Strickland,Mark",91,204,.446,1,4,.250,90,200,.450,25,44,.568,41,90,131,20,19,28,17,48,208,2001/2002
"Strickland,Rod",316,714,.443,8,26,.308,308,688,.448,154,201,.766,49,183,232,463,82,159,11,114,794,2001/2002
"Šundov,Bruno",16,40,.400,0,1,.000,16,39,.410,0,2,.000,7,14,21,3,3,4,3,16,32,2001/2002
"Sura,Bob",250,590,.424,42,133,.316,208,457,.455,236,328,.720,89,167,256,275,88,133,17,160,778,2001/2002
"Swift,Stromile",293,611,.480,0,3,.000,293,608,.482,217,305,.711,161,269,430,50,53,122,113,178,803,2001/2002
"Szczerbiak,Wally",609,1200,.508,87,191,.455,522,1009,.517,226,272,.831,120,271,391,257,66,181,21,188,1531,2001/2002
"Terry,Jason",524,1219,.430,172,444,.387,352,775,.454,284,340,.835,40,230,270,444,144,181,13,156,1504,2001/2002
"Thomas,Etan",81,151,.536,0,0,,81,151,.536,41,74,.554,55,126,181,6,17,26,35,76,203,2001/2002
"Thomas,Kenny",396,829,.478,0,16,.000,396,813,.487,223,336,.664,158,358,516,137,85,143,66,195,1015,2001/2002
"Thomas,Kurt",463,938,.494,1,6,.167,462,932,.496,216,265,.815,214,533,747,87,71,153,79,341,1143,2001/2002
"Thomas,Tim",316,753,.420,95,291,.326,221,462,.478,142,179,.793,64,236,300,105,65,127,32,200,869,2001/2002
"Tinsley,Jamaal",289,760,.380,42,175,.240,247,585,.422,131,186,.704,78,220,298,647,138,270,40,248,751,2001/2002
"Torres,Óscar",135,341,.396,37,126,.294,98,215,.456,82,105,.781,47,75,122,40,25,49,9,64,389,2001/2002
"Traylor,Robert",87,204,.426,1,1,1.000,86,203,.424,53,84,.631,67,120,187,37,24,45,37,127,228,2001/2002
"Trent,Gary",193,381,.507,0,2,.000,193,379,.509,92,144,.639,104,166,270,60,21,58,27,160,478,2001/2002
"Trepagnier,Jeff",7,23,.304,0,1,.000,7,22,.318,4,7,.571,3,9,12,12,8,11,4,8,18,2001/2002
"Tsakalidis,Jake",190,400,.475,0,1,.000,190,399,.476,111,159,.698,130,244,374,23,23,78,69,193,491,2001/2002
"Türkoğlu,Hedo",290,687,.422,63,171,.368,227,516,.440,167,230,.726,63,300,363,163,57,81,31,184,810,2001/2002
"Van Exel,Nick",501,1226,.409,119,350,.340,382,876,.436,201,251,.801,28,226,254,478,44,156,11,104,1322,2001/2002
"Van Exel,Nick",372,912,.408,85,252,.337,287,660,.435,136,174,.782,19,150,169,365,30,116,7,69,965,2001/2002
"Van Exel,Nick",129,314,.411,34,98,.347,95,216,.440,65,77,.844,9,76,85,113,14,40,4,35,357,2001/2002
"Van Horn,Keith",471,1089,.433,101,293,.345,370,796,.465,156,195,.800,137,472,609,164,63,146,42,221,1199,2001/2002
"Varda,Ratko",2,3,.667,0,0,,2,3,.667,1,1,1.000,0,1,1,0,0,1,0,3,5,2001/2002
"Vaughn,Jacque",206,438,.470,24,54,.444,182,384,.474,104,126,.825,18,150,168,349,65,112,2,183,540,2001/2002
"Voskuhl,Jake",107,193,.554,0,0,,107,193,.554,82,109,.752,103,147,250,18,11,48,23,139,296,2001/2002
"Walker,Antoine",666,1689,.394,222,645,.344,444,1044,.425,240,324,.741,150,564,714,407,122,251,38,237,1794,2001/2002
"Walker,Samaki",187,365,.512,0,0,,187,365,.512,86,129,.667,129,352,481,64,28,53,88,170,460,2001/2002
"Wallace,Ben",255,480,.531,0,3,.000,255,477,.535,99,234,.423,318,721,1039,115,138,70,278,178,609,2001/2002
"Wallace,Gerald",75,175,.429,0,7,.000,75,168,.446,23,46,.500,49,40,89,27,19,22,6,46,173,2001/2002
"Wallace,John",93,214,.435,5,13,.385,88,201,.438,40,46,.870,27,58,85,29,11,29,9,60,231,2001/2002
"Wallace,Rasheed",603,1287,.469,114,317,.360,489,970,.504,201,274,.734,136,509,645,152,101,131,101,212,1521,2001/2002
"Ward,Charlie",113,303,.373,53,164,.323,60,139,.432,47,58,.810,15,112,127,203,68,75,14,100,326,2001/2002
"Watson,Earl",96,212,.453,16,44,.364,80,168,.476,23,36,.639,31,52,83,125,60,51,5,93,231,2001/2002
"Weatherspoon,Clarence",189,452,.418,0,0,,189,452,.418,116,146,.795,149,311,460,60,37,47,48,132,494,2001/2002
"Webber,Chris",532,1075,.495,5,19,.263,527,1056,.499,253,338,.749,150,396,546,258,90,158,76,181,1322,2001/2002
"Wells,Bonzi",487,1039,.469,66,172,.384,421,867,.486,215,290,.741,121,323,444,204,113,191,25,208,1255,2001/2002
"Wesley,David",364,910,.400,85,256,.332,279,654,.427,138,188,.734,44,99,143,236,74,119,15,147,951,2001/2002
"White,Jahidi",150,279,.538,0,0,,150,279,.538,83,154,.539,159,285,444,17,25,65,75,163,383,2001/2002
"White,Rodney",21,60,.350,2,9,.222,19,51,.373,12,14,.857,2,16,18,12,9,14,2,6,56,2001/2002
"Whitney,Chris",274,656,.418,131,323,.406,143,333,.429,154,175,.880,11,141,152,314,72,85,6,182,833,2001/2002
"Williams,Aaron",231,439,.526,0,2,.000,231,437,.529,130,186,.699,115,224,339,77,29,79,76,212,592,2001/2002
"Williams,Alvin",403,971,.415,62,193,.321,341,778,.438,103,140,.736,58,223,281,468,135,150,26,191,971,2001/2002
"Williams,Eric",144,385,.374,24,86,.279,120,299,.401,160,219,.731,58,163,221,109,77,95,8,179,472,2001/2002
"Williams,Jason",376,985,.382,127,430,.295,249,555,.449,80,101,.792,22,173,195,519,111,214,7,102,959,2001/2002
"Williams,Jerome",190,388,.490,0,0,,190,388,.490,138,204,.676,165,221,386,75,78,68,25,153,518,2001/2002
"Williams,Monty",198,362,.547,0,4,.000,198,358,.553,88,134,.657,80,155,235,96,49,86,17,134,484,2001/2002
"Williams,Scott",86,217,.396,0,2,.000,86,215,.400,30,41,.732,82,127,209,13,17,35,33,98,202,2001/2002
"Williams,Shammond",81,193,.420,28,75,.373,53,118,.449,31,39,.795,16,47,63,83,21,35,2,35,221,2001/2002
"Williams,Walt",166,396,.419,78,183,.426,88,213,.413,40,51,.784,37,125,162,69,18,53,10,106,450,2001/2002
"Williamson,Corliss",411,806,.510,1,5,.200,410,801,.512,240,298,.805,117,202,319,94,49,137,26,226,1063,2001/2002
"Willis,Kevin",125,284,.440,0,1,.000,125,283,.442,65,87,.747,105,194,299,14,25,41,23,98,315,2001/2002
"Woods,Loren",33,96,.344,0,2,.000,33,94,.351,44,60,.733,46,76,122,22,17,36,34,60,110,2001/2002
"World Peace,Metta",269,636,.423,53,170,.312,216,466,.464,136,204,.667,73,198,271,127,141,118,39,217,727,2001/2002
"World Peace,Metta",152,351,.433,36,91,.396,116,260,.446,81,129,.628,40,91,131,77,75,69,23,108,421,2001/2002
"World Peace,Metta",117,285,.411,17,79,.215,100,206,.485,55,75,.733,33,107,140,50,66,49,16,109,306,2001/2002
"Wright,Lorenzen",223,486,.459,0,2,.000,223,484,.461,70,123,.569,130,275,405,44,30,72,23,126,516,2001/2002
"Zhizhi,Wang",109,248,.440,48,116,.414,61,132,.462,42,57,.737,19,92,111,22,11,25,18,84,308,2001/2002
"Abdul-Wahad,Tariq",27,58,.466,0,1,.000,27,57,.474,3,6,.500,14,26,40,21,6,7,3,26,57,2002/2003
"Abdur-Rahim,Shareef",566,1183,.478,21,60,.350,545,1123,.485,455,541,.841,175,502,677,242,87,212,38,240,1608,2002/2003
"Alexander,Courtney",193,505,.382,19,57,.333,174,448,.388,118,146,.808,39,79,118,79,31,68,6,125,523,2002/2003
"Allen,Malik",335,790,.424,0,4,.000,335,786,.426,97,121,.802,134,291,425,54,37,128,78,234,767,2002/2003
"Allen,Ray",598,1363,.439,201,533,.377,397,830,.478,316,345,.916,94,287,381,334,103,198,14,220,1713,2002/2003
"Allen,Ray",351,803,.437,123,311,.395,228,492,.463,178,195,.913,45,173,218,164,57,117,11,149,1003,2002/2003
"Allen,Ray",247,560,.441,78,222,.351,169,338,.500,138,150,.920,49,114,163,170,46,81,3,71,710,2002/2003
"Alston,Rafer",139,335,.415,51,130,.392,88,205,.429,37,54,.685,21,86,107,192,38,86,15,120,366,2002/2003
"Amaechi,John",37,118,.314,0,0,,37,118,.314,25,52,.481,26,51,77,21,14,34,7,50,99,2002/2003
"Andersen,Chris",114,285,.400,0,1,.000,114,284,.401,77,140,.550,109,165,274,32,30,60,60,90,305,2002/2003
"Anderson,Derek",355,832,.427,116,331,.350,239,501,.477,231,269,.859,53,211,264,325,90,128,16,141,1057,2002/2003
"Anderson,Kenny",163,382,.427,1,7,.143,162,375,.432,45,57,.789,31,101,132,198,58,75,5,106,372,2002/2003
"Anderson,Kenny",102,232,.440,0,5,.000,102,227,.449,29,35,.829,17,70,87,121,40,33,1,63,233,2002/2003
"Anderson,Kenny",61,150,.407,1,2,.500,60,148,.405,16,22,.727,14,31,45,77,18,42,4,43,139,2002/2003
"Anderson,Shandon",248,537,.462,52,140,.371,196,397,.494,139,190,.732,64,190,254,87,73,114,20,177,687,2002/2003
"Archibald,Robert",6,20,.300,0,0,,6,20,.300,7,18,.389,6,11,17,3,0,7,3,9,19,2002/2003
"Arenas,Gilbert",509,1180,.431,109,313,.348,400,867,.461,370,468,.791,97,289,386,514,124,290,17,260,1497,2002/2003
"Armstrong,Brandon",9,27,.333,1,6,.167,8,21,.381,5,6,.833,0,4,4,2,3,5,1,8,24,2002/2003
"Armstrong,Darrell",263,643,.409,78,232,.336,185,411,.450,165,188,.878,91,204,295,323,135,160,13,167,769,2002/2003
"Arroyo,Carlos",50,109,.459,3,7,.429,47,102,.461,18,22,.818,11,15,26,53,12,30,1,28,121,2002/2003
"Atkins,Chucky",168,465,.361,86,242,.355,82,223,.368,40,49,.816,21,75,96,175,27,77,4,108,462,2002/2003
"Augmon,Stacey",79,192,.411,0,7,.000,79,185,.427,54,72,.750,26,93,119,69,27,40,9,80,212,2002/2003
"Bagarić,Dalibor",8,26,.308,0,0,,8,26,.308,3,4,.750,7,13,20,4,3,5,3,11,19,2002/2003
"Baker,Vin",99,207,.478,0,4,.000,99,203,.488,72,107,.673,90,108,198,29,22,61,30,146,270,2002/2003
"Barry,Brent",264,577,.458,118,293,.403,146,284,.514,128,161,.795,48,253,301,384,113,142,15,199,774,2002/2003
"Barry,Jon",191,424,.450,87,214,.407,104,210,.495,86,100,.860,33,147,180,206,63,81,14,104,555,2002/2003
"Baston,Maceo",15,25,.600,0,0,,15,25,.600,10,12,.833,4,19,23,0,4,6,11,16,40,2002/2003
"Bateer,Mengke",4,17,.235,1,3,.333,3,14,.214,0,2,.000,2,8,10,4,0,6,0,14,9,2002/2003
"Batiste,Mike",197,467,.422,18,81,.222,179,386,.464,69,88,.784,82,175,257,52,42,69,16,120,481,2002/2003
"Battie,Tony",199,369,.539,1,5,.200,198,364,.544,88,118,.746,148,285,433,49,33,48,81,197,487,2002/2003
"Battier,Shane",275,569,.483,86,216,.398,189,353,.535,120,145,.828,128,217,345,105,102,68,88,207,756,2002/2003
"Baxter,Lonny",96,206,.466,0,2,.000,96,204,.471,70,103,.680,65,100,165,16,9,46,22,135,262,2002/2003
"Bell,Raja",93,211,.441,21,51,.412,72,160,.450,23,34,.676,47,98,145,57,52,43,8,134,230,2002/2003
"Bender,Jonathan",112,254,.441,19,53,.358,93,201,.463,60,84,.714,42,91,133,42,8,42,56,86,303,2002/2003
"Benjamin,Corey",13,43,.302,2,13,.154,11,30,.367,12,16,.750,10,21,31,10,1,6,2,20,40,2002/2003
"Best,Travis",231,583,.396,36,109,.330,195,474,.411,105,123,.854,26,121,147,255,44,106,7,174,603,2002/2003
"Bibby,Mike",329,700,.470,56,137,.409,273,563,.485,161,187,.861,34,113,147,285,72,127,8,93,875,2002/2003
"Billups,Chauncey",366,870,.421,149,380,.392,217,490,.443,318,362,.878,38,235,273,287,63,134,15,136,1199,2002/2003
"Blount,Corie",65,134,.485,0,0,,65,134,.485,20,35,.571,68,137,205,50,33,43,19,121,150,2002/2003
"Blount,Mark",150,347,.432,0,0,,150,347,.432,101,139,.727,111,197,308,56,42,103,68,187,401,2002/2003
"Blount,Mark",105,267,.393,0,0,,105,267,.393,71,99,.717,62,121,183,35,22,70,51,112,281,2002/2003
"Blount,Mark",45,80,.563,0,0,,45,80,.563,30,40,.750,49,76,125,21,20,33,17,75,120,2002/2003
"Booth,Calvin",52,119,.437,0,2,.000,52,117,.444,34,47,.723,32,77,109,12,11,22,33,74,138,2002/2003
"Boozer,Carlos",331,618,.536,0,1,.000,331,617,.536,148,192,.771,202,407,609,106,59,103,50,224,810,2002/2003
"Boumtje-Boumtje,Ruben",0,1,.000,0,0,,0,1,.000,0,0,,1,0,1,1,1,0,0,0,0,2002/2003
"Bowen,Bruce",223,479,.466,101,229,.441,122,250,.488,36,89,.404,59,180,239,113,66,72,42,195,583,2002/2003
"Bowen,Ryan",97,197,.492,2,7,.286,95,190,.500,27,41,.659,78,79,157,54,65,43,29,82,223,2002/2003
"Boykins,Earl",199,464,.429,29,77,.377,170,387,.439,173,200,.865,35,53,88,221,38,73,4,75,600,2002/2003
"Bradley,Michael",151,314,.481,1,6,.167,150,308,.487,35,67,.522,162,247,409,67,16,76,32,125,338,2002/2003
"Bradley,Shawn",201,375,.536,0,1,.000,201,374,.537,141,175,.806,151,325,476,54,65,67,170,242,543,2002/2003
"Brand,Elton",451,899,.502,0,1,.000,451,898,.502,244,356,.685,283,420,703,157,71,161,158,204,1146,2002/2003
"Bremer,J.R.",171,464,.369,101,286,.353,70,178,.393,85,111,.766,18,127,145,164,38,59,3,80,528,2002/2003
"Brewer,Jamison",9,17,.529,0,2,.000,9,15,.600,4,9,.444,5,4,9,18,2,6,1,11,22,2002/2003
"Brezec,Primož",15,38,.395,0,1,.000,15,37,.405,12,20,.600,13,10,23,4,2,7,4,16,42,2002/2003
"Brown,Damone",11,35,.314,0,2,.000,11,33,.333,6,8,.750,3,12,15,3,1,6,0,14,28,2002/2003
"Brown,Devin",12,35,.343,0,1,.000,12,34,.353,6,8,.750,8,10,18,7,4,9,1,14,30,2002/2003
"Brown,Devin",5,10,.500,0,0,,5,10,.500,2,2,1.000,4,3,7,2,0,5,0,3,12,2002/2003
"Brown,Devin",7,25,.280,0,1,.000,7,24,.292,4,6,.667,4,7,11,5,4,4,1,11,18,2002/2003
"Brown,Kedrick",61,171,.357,3,39,.077,58,132,.439,20,32,.625,45,95,140,20,34,23,13,68,145,2002/2003
"Brown,Kwame",224,502,.446,0,3,.000,224,499,.449,145,217,.668,128,298,426,58,50,110,80,159,593,2002/2003
"Brown,P.J.",319,601,.531,0,3,.000,319,598,.533,194,232,.836,243,458,701,147,67,98,80,203,832,2002/2003
"Brown,Randy",16,43,.372,0,0,,16,43,.372,9,12,.750,3,23,26,35,17,17,2,36,41,2002/2003
"Brown,Tierre",27,59,.458,0,1,.000,27,58,.466,11,14,.786,8,22,30,39,13,22,0,9,65,2002/2003
"Brunson,Rick",23,50,.460,4,6,.667,19,44,.432,10,12,.833,4,15,19,36,10,17,3,20,60,2002/2003
"Bryant,Kobe",868,1924,.451,124,324,.383,744,1600,.465,601,713,.843,106,458,564,481,181,288,67,218,2461,2002/2003
"Bryant,Mark",5,19,.263,0,0,,5,19,.263,3,4,.750,8,12,20,4,1,7,1,18,13,2002/2003
"Bryant,Mark",5,17,.294,0,0,,5,17,.294,2,2,1.000,7,9,16,1,1,5,1,12,12,2002/2003
"Bryant,Mark",0,1,.000,0,0,,0,1,.000,1,2,.500,1,1,2,2,0,2,0,4,1,2002/2003
"Bryant,Mark",0,1,.000,0,0,,0,1,.000,0,0,,0,2,2,1,0,0,0,2,0,2002/2003
"Buckner,Greg",185,398,.465,15,55,.273,170,343,.496,65,81,.802,72,144,216,96,72,62,16,203,450,2002/2003
"Burke,Pat",113,296,.382,1,7,.143,112,289,.388,40,58,.690,57,89,146,23,19,47,25,99,267,2002/2003
"Butler,Caron",429,1032,.416,34,107,.318,395,925,.427,309,375,.824,135,262,397,213,137,192,31,230,1201,2002/2003
"Butler,Rasual",207,572,.362,50,171,.292,157,401,.392,76,104,.731,29,157,186,93,21,77,43,105,540,2002/2003
"Caffey,Jason",113,248,.456,0,0,,113,248,.456,69,106,.651,68,108,176,38,19,56,15,122,295,2002/2003
"Camby,Marcus",93,227,.410,2,5,.400,91,222,.410,33,50,.660,75,133,208,47,20,27,40,69,221,2002/2003
"Campbell,Elden",117,295,.397,0,1,.000,117,294,.398,109,136,.801,47,134,181,51,33,50,39,129,343,2002/2003
"Campbell,Elden",101,247,.409,0,1,.000,101,246,.411,93,115,.809,34,108,142,42,24,42,31,102,295,2002/2003
"Campbell,Elden",16,48,.333,0,0,,16,48,.333,16,21,.762,13,26,39,9,9,8,8,27,48,2002/2003
"Cardinal,Brian",1,4,.250,0,1,.000,1,3,.333,2,2,1.000,3,2,5,1,0,1,0,0,4,2002/2003
"Carter,Anthony",83,233,.356,0,8,.000,83,225,.369,33,50,.660,12,71,83,203,45,81,5,70,199,2002/2003
"Carter,Vince",355,760,.467,45,131,.344,310,629,.493,129,160,.806,59,129,188,143,48,74,41,121,884,2002/2003
"Cassell,Sam",546,1162,.470,59,163,.362,487,999,.487,385,447,.861,57,285,342,450,88,177,14,216,1536,2002/2003
"Cato,Kelvin",133,256,.520,0,4,.000,133,252,.528,66,124,.532,132,296,428,20,38,56,85,176,332,2002/2003
"Chandler,Tyson",257,484,.531,0,0,,257,484,.531,177,291,.608,169,345,514,76,37,135,106,220,691,2002/2003
"Cheaney,Calbert",325,651,.499,10,25,.400,315,626,.503,40,69,.580,73,211,284,163,65,108,13,225,700,2002/2003
"Childs,Chris",6,20,.300,1,6,.167,5,14,.357,2,3,.667,3,2,5,16,8,6,1,17,15,2002/2003
"Christie,Doug",267,557,.479,73,185,.395,194,372,.522,141,174,.810,61,281,342,376,180,144,37,186,748,2002/2003
"Clark,Keon",226,451,.501,0,4,.000,226,447,.506,84,128,.656,138,313,451,80,38,94,150,227,536,2002/2003
"Claxton,Speedy",67,145,.462,0,11,.000,67,134,.500,39,57,.684,22,34,56,75,22,35,7,43,173,2002/2003
"Cleaves,Mateen",6,23,.261,1,1,1.000,5,22,.227,3,4,.750,1,7,8,10,2,14,0,6,16,2002/2003
"Coleman,Derrick",223,498,.448,22,67,.328,201,431,.466,134,171,.784,151,299,450,87,53,96,69,171,602,2002/2003
"Coles,Bimbo",56,168,.333,7,32,.219,49,136,.360,35,42,.833,11,48,59,72,17,28,4,60,154,2002/2003
"Coles,Bimbo",34,119,.286,7,25,.280,27,94,.287,27,34,.794,10,38,48,56,11,18,4,43,102,2002/2003
"Coles,Bimbo",22,49,.449,0,7,.000,22,42,.524,8,8,1.000,1,10,11,16,6,10,0,17,52,2002/2003
"Collier,Jason",17,36,.472,0,0,,17,36,.472,2,2,1.000,12,17,29,1,2,2,1,10,36,2002/2003
"Collins,Jarron",38,86,.442,0,1,.000,38,85,.447,44,62,.710,32,28,60,14,5,19,6,70,120,2002/2003
"Collins,Jason",140,338,.414,0,4,.000,140,334,.419,180,236,.763,136,232,368,87,47,85,44,252,460,2002/2003
"Crawford,Chris",8,13,.615,1,3,.333,7,10,.700,7,8,.875,3,4,7,1,2,2,3,7,24,2002/2003
"Crawford,Jamal",334,808,.413,86,242,.355,248,566,.438,104,129,.806,21,164,185,334,77,134,25,126,858,2002/2003
"Croshere,Austin",86,209,.411,27,69,.391,59,140,.421,53,65,.815,40,115,155,56,6,28,13,48,252,2002/2003
"Crotty,John",14,41,.341,4,13,.308,10,28,.357,9,15,.600,1,14,15,29,3,9,0,16,41,2002/2003
"Curry,Eddy",335,573,.585,0,0,,335,573,.585,179,287,.624,116,237,353,37,18,137,62,226,849,2002/2003
"Curry,Michael",92,229,.402,16,54,.296,76,175,.434,36,45,.800,16,111,127,104,44,43,4,163,236,2002/2003
"Dampier,Erick",259,522,.496,0,2,.000,259,520,.498,155,222,.698,248,295,543,58,27,112,154,242,673,2002/2003
"Daniels,Antonio",84,186,.452,18,59,.305,66,127,.520,65,76,.855,11,61,72,85,33,32,9,43,251,2002/2003
"Davis,Antonio",261,641,.407,0,0,,261,641,.407,216,280,.771,130,307,437,131,23,118,62,150,738,2002/2003
"Davis,Baron",332,798,.416,99,283,.350,233,515,.452,93,131,.710,56,130,186,320,91,140,22,148,856,2002/2003
"Davis,Dale",237,438,.541,0,0,,237,438,.541,105,166,.633,233,331,564,94,51,71,70,189,579,2002/2003
"Davis,Emanual",32,88,.364,7,29,.241,25,59,.424,17,22,.773,5,38,43,36,12,25,2,28,88,2002/2003
"Davis,Hubert",31,79,.392,12,36,.333,19,43,.442,5,6,.833,6,30,36,29,5,11,0,23,79,2002/2003
"Davis,Ricky",602,1470,.410,74,204,.363,528,1266,.417,348,465,.748,97,293,390,436,125,277,36,180,1626,2002/2003
"DeClercq,Andrew",149,279,.534,0,0,,149,279,.534,67,104,.644,142,197,339,52,39,84,36,258,365,2002/2003
"Delk,Tony",233,560,.416,120,304,.395,113,256,.441,68,87,.782,41,191,232,146,72,69,10,124,654,2002/2003
"Dickau,Dan",70,170,.412,22,61,.361,48,109,.440,21,26,.808,9,34,43,85,14,53,2,66,183,2002/2003
"Dickerson,Michael",10,24,.417,4,11,.364,6,13,.462,5,5,1.000,1,5,6,8,5,6,1,16,29,2002/2003
"Diop,DeSagana",54,154,.351,0,0,,54,154,.351,11,30,.367,63,152,215,43,33,56,81,148,119,2002/2003
"Divac,Vlade",305,655,.466,6,25,.240,299,630,.475,179,251,.713,157,417,574,274,83,152,105,239,795,2002/2003
"Dixon,Juan",104,271,.384,25,84,.298,79,187,.422,37,46,.804,13,59,72,40,26,42,3,54,270,2002/2003
"Doleac,Michael",146,343,.426,0,0,,146,343,.426,36,46,.783,65,154,219,42,16,49,16,150,328,2002/2003
"Dooling,Keyon",128,329,.389,50,139,.360,78,190,.411,44,57,.772,9,63,72,89,24,60,6,93,350,2002/2003
"Drew,Bryce",8,27,.296,3,7,.429,5,20,.250,0,0,,4,9,13,11,2,3,0,2,19,2002/2003
"Drobnjak,Predrag",325,789,.412,30,85,.353,295,704,.419,91,115,.791,111,209,320,86,48,65,38,180,771,2002/2003
"Dudley,Chris",0,1,.000,0,0,,0,1,.000,0,0,,2,0,2,0,0,0,0,3,0,2002/2003
"Duncan,Tim",714,1392,.513,6,22,.273,708,1370,.517,450,634,.710,259,784,1043,316,55,248,237,231,1884,2002/2003
"Dunleavy,Mike",168,417,.403,52,150,.347,116,267,.434,78,100,.780,66,148,214,106,53,86,19,120,466,2002/2003
"Eisley,Howard",262,628,.417,131,337,.389,131,291,.450,89,105,.848,24,162,186,444,71,149,9,222,744,2002/2003
"Ellis,LaPhonso",100,262,.382,27,107,.252,73,155,.471,50,66,.758,44,113,157,15,15,31,15,88,277,2002/2003
"Ely,Melvin",92,186,.495,0,0,,92,186,.495,52,74,.703,64,110,174,15,10,50,32,95,236,2002/2003
"Eschmeyer,Evan",7,19,.368,0,0,,7,19,.368,3,4,.750,10,19,29,6,10,6,7,35,17,2002/2003
"Evans,Reggie",66,140,.471,0,0,,66,140,.471,80,154,.519,167,278,445,34,38,52,11,173,212,2002/2003
"Ferry,Danny",44,124,.355,21,60,.350,23,64,.359,10,13,.769,20,55,75,21,7,27,9,55,119,2002/2003
"Finley,Michael",507,1193,.425,119,322,.370,388,871,.445,198,230,.861,107,295,402,205,76,114,21,105,1331,2002/2003
"Fisher,Derek",339,775,.437,85,212,.401,254,563,.451,100,125,.800,40,199,239,298,93,94,15,195,863,2002/2003
"Fizer,Marcus",178,383,.465,1,6,.167,177,377,.469,88,134,.657,80,136,216,48,14,57,17,89,445,2002/2003
"Ford,Alton",3,9,.333,0,0,,3,9,.333,1,3,.333,0,6,6,1,0,2,0,7,7,2002/2003
"Forte,Joseph",10,35,.286,0,3,.000,10,32,.313,4,6,.667,4,7,11,11,4,10,0,6,24,2002/2003
"Fortson,Danny",20,54,.370,0,1,.000,20,53,.377,19,29,.655,28,45,73,12,9,15,0,43,59,2002/2003
"Foster,Greg",47,122,.385,1,4,.250,46,118,.390,26,32,.813,30,72,102,13,1,30,9,82,121,2002/2003
"Foster,Jeff",64,178,.360,0,2,.000,64,176,.364,34,63,.540,118,161,279,51,28,34,21,103,162,2002/2003
"Fowlkes,Tremaine",56,128,.438,2,9,.222,54,119,.454,50,59,.847,41,62,103,23,25,20,2,63,164,2002/2003
"Fox,Rick",262,621,.422,105,280,.375,157,341,.460,52,69,.754,64,259,323,253,69,121,14,215,681,2002/2003
"Foyle,Adonal",185,345,.536,0,1,.000,185,344,.538,70,104,.673,176,314,490,37,40,73,205,214,440,2002/2003
"Francis,Steve",571,1312,.435,85,240,.354,486,1072,.453,476,595,.800,159,340,499,502,141,299,41,251,1703,2002/2003
"Funderburke,Lawrence",32,72,.444,0,0,,32,72,.444,10,17,.588,17,38,55,8,1,6,11,25,74,2002/2003
"Gadzuric,Dan",70,145,.483,0,1,.000,70,144,.486,29,56,.518,66,131,197,9,22,27,52,125,169,2002/2003
"Garnett,Kevin",743,1481,.502,20,71,.282,723,1410,.513,377,502,.751,244,858,1102,495,113,229,129,199,1883,2002/2003
"Garrity,Pat",312,744,.419,161,407,.396,151,337,.448,83,100,.830,72,234,306,121,62,77,20,255,868,2002/2003
"Gasol,Pau",569,1116,.510,1,10,.100,568,1106,.514,416,565,.736,192,528,720,229,34,213,148,220,1555,2002/2003
"George,Devean",180,461,.390,49,132,.371,131,329,.398,83,105,.790,91,195,286,92,56,65,38,180,492,2002/2003
"Gill,Kendall",286,677,.422,19,59,.322,267,618,.432,123,161,.764,51,197,248,156,78,108,15,176,714,2002/2003
"Ginóbili,Manu",174,397,.438,51,148,.345,123,249,.494,126,171,.737,47,114,161,138,96,100,17,170,525,2002/2003
"Giriček,Gordan",350,803,.436,85,249,.341,265,554,.478,150,183,.820,36,202,238,137,52,145,8,159,935,2002/2003
"Giriček,Gordan",207,478,.433,46,130,.354,161,348,.463,88,107,.822,18,90,108,70,22,94,6,104,548,2002/2003
"Giriček,Gordan",143,325,.440,39,119,.328,104,206,.505,62,76,.816,18,112,130,67,30,51,2,55,387,2002/2003
"Glover,Dion",277,648,.427,56,158,.354,221,490,.451,127,162,.784,62,220,282,141,71,108,15,146,737,2002/2003
"Goldwire,Anthony",9,25,.360,3,9,.333,6,16,.375,4,7,.571,0,6,6,4,3,6,0,6,25,2002/2003
"Goldwire,Anthony",5,18,.278,2,8,.250,3,10,.300,0,2,.000,0,3,3,3,3,2,0,5,12,2002/2003
"Goldwire,Anthony",4,7,.571,1,1,1.000,3,6,.500,4,5,.800,0,3,3,1,0,4,0,1,13,2002/2003
"Gooden,Drew",355,777,.457,14,48,.292,341,729,.468,151,212,.712,163,292,455,83,53,150,35,172,875,2002/2003
"Gooden,Drew",255,576,.443,14,46,.304,241,530,.455,92,132,.697,105,190,295,63,38,105,22,121,616,2002/2003
"Gooden,Drew",100,201,.498,0,2,.000,100,199,.503,59,80,.738,58,102,160,20,15,45,13,51,259,2002/2003
"Grant,Brian",344,676,.509,0,0,,344,676,.509,158,205,.771,241,596,837,104,63,129,47,300,846,2002/2003
"Grant,Horace",13,25,.520,0,0,,13,25,.520,0,0,,2,6,8,7,3,1,0,5,26,2002/2003
"Griffin,Adrian",146,337,.433,6,24,.250,140,313,.447,27,32,.844,88,176,264,105,77,47,6,157,325,2002/2003
"Griffin,Eddie",271,678,.400,64,192,.333,207,486,.426,58,94,.617,138,323,461,86,52,76,111,136,664,2002/2003
"Gugliotta,Tom",60,132,.455,0,1,.000,60,131,.458,9,9,1.000,25,75,100,31,14,31,5,35,129,2002/2003
"Guyton,A.J.",0,4,.000,0,1,.000,0,3,.000,0,0,,0,0,0,2,1,1,0,0,0,2002/2003
"Haislip,Marcus",66,153,.431,3,12,.250,63,141,.447,26,38,.684,21,32,53,9,7,21,18,55,161,2002/2003
"Ham,Darvin",71,159,.447,0,3,.000,71,156,.455,38,79,.481,73,80,153,38,16,65,19,127,180,2002/2003
"Hamilton,Richard",570,1286,.443,32,119,.269,538,1167,.461,440,528,.833,88,230,318,208,64,200,13,249,1612,2002/2003
"Hamilton,Zendon",2,5,.400,0,0,,2,5,.400,2,2,1.000,1,3,4,0,1,1,0,2,6,2002/2003
"Hardaway,Anfernee",256,573,.447,26,73,.356,230,500,.460,77,97,.794,66,192,258,235,66,145,26,150,615,2002/2003
"Hardaway,Tim",18,49,.367,11,31,.355,7,18,.389,2,4,.500,1,14,15,24,9,11,0,8,49,2002/2003
"Harpring,Matt",521,1020,.511,66,160,.413,455,860,.529,262,331,.792,190,324,514,133,73,160,17,217,1370,2002/2003
"Harrington,Adam",11,37,.297,5,14,.357,6,23,.261,3,4,.750,1,7,8,12,2,2,1,8,30,2002/2003
"Harrington,Adam",4,17,.235,1,3,.333,3,14,.214,2,2,1.000,0,2,2,2,1,2,1,2,11,2002/2003
"Harrington,Adam",7,20,.350,4,11,.364,3,9,.333,1,2,.500,1,5,6,10,1,0,0,6,19,2002/2003
"Harrington,Al",389,896,.434,13,46,.283,376,850,.442,211,274,.770,159,352,511,125,71,163,33,280,1002,2002/2003
"Harrington,Junior",169,467,.362,7,28,.250,162,439,.369,73,112,.652,44,206,250,277,80,157,15,250,418,2002/2003
"Harrington,Othella",225,443,.508,0,0,,225,443,.508,123,150,.820,165,311,476,62,12,90,23,231,573,2002/2003
"Harris,Lucious",298,721,.413,47,136,.346,251,585,.429,152,189,.804,63,169,232,155,53,71,8,95,795,2002/2003
"Harvey,Antonio",2,5,.400,0,0,,2,5,.400,0,0,,1,5,6,0,1,3,4,7,4,2002/2003
"Harvey,Donnell",246,551,.446,1,7,.143,245,544,.450,118,176,.670,125,284,409,100,48,123,27,203,611,2002/2003
"Hassell,Trenton",144,392,.367,13,40,.325,131,352,.372,41,55,.745,37,218,255,151,45,83,61,197,342,2002/2003
"Haston,Kirk",2,17,.118,0,3,.000,2,14,.143,2,4,.500,0,7,7,3,0,7,5,10,6,2002/2003
"Hawkins,Juaquin",57,148,.385,10,24,.417,47,124,.379,10,20,.500,16,62,78,47,29,29,6,57,134,2002/2003
"Haywood,Brendan",173,339,.510,0,0,,173,339,.510,155,245,.633,192,212,404,29,32,65,119,225,501,2002/2003
"Henderson,Alan",153,327,.468,0,2,.000,153,325,.471,88,138,.638,156,242,398,41,33,61,32,168,394,2002/2003
"Hilário,Nenê",321,619,.519,0,3,.000,321,616,.521,197,341,.578,208,283,491,149,127,181,65,295,839,2002/2003
"Hill,Grant",151,307,.492,1,4,.250,150,303,.495,118,144,.819,40,166,206,122,28,84,13,46,421,2002/2003
"Hill,Tyrone",129,306,.422,0,0,,129,306,.422,54,80,.675,126,265,391,41,46,68,26,172,312,2002/2003
"Hill,Tyrone",85,197,.431,0,0,,85,197,.431,33,45,.733,70,197,267,32,31,52,19,104,203,2002/2003
"Hill,Tyrone",44,109,.404,0,0,,44,109,.404,21,35,.600,56,68,124,9,15,16,7,68,109,2002/2003
"Hoiberg,Fred",49,126,.389,5,21,.238,44,105,.419,41,50,.820,11,126,137,70,40,25,5,59,144,2002/2003
"Horry,Robert",184,476,.387,51,177,.288,133,299,.445,103,134,.769,181,333,514,233,96,112,61,247,522,2002/2003
"House,Eddie",172,444,.387,36,120,.300,136,324,.420,31,36,.861,17,84,101,87,44,46,1,73,411,2002/2003
"Houston,Allan",652,1465,.445,178,450,.396,474,1015,.467,363,395,.919,26,205,231,220,54,178,7,191,1845,2002/2003
"Howard,Juwan",567,1261,.450,2,4,.500,565,1257,.449,282,351,.803,181,404,585,234,77,189,27,239,1418,2002/2003
"Hudson,Troy",409,956,.428,97,266,.365,312,690,.452,208,231,.900,42,141,183,452,60,182,7,160,1123,2002/2003
"Huffman,Nate",9,25,.360,0,0,,9,25,.360,5,8,.625,9,14,23,5,1,3,3,13,23,2002/2003
"Hughes,Larry",346,741,.467,29,79,.367,317,662,.479,136,186,.731,67,241,308,205,86,136,24,149,857,2002/2003
"Humphrey,Ryan",35,120,.292,0,0,,35,120,.292,23,39,.590,34,65,99,11,9,23,18,75,93,2002/2003
"Humphrey,Ryan",23,85,.271,0,0,,23,85,.271,18,28,.643,30,39,69,7,4,21,16,57,64,2002/2003
"Humphrey,Ryan",12,35,.343,0,0,,12,35,.343,5,11,.455,4,26,30,4,5,2,2,18,29,2002/2003
"Hunter,Lindsey",106,302,.351,34,107,.318,72,195,.369,34,47,.723,15,44,59,71,35,57,5,50,280,2002/2003
"Hunter,Steven",56,103,.544,0,0,,56,103,.544,18,44,.409,38,55,93,6,9,15,36,56,130,2002/2003
"Ilgauskas,Zydrunas",495,1122,.441,0,5,.000,495,1117,.443,400,512,.781,240,371,611,127,56,210,152,274,1390,2002/2003
"Iverson,Allen",804,1940,.414,84,303,.277,720,1637,.440,570,736,.774,68,276,344,454,225,286,13,149,2262,2002/2003
"Jackson,Bobby",340,732,.464,89,235,.379,251,497,.505,126,149,.846,57,162,219,182,71,106,3,126,895,2002/2003
"Jackson,Jermaine",40,110,.364,1,10,.100,39,100,.390,40,55,.727,19,38,57,74,19,34,6,51,121,2002/2003
"Jackson,Jermaine",21,68,.309,1,9,.111,20,59,.339,23,27,.852,10,15,25,39,9,19,3,24,66,2002/2003
"Jackson,Jermaine",19,42,.452,0,1,.000,19,41,.463,17,28,.607,9,23,32,35,10,15,3,27,55,2002/2003
"Jackson,Jim",204,462,.442,32,71,.451,172,391,.440,47,55,.855,84,178,262,118,31,80,4,132,487,2002/2003
"Jackson,Marc",153,349,.438,1,1,1.000,152,348,.437,114,149,.765,86,139,225,37,24,59,30,137,421,2002/2003
"Jackson,Mark",147,369,.398,27,95,.284,120,274,.438,61,80,.763,34,142,176,375,48,152,3,90,382,2002/2003
"Jackson,Stephen",356,818,.435,95,297,.320,261,521,.501,139,183,.760,66,220,286,183,125,176,30,202,946,2002/2003
"Jacobsen,Casey",122,327,.373,52,165,.315,70,162,.432,72,105,.686,29,54,83,73,35,55,6,90,368,2002/2003
"James,Jerome",111,232,.478,0,0,,111,232,.478,54,92,.587,78,138,216,27,12,75,82,166,276,2002/2003
"James,Mike",218,585,.373,67,228,.294,151,357,.423,104,142,.732,26,123,149,246,64,108,5,176,607,2002/2003
"Jamison,Antawn",691,1471,.470,65,209,.311,626,1262,.496,375,475,.789,195,383,578,156,76,177,45,197,1822,2002/2003
"Jarić,Marko",179,446,.401,53,166,.319,126,280,.450,79,105,.752,35,125,160,193,97,103,11,125,490,2002/2003
"Jefferies,Chris",75,194,.387,18,54,.333,57,140,.407,29,43,.674,16,43,59,22,19,45,16,56,197,2002/2003
"Jefferson,Richard",456,911,.501,6,24,.250,450,887,.507,324,436,.743,150,364,514,201,80,156,44,216,1242,2002/2003
"Jeffries,Jared",30,63,.476,3,6,.500,27,57,.474,16,29,.552,26,32,58,16,8,21,5,28,79,2002/2003
"Johnson,Anthony",103,231,.446,13,35,.371,90,196,.459,51,74,.689,13,65,78,86,37,41,5,93,270,2002/2003
"Johnson,Avery",63,150,.420,0,2,.000,63,148,.426,30,39,.769,10,21,31,64,15,29,1,26,156,2002/2003
"Johnson,Ervin",61,135,.452,0,0,,61,135,.452,30,44,.682,117,177,294,24,34,34,63,178,152,2002/2003
"Johnson,Joe",316,796,.397,75,205,.366,241,591,.408,96,124,.774,57,207,264,210,62,108,19,143,803,2002/2003
"Johnson,Ken",15,37,.405,0,0,,15,37,.405,2,6,.333,4,28,32,0,1,6,12,20,32,2002/2003
"Jones,Damon",80,210,.381,44,121,.364,36,89,.404,20,27,.741,11,59,70,80,18,23,4,42,224,2002/2003
"Jones,Eddie",291,688,.423,98,241,.407,193,447,.432,189,230,.822,35,191,226,173,64,85,31,137,869,2002/2003
"Jones,Fred",9,24,.375,2,7,.286,7,17,.412,3,4,.750,4,5,9,5,6,6,1,13,23,2002/2003
"Jones,Jumaine",308,710,.434,111,314,.354,197,396,.497,57,83,.687,106,299,405,112,67,107,22,176,784,2002/2003
"Jones,Popeye",24,62,.387,0,0,,24,62,.387,5,11,.455,29,30,59,8,5,15,1,31,53,2002/2003
"Jordan,Michael",679,1527,.445,16,55,.291,663,1472,.450,266,324,.821,71,426,497,311,123,173,39,171,1640,2002/2003
"Kemp,Shawn",211,505,.418,0,1,.000,211,504,.419,115,155,.742,147,304,451,55,66,102,33,239,537,2002/2003
"Kerr,Steve",110,256,.430,49,124,.395,61,132,.462,30,34,.882,12,48,60,70,27,35,3,49,299,2002/2003
"Kidd,Jason",515,1244,.414,126,370,.341,389,874,.445,339,403,.841,110,394,504,711,179,296,25,127,1495,2002/2003
"Kirilenko,Andrei",315,642,.491,37,114,.325,278,528,.527,296,370,.800,147,273,420,138,118,136,175,185,963,2002/2003
"Kittles,Kerry",332,711,.467,78,219,.356,254,492,.516,106,135,.785,52,200,252,170,101,55,30,110,848,2002/2003
"Knight,Brevin",97,228,.425,2,8,.250,95,220,.432,20,37,.541,15,66,81,233,69,94,2,123,216,2002/2003
"Knight,Travis",25,65,.385,0,1,.000,25,64,.391,10,13,.769,18,44,62,14,8,10,9,44,60,2002/2003
"Kukoč,Toni",249,577,.432,95,263,.361,154,314,.490,137,194,.706,67,199,266,230,81,122,29,134,730,2002/2003
"Laettner,Christian",255,516,.494,2,16,.125,253,500,.506,120,144,.833,114,388,502,235,82,87,40,206,632,2002/2003
"LaFrentz,Raef",266,514,.518,47,116,.405,219,398,.550,60,88,.682,125,205,330,54,35,46,91,264,639,2002/2003
"Lampley,Sean",56,129,.434,0,4,.000,56,125,.448,57,82,.695,26,57,83,31,7,25,3,43,169,2002/2003
"Langhi,Dan",81,202,.401,9,31,.290,72,171,.421,12,20,.600,19,68,87,21,15,16,6,58,183,2002/2003
"Lenard,Voshon",325,809,.402,92,252,.365,233,557,.418,156,194,.804,48,164,212,144,59,103,21,156,898,2002/2003
"Lewis,Rashard",519,1149,.452,75,217,.346,444,932,.476,283,345,.820,152,351,503,133,99,143,35,205,1396,2002/2003
"Livingston,Randy",2,4,.500,0,0,,2,4,.500,2,2,1.000,0,0,0,1,0,0,0,0,6,2002/2003
"Long,Art",28,75,.373,2,3,.667,26,72,.361,2,10,.200,21,39,60,6,5,20,11,35,60,2002/2003
"Long,Art",19,50,.380,1,1,1.000,18,49,.367,1,5,.200,13,27,40,2,2,9,8,22,40,2002/2003
"Long,Art",9,25,.360,1,2,.500,8,23,.348,1,5,.200,8,12,20,4,3,11,3,13,20,2002/2003
"Long,Grant",27,70,.386,0,3,.000,27,67,.403,18,23,.783,24,59,83,25,9,19,1,62,72,2002/2003
"Lue,Tyronn",248,573,.433,60,176,.341,188,397,.474,91,104,.875,22,127,149,263,47,77,1,151,647,2002/2003
"Lynch,George",147,359,.409,28,79,.354,119,280,.425,41,74,.554,139,214,353,104,66,52,19,136,363,2002/2003
"MacCulloch,Todd",123,238,.517,0,0,,123,238,.517,53,79,.671,66,130,196,20,19,35,32,107,299,2002/2003
"Maddox,Tito",3,12,.250,0,3,.000,3,9,.333,5,8,.625,1,6,7,5,3,3,1,4,11,2002/2003
"Madsen,Mark",69,163,.423,0,0,,69,163,.423,36,61,.590,86,73,159,38,15,27,19,116,174,2002/2003
"Maggette,Corey",343,773,.444,62,177,.350,281,596,.471,325,405,.802,77,245,322,123,55,147,16,194,1073,2002/2003
"Magloire,Jamaal",305,635,.480,0,3,.000,305,632,.483,231,322,.717,260,464,724,88,49,158,111,276,841,2002/2003
"Malone,Karl",595,1289,.462,3,14,.214,592,1275,.464,474,621,.763,113,515,628,379,136,210,31,204,1667,2002/2003
"Maloney,Matt",8,25,.320,5,15,.333,3,10,.300,3,5,.600,1,6,7,17,4,5,0,9,24,2002/2003
"Manning,Danny",13,32,.406,3,8,.375,10,24,.417,5,6,.833,7,11,18,7,9,7,3,11,34,2002/2003
"Marbury,Stephon",671,1530,.439,89,296,.301,582,1234,.472,375,467,.803,53,210,263,654,108,263,20,200,1806,2002/2003
"Marion,Shawn",662,1466,.452,141,364,.387,521,1102,.473,251,295,.851,199,574,773,198,185,157,95,208,1716,2002/2003
"Marks,Sean",22,59,.373,0,1,.000,22,58,.379,10,15,.667,8,27,35,3,5,14,6,37,54,2002/2003
"Marshall,Donny",0,3,.000,0,1,.000,0,2,.000,0,0,,0,3,3,0,0,1,0,0,0,2002/2003
"Marshall,Donyell",421,918,.459,33,87,.379,388,831,.467,167,221,.756,234,465,699,137,95,135,85,234,1042,2002/2003
"Martin,Kenyon",509,1082,.470,9,43,.209,500,1039,.481,256,392,.653,164,476,640,185,98,192,70,294,1283,2002/2003
"Mashburn,Jamal",670,1586,.422,119,306,.389,551,1280,.430,313,369,.848,66,432,498,462,83,230,17,196,1772,2002/2003
"Mason,Anthony",191,393,.486,0,1,.000,191,392,.487,84,117,.718,90,326,416,209,32,79,12,147,466,2002/2003
"Mason,Desmond",457,1017,.449,21,72,.292,436,945,.461,212,283,.749,154,369,523,163,67,115,32,210,1147,2002/2003
"Mason,Desmond",291,667,.436,16,55,.291,275,612,.449,134,181,.740,88,247,335,95,47,74,21,136,732,2002/2003
"Mason,Desmond",166,350,.474,5,17,.294,161,333,.483,78,102,.765,66,122,188,68,20,41,11,74,415,2002/2003
"Mason,Roger",11,31,.355,6,18,.333,5,13,.385,2,2,1.000,2,10,12,12,4,5,0,20,30,2002/2003
"Massenburg,Tony",104,232,.448,0,0,,104,232,.448,65,84,.774,59,97,156,17,17,50,19,144,273,2002/2003
"McCarty,Walter",173,418,.414,91,248,.367,82,170,.482,61,98,.622,64,224,288,106,78,67,28,188,498,2002/2003
"McCaskill,Amal",4,17,.235,0,0,,4,17,.235,3,4,.750,7,15,22,5,3,2,1,13,11,2002/2003
"McCoy,Jelani",194,395,.491,0,0,,194,395,.491,69,126,.548,95,260,355,43,28,96,60,162,457,2002/2003
"McGrady,Tracy",829,1813,.457,173,448,.386,656,1365,.481,576,726,.793,121,367,488,411,124,195,59,156,2407,2002/2003
"McInnis,Jeff",188,423,.444,6,35,.171,182,388,.469,50,67,.746,22,75,97,170,21,75,2,117,432,2002/2003
"McKie,Aaron",286,666,.429,37,112,.330,249,554,.449,112,134,.836,61,289,350,278,131,109,9,177,721,2002/2003
"Medvedenko,Stanislav",112,258,.434,0,2,.000,112,256,.438,31,43,.721,66,75,141,18,11,37,8,118,255,2002/2003
"Mercer,Ron",244,597,.409,3,16,.188,241,581,.415,65,81,.802,32,122,154,112,49,54,14,123,556,2002/2003
"Mihm,Chris",116,287,.404,0,3,.000,116,284,.408,76,105,.724,93,138,231,28,18,48,38,124,308,2002/2003
"Miles,Darius",263,642,.410,0,14,.000,263,628,.419,92,155,.594,113,250,363,176,67,178,69,159,618,2002/2003
"Miller,Andre",377,928,.406,23,108,.213,354,820,.432,311,391,.795,84,232,316,537,99,206,11,203,1088,2002/2003
"Miller,Brad",329,667,.493,5,16,.313,324,651,.498,292,357,.818,185,418,603,193,65,118,43,203,955,2002/2003
"Miller,Mike",373,859,.434,109,300,.363,264,559,.472,156,186,.839,46,295,341,170,42,125,21,173,1011,2002/2003
"Miller,Mike",296,708,.418,87,256,.340,209,452,.462,127,150,.847,40,246,286,139,36,99,16,139,806,2002/2003
"Miller,Mike",77,151,.510,22,44,.500,55,107,.514,29,36,.806,6,49,55,31,6,26,5,34,205,2002/2003
"Miller,Reggie",281,637,.441,113,318,.355,168,319,.527,207,230,.900,21,151,172,170,62,66,4,89,882,2002/2003
"Mills,Chris",39,106,.368,7,25,.280,32,81,.395,16,18,.889,19,31,50,22,7,10,3,29,101,2002/2003
"Ming,Yao",401,805,.498,1,2,.500,400,803,.498,301,371,.811,196,479,675,137,31,173,147,230,1104,2002/2003
"Mobley,Cuttino",463,1067,.434,112,318,.352,351,749,.469,242,282,.858,70,233,303,208,95,166,36,185,1280,2002/2003
"Mohammed,Nazr",67,159,.421,0,0,,67,159,.421,26,41,.634,47,82,129,6,16,25,21,79,160,2002/2003
"Moïso,Jérôme",89,171,.520,0,0,,89,171,.520,27,41,.659,59,119,178,22,19,46,44,87,205,2002/2003
"Moore,Mikki",5,13,.385,0,0,,5,13,.385,8,10,.800,6,2,8,3,0,2,4,7,18,2002/2003
"Moore,Mikki",0,1,.000,0,0,,0,1,.000,0,0,,1,0,1,0,0,0,2,6,0,2002/2003
"Moore,Mikki",5,12,.417,0,0,,5,12,.417,8,10,.800,5,2,7,3,0,2,2,1,18,2002/2003
"Morris,Terence",82,176,.466,7,32,.219,75,144,.521,11,14,.786,40,88,128,25,8,29,17,35,182,2002/2003
"Murphy,Troy",338,749,.451,3,14,.214,335,735,.456,244,290,.841,228,578,806,106,65,111,30,246,923,2002/2003
"Murray,Ronald",11,31,.355,0,5,.000,11,26,.423,5,8,.625,0,4,4,5,4,8,0,0,27,2002/2003
"Murray,Ronald",9,26,.346,0,4,.000,9,22,.409,5,8,.625,0,1,1,3,4,4,0,0,23,2002/2003
"Murray,Ronald",2,5,.400,0,1,.000,2,4,.500,0,0,,0,3,3,2,0,4,0,0,4,2002/2003
"Murray,Tracy",23,71,.324,8,38,.211,15,33,.455,7,9,.778,5,18,23,12,5,14,3,22,61,2002/2003
"Mutombo,Dikembe",49,131,.374,0,0,,49,131,.374,40,55,.727,54,99,153,19,4,34,37,54,138,2002/2003
"N'Diaye,Mamadou",43,96,.448,0,0,,43,96,.448,34,47,.723,29,53,82,7,8,21,32,58,120,2002/2003
"Nachbar,Boštjan",11,31,.355,2,10,.200,9,21,.429,5,10,.500,3,8,11,3,2,6,2,13,29,2002/2003
"Nailon,Lee",84,190,.442,0,1,.000,84,189,.444,42,51,.824,32,38,70,26,6,32,3,46,210,2002/2003
"Nájera,Eduardo",129,231,.558,0,1,.000,129,230,.561,62,91,.681,90,133,223,47,40,23,22,129,320,2002/2003
"Nash,Steve",518,1114,.465,111,269,.413,407,845,.482,308,339,.909,63,171,234,598,85,192,6,134,1455,2002/2003
"Nesterović,Rasho",400,762,.525,0,2,.000,400,760,.526,61,95,.642,146,358,504,114,39,99,116,256,861,2002/2003
"Newble,Ira",231,467,.495,32,84,.381,199,383,.520,70,90,.778,86,185,271,99,50,69,26,174,564,2002/2003
"Norris,Moochie",134,330,.406,11,45,.244,123,285,.432,78,114,.684,37,122,159,196,55,86,4,72,357,2002/2003
"Nowitzki,Dirk",690,1489,.463,148,390,.379,542,1099,.493,483,548,.881,81,710,791,239,111,152,82,206,2011,2002/2003
"O'Neal,Jermaine",610,1260,.484,7,21,.333,603,1239,.487,373,510,.731,202,594,796,155,66,180,178,277,1600,2002/2003
"O'Neal,Shaquille",695,1211,.574,0,0,,695,1211,.574,451,725,.622,259,483,742,206,38,196,159,229,1841,2002/2003
"Oakley,Charles",23,55,.418,0,0,,23,55,.418,28,34,.824,37,70,107,40,13,21,6,90,74,2002/2003
"Odom,Lamar",268,611,.439,42,129,.326,226,482,.469,136,175,.777,59,267,326,178,42,140,41,181,714,2002/2003
"Okur,Mehmet",180,423,.426,38,112,.339,142,311,.457,96,131,.733,117,218,335,71,25,66,39,167,494,2002/2003
"Oliver,Dean",7,29,.241,1,6,.167,6,23,.261,7,8,.875,8,8,16,23,7,10,0,9,22,2002/2003
"Ollie,Kevin",199,441,.451,2,6,.333,197,435,.453,134,178,.753,25,157,182,291,69,72,5,122,534,2002/2003
"Ollie,Kevin",117,255,.459,1,5,.200,116,250,.464,68,91,.747,12,87,99,181,37,36,4,71,303,2002/2003
"Ollie,Kevin",82,186,.441,1,1,1.000,81,185,.438,66,87,.759,13,70,83,110,32,36,1,51,231,2002/2003
"Olowokandi,Michael",186,436,.427,0,0,,186,436,.427,69,105,.657,57,271,328,47,18,98,79,110,441,2002/2003
"Ostertag,Greg",169,326,.518,0,0,,169,326,.518,100,196,.510,180,323,503,55,20,104,147,235,438,2002/2003
"Outlaw,Bo",153,278,.550,0,2,.000,153,276,.554,72,116,.621,134,234,368,112,50,76,71,194,378,2002/2003
"Owens,Chris",2,3,.667,0,0,,2,3,.667,0,0,,1,0,1,0,0,1,0,0,4,2002/2003
"Oyedeji,Olumide",10,23,.435,0,0,,10,23,.435,7,11,.636,10,40,50,5,5,5,3,30,27,2002/2003
"Pack,Robert",52,129,.403,0,5,.000,52,124,.419,41,55,.745,11,40,51,81,25,40,0,35,145,2002/2003
"Padgett,Scott",170,423,.402,45,133,.338,125,290,.431,81,107,.757,83,189,272,86,41,70,24,148,466,2002/2003
"Palacio,Milt",162,388,.418,8,37,.216,154,351,.439,65,87,.747,48,187,235,259,68,131,16,168,397,2002/2003
"Pargo,Jannero",37,93,.398,7,24,.292,30,69,.435,4,4,1.000,9,28,37,39,13,23,2,45,85,2002/2003
"Parker,Smush",136,338,.402,38,118,.322,98,220,.445,98,118,.831,29,90,119,162,48,133,12,106,408,2002/2003
"Parker,Tony",484,1043,.464,82,243,.337,402,800,.503,219,290,.755,33,183,216,432,71,198,4,174,1269,2002/2003
"Parks,Cherokee",82,163,.503,1,2,.500,81,161,.503,23,38,.605,46,86,132,21,16,18,20,52,188,2002/2003
"Patterson,Ruben",254,516,.492,3,20,.150,251,496,.506,138,220,.627,120,144,264,101,73,117,29,161,649,2002/2003
"Payton,Gary",665,1466,.454,54,182,.297,611,1284,.476,250,352,.710,79,255,334,663,133,187,20,181,1634,2002/2003
"Payton,Gary",444,992,.448,34,114,.298,410,878,.467,162,234,.692,56,192,248,457,93,131,12,117,1084,2002/2003
"Payton,Gary",221,474,.466,20,68,.294,201,406,.495,88,118,.746,23,63,86,206,40,56,8,64,550,2002/2003
"Peeler,Anthony",252,609,.414,87,212,.410,165,397,.416,39,50,.780,40,201,241,244,72,82,13,161,630,2002/2003
"Person,Wesley",274,601,.456,100,231,.433,174,370,.470,79,97,.814,24,168,192,112,42,56,19,64,727,2002/2003
"Peterson,Morris",421,1073,.392,116,344,.337,305,729,.418,195,247,.789,97,266,363,188,88,128,32,232,1153,2002/2003
"Piatkowski,Eric",210,446,.471,80,201,.398,130,245,.531,101,122,.828,44,112,156,70,33,56,9,92,601,2002/2003
"Pierce,Paul",663,1592,.416,118,391,.302,545,1201,.454,604,753,.802,106,472,578,349,139,288,62,227,2048,2002/2003
"Pippen,Scottie",265,597,.444,38,133,.286,227,464,.489,121,148,.818,57,221,278,285,105,164,25,149,689,2002/2003
"Pollard,Scot",40,87,.460,0,0,,40,87,.460,23,38,.605,46,60,106,6,13,15,15,50,103,2002/2003
"Posey,James",309,752,.411,70,229,.306,239,523,.457,205,246,.833,90,336,426,184,106,144,15,197,893,2002/2003
"Posey,James",121,324,.373,24,88,.273,97,236,.411,86,102,.843,38,107,145,78,29,66,6,63,352,2002/2003
"Posey,James",188,428,.439,46,141,.326,142,287,.495,119,144,.826,52,229,281,106,77,78,9,134,541,2002/2003
"Postell,Lavor",14,38,.368,2,7,.286,12,31,.387,13,15,.867,1,3,4,3,2,7,0,9,43,2002/2003
"Potapenko,Vitaly",41,93,.441,0,0,,41,93,.441,22,29,.759,25,64,89,4,9,25,8,46,104,2002/2003
"Prince,Tayshaun",53,118,.449,20,47,.426,33,71,.465,11,17,.647,5,40,45,24,10,21,14,25,137,2002/2003
"Przybilla,Joel",18,46,.391,0,0,,18,46,.391,12,24,.500,48,97,145,12,10,19,45,85,48,2002/2003
"Radmanović,Vladimir",274,668,.410,104,293,.355,170,375,.453,72,102,.706,76,247,323,97,64,100,22,136,724,2002/2003
"Rakočević,Igor",22,58,.379,5,12,.417,17,46,.370,29,36,.806,4,13,17,33,4,23,0,25,78,2002/2003
"Randolph,Zach",264,515,.513,0,5,.000,264,510,.518,122,161,.758,139,204,343,41,42,62,14,141,650,2002/2003
"Ratliff,Theo",276,595,.464,0,0,,276,595,.464,154,214,.720,154,453,607,73,56,137,262,271,706,2002/2003
"Rebrača,Željko",80,145,.552,0,0,,80,145,.552,38,48,.792,27,65,92,9,6,29,17,79,198,2002/2003
"Redd,Michael",455,971,.469,182,416,.438,273,555,.492,149,185,.805,98,273,371,117,100,74,13,143,1241,2002/2003
"Reid,Don",0,3,.000,0,0,,0,3,.000,1,2,.500,0,0,0,0,0,0,0,4,1,2002/2003
"Rentzias,Efthimi",20,59,.339,4,8,.500,16,51,.314,8,9,.889,10,16,26,7,6,4,2,21,52,2002/2003
"Rice,Glen",196,457,.429,101,254,.398,95,203,.468,63,83,.759,28,126,154,65,23,55,5,99,556,2002/2003
"Richardson,Jason",476,1161,.410,123,334,.368,353,827,.427,207,271,.764,111,267,378,247,90,179,23,201,1282,2002/2003
"Richardson,Quentin",203,546,.372,61,198,.308,142,348,.408,85,124,.685,98,183,281,52,35,64,10,92,552,2002/2003
"Rigaudeau,Antoine",8,35,.229,1,5,.200,7,30,.233,0,0,,4,4,8,6,3,6,0,11,17,2002/2003
"Robinson,Clifford",372,935,.398,87,259,.336,285,676,.422,161,238,.676,81,237,318,268,87,158,88,259,992,2002/2003
"Robinson,David",197,420,.469,0,0,,197,420,.469,152,214,.710,163,345,508,61,52,83,111,126,546,2002/2003
"Robinson,Eddie",155,315,.492,3,14,.214,152,301,.505,51,63,.810,76,124,200,66,62,52,13,120,364,2002/2003
"Robinson,Glenn",539,1248,.432,90,263,.342,449,985,.456,268,306,.876,86,371,457,205,91,248,26,183,1436,2002/2003
"Rogers,Rodney",183,455,.402,44,132,.333,139,323,.430,68,90,.756,61,202,263,107,50,91,31,192,478,2002/2003
"Rooks,Sean",125,297,.421,0,1,.000,125,296,.422,47,58,.810,53,163,216,69,34,66,44,174,297,2002/2003
"Rose,Jalen",642,1583,.406,133,359,.370,509,1224,.416,399,467,.854,68,283,351,395,72,285,23,271,1816,2002/2003
"Rose,Malik",289,630,.459,2,5,.400,287,625,.459,242,306,.791,148,358,506,124,57,170,40,206,822,2002/2003
"Rucker,Guy",0,0,,0,0,,0,0,,0,0,,0,1,1,1,0,0,0,1,0,2002/2003
"Rush,Kareem",96,244,.393,19,68,.279,77,176,.438,16,23,.696,26,68,94,68,10,63,11,71,227,2002/2003
"Russell,Bryon",108,306,.353,46,140,.329,62,166,.373,53,69,.768,43,165,208,72,70,55,7,130,315,2002/2003
"Sabonis,Arvydas",172,361,.476,3,6,.500,169,355,.476,129,164,.787,88,247,335,142,61,75,49,141,476,2002/2003
"Salmons,John",48,116,.414,10,31,.323,38,85,.447,26,35,.743,16,43,59,47,17,29,6,53,132,2002/2003
"Samake,Soumaila",10,24,.417,0,0,,10,24,.417,2,2,1.000,10,13,23,4,0,2,5,13,22,2002/2003
"Sampson,Jamal",0,2,.000,0,0,,0,2,.000,0,0,,1,1,2,1,1,0,0,0,0,2002/2003
"Sánchez,Pepe",0,5,.000,0,0,,0,5,.000,0,0,,4,2,6,8,5,2,0,3,0,2002/2003
"Sasser,Jeryl",64,207,.309,13,44,.295,51,163,.313,53,78,.679,64,120,184,65,45,39,12,91,194,2002/2003
"Satterfield,Kenny",55,183,.301,5,28,.179,50,155,.323,17,25,.680,16,27,43,68,20,43,2,36,132,2002/2003
"Satterfield,Kenny",51,165,.309,5,28,.179,46,137,.336,16,23,.696,12,23,35,53,18,36,2,30,123,2002/2003
"Satterfield,Kenny",4,18,.222,0,0,,4,18,.222,1,2,.500,4,4,8,15,2,7,0,6,9,2002/2003
"Savović,Predrag",29,93,.312,4,26,.154,25,67,.373,21,29,.724,9,16,25,22,14,21,1,33,83,2002/2003
"Scalabrine,Brian",68,169,.402,14,39,.359,54,130,.415,30,36,.833,40,101,141,46,16,46,18,77,180,2002/2003
"Sesay,Ansu",41,107,.383,0,0,,41,107,.383,12,21,.571,34,39,73,23,14,25,5,62,94,2002/2003
"Shaw,Brian",101,261,.387,38,109,.349,63,152,.414,10,15,.667,20,99,119,103,32,54,13,62,250,2002/2003
"Shirley,Paul",0,4,.000,0,0,,0,4,.000,0,0,,0,1,1,0,0,0,0,0,0,2002/2003
"Simmons,Bobby",44,112,.393,0,5,.000,44,107,.411,32,35,.914,33,44,77,20,10,8,3,51,120,2002/2003
"Skinner,Brian",182,331,.550,0,0,,182,331,.550,97,161,.602,136,230,366,19,47,62,53,176,461,2002/2003
"Slater,Reggie",27,50,.540,0,0,,27,50,.540,27,45,.600,18,13,31,4,6,9,1,31,81,2002/2003
"Slay,Tamar",39,103,.379,7,25,.280,32,78,.410,7,10,.700,8,23,31,14,14,20,3,31,92,2002/2003
"Smith,Charles",1,4,.250,0,1,.000,1,3,.333,3,4,.750,0,0,0,1,1,1,0,3,5,2002/2003
"Smith,Joe",151,328,.460,0,2,.000,151,326,.463,102,131,.779,111,159,270,38,14,43,55,171,404,2002/2003
"Smith,Steve",113,291,.388,39,118,.331,74,173,.428,95,114,.833,21,78,99,70,28,43,9,79,360,2002/2003
"Snow,Eric",361,799,.452,7,32,.219,354,767,.462,325,379,.858,71,230,301,544,133,194,11,235,1054,2002/2003
"Sprewell,Latrell",454,1127,.403,134,360,.372,320,767,.417,173,218,.794,45,240,285,332,102,172,22,134,1215,2002/2003
"Stackhouse,Jerry",491,1201,.409,71,245,.290,420,956,.439,455,518,.878,61,197,258,316,65,193,28,130,1508,2002/2003
"Stepania,Vladimir",185,427,.433,0,0,,185,427,.433,71,134,.530,211,343,554,24,45,69,40,169,441,2002/2003
"Stevenson,DeShawn",114,284,.401,4,12,.333,110,272,.404,47,68,.691,22,63,85,40,22,49,8,57,279,2002/2003
"Stewart,Michael",14,37,.378,0,0,,14,37,.378,8,12,.667,19,36,55,6,2,10,15,42,36,2002/2003
"Stockton,John",309,640,.483,29,80,.363,280,560,.500,237,287,.826,51,150,201,629,137,182,16,184,884,2002/2003
"Stojaković,Peja",497,1034,.481,155,406,.382,342,628,.545,231,264,.875,61,336,397,141,72,101,5,143,1380,2002/2003
"Stoudamire,Damon",156,415,.376,44,114,.386,112,301,.372,53,67,.791,40,115,155,204,39,82,6,67,409,2002/2003
"Stoudemire,Amar'e",392,830,.472,2,10,.200,390,820,.476,320,484,.661,250,471,721,78,62,189,87,269,1106,2002/2003
"Strickland,Erick",163,380,.429,62,160,.388,101,220,.459,70,87,.805,23,122,145,209,38,98,7,111,458,2002/2003
"Strickland,Mark",2,5,.400,0,0,,2,5,.400,0,0,,5,2,7,0,0,1,0,1,4,2002/2003
"Strickland,Rod",120,278,.432,1,11,.091,119,267,.446,79,107,.738,20,75,95,215,46,76,6,55,320,2002/2003
"Šundov,Bruno",14,56,.250,4,16,.250,10,40,.250,0,2,.000,8,20,28,7,6,9,3,24,32,2002/2003
"Sura,Bob",135,328,.412,28,85,.329,107,243,.440,103,148,.696,58,109,167,177,45,82,2,108,401,2002/2003
"Swift,Stromile",235,489,.481,0,2,.000,235,487,.483,177,245,.722,114,270,384,45,55,99,104,152,647,2002/2003
"Szczerbiak,Wally",351,729,.481,61,145,.421,290,584,.497,150,173,.867,53,188,241,136,44,87,22,123,913,2002/2003
"Taylor,Maurice",231,535,.432,0,2,.000,231,533,.433,100,138,.725,95,143,238,66,22,100,22,151,562,2002/2003
"Terry,Jason",488,1141,.428,160,431,.371,328,710,.462,259,292,.887,37,242,279,600,126,249,14,175,1395,2002/2003
"Thomas,Etan",61,124,.492,0,0,,61,124,.492,60,94,.638,70,95,165,3,8,33,23,66,182,2002/2003
"Thomas,Kenny",260,559,.465,0,0,,260,559,.465,147,197,.746,185,344,529,112,62,116,28,169,667,2002/2003
"Thomas,Kenny",82,190,.432,0,0,,82,190,.432,33,45,.733,45,92,137,39,16,40,6,49,197,2002/2003
"Thomas,Kenny",178,369,.482,0,0,,178,369,.482,114,152,.750,140,252,392,73,46,76,22,120,470,2002/2003
"Thomas,Kurt",497,1028,.483,2,3,.667,495,1025,.483,138,184,.750,160,477,637,162,81,138,97,344,1134,2002/2003
"Thomas,Tim",412,930,.443,97,265,.366,315,665,.474,145,186,.780,97,292,389,102,70,133,49,257,1066,2002/2003
"Tinsley,Jamaal",220,556,.396,46,166,.277,174,390,.446,80,112,.714,58,202,260,548,125,192,18,201,566,2002/2003
"Torres,Óscar",16,36,.444,7,13,.538,9,23,.391,14,20,.700,3,9,12,3,4,8,2,9,53,2002/2003
"Traylor,Robert",105,237,.443,1,3,.333,104,234,.444,57,88,.648,108,154,262,50,45,53,37,153,268,2002/2003
"Trent,Gary",208,389,.535,0,2,.000,208,387,.537,60,101,.594,106,185,291,77,32,59,23,142,476,2002/2003
"Trepagnier,Jeff",17,40,.425,4,8,.500,13,32,.406,7,7,1.000,8,8,16,6,8,8,0,5,45,2002/2003
"Trybański,Cezary",5,20,.250,0,0,,5,20,.250,4,10,.400,6,8,14,1,0,8,6,13,14,2002/2003
"Tsakalidis,Jake",61,135,.452,0,0,,61,135,.452,39,58,.672,45,77,122,13,6,26,17,80,161,2002/2003
"Tskitishvili,Nikoloz",115,393,.293,37,152,.243,78,241,.324,48,65,.738,64,117,181,91,31,84,29,136,315,2002/2003
"Türkoğlu,Hedo",165,391,.422,29,78,.372,136,313,.435,88,110,.800,35,153,188,87,25,50,12,125,447,2002/2003
"Van Exel,Nick",342,831,.412,118,312,.378,224,519,.432,110,144,.764,35,173,208,312,42,123,4,86,912,2002/2003
"Van Horn,Keith",459,952,.482,65,176,.369,394,776,.508,193,240,.804,159,365,524,93,63,150,30,251,1176,2002/2003
"Vaughn,Jacque",184,411,.448,8,34,.235,176,377,.467,97,125,.776,26,92,118,232,64,97,2,169,473,2002/2003
"Voskuhl,Jake",92,163,.564,0,0,,92,163,.564,64,96,.667,97,128,225,36,18,48,29,172,248,2002/2003
"Wagner,Dajuan",223,605,.369,55,174,.316,168,431,.390,128,160,.800,20,62,82,130,38,85,7,107,629,2002/2003
"Walker,Antoine",603,1554,.388,188,582,.323,415,972,.427,176,286,.615,99,464,563,373,116,260,31,221,1570,2002/2003
"Walker,Samaki",115,274,.420,0,1,.000,115,273,.421,66,101,.653,115,253,368,64,20,56,55,143,296,2002/2003
"Wallace,Ben",210,437,.481,1,6,.167,209,431,.485,85,189,.450,293,833,1126,120,104,88,230,179,506,2002/2003
"Wallace,Gerald",90,183,.492,1,4,.250,89,179,.497,39,74,.527,38,90,128,23,24,44,15,68,220,2002/2003
"Wallace,Rasheed",515,1094,.471,110,307,.358,405,787,.515,200,272,.735,113,435,548,153,70,140,77,223,1340,2002/2003
"Ward,Charlie",165,414,.399,101,267,.378,64,147,.435,41,53,.774,25,152,177,306,78,95,11,146,472,2002/2003
"Watson,Earl",170,391,.435,31,91,.341,139,300,.463,62,86,.721,46,118,164,225,89,88,14,138,433,2002/2003
"Weatherspoon,Clarence",186,414,.449,0,0,,186,414,.449,149,194,.768,214,385,599,68,69,63,36,174,521,2002/2003
"Webber,Chris",661,1433,.461,5,21,.238,656,1412,.465,215,354,.607,160,544,704,364,106,215,88,204,1542,2002/2003
"Wells,Bonzi",437,990,.441,38,130,.292,399,860,.464,226,313,.722,98,296,394,246,123,215,18,220,1138,2002/2003
"Welsch,Jiří",19,75,.253,1,4,.250,18,71,.254,22,29,.759,12,16,28,27,8,19,2,32,61,2002/2003
"Wesley,David",449,1037,.433,134,316,.424,315,721,.437,185,237,.781,38,137,175,251,109,132,9,173,1217,2002/2003
"White,Jahidi",25,53,.472,0,0,,25,53,.472,17,25,.680,37,36,73,2,1,9,12,33,67,2002/2003
"White,Rodney",260,638,.408,32,134,.239,228,504,.452,98,125,.784,43,170,213,121,45,156,32,134,650,2002/2003
"Whitney,Chris",124,349,.355,50,164,.305,74,185,.400,57,69,.826,3,64,67,145,29,71,2,92,355,2002/2003
"Whitney,Chris",94,261,.360,43,128,.336,51,133,.383,46,57,.807,1,45,46,124,17,55,1,77,277,2002/2003
"Whitney,Chris",30,88,.341,7,36,.194,23,52,.442,11,12,.917,2,19,21,21,12,16,1,15,78,2002/2003
"Wilcox,Chris",73,140,.521,0,0,,73,140,.521,25,50,.500,32,72,104,21,7,26,12,65,171,2002/2003
"Wilks,Mike",50,148,.338,10,35,.286,40,113,.354,37,47,.787,20,51,71,92,27,28,4,69,147,2002/2003
"Wilks,Mike",29,81,.358,6,17,.353,23,64,.359,21,29,.724,9,32,41,42,16,16,1,38,85,2002/2003
"Wilks,Mike",21,67,.313,4,18,.222,17,49,.347,16,18,.889,11,19,30,50,11,12,3,31,62,2002/2003
"Williams,Aaron",199,439,.453,0,1,.000,199,438,.454,102,130,.785,137,194,331,88,27,85,57,206,500,2002/2003
"Williams,Alvin",396,905,.438,48,146,.329,348,759,.458,187,239,.782,55,190,245,416,111,128,21,170,1027,2002/2003
"Williams,Brandon",1,7,.143,0,1,.000,1,6,.167,0,0,,2,0,2,0,2,3,0,4,2,2002/2003
"Williams,Eric",254,575,.442,37,110,.336,217,465,.467,201,268,.750,143,239,382,140,86,97,19,234,746,2002/2003
"Williams,Frank",9,33,.273,6,16,.375,3,17,.176,4,6,.667,3,15,18,34,7,17,2,20,28,2002/2003
"Williams,Jason",333,859,.388,143,404,.354,190,455,.418,110,131,.840,25,187,212,631,91,168,10,130,919,2002/2003
"Williams,Jay",273,685,.399,65,202,.322,208,483,.431,103,161,.640,27,168,195,350,86,171,17,179,714,2002/2003
"Williams,Jerome",267,535,.499,1,6,.167,266,529,.503,156,281,.555,231,419,650,95,116,98,26,197,691,2002/2003
"Williams,Monty",34,80,.425,0,2,.000,34,78,.436,24,32,.750,12,33,45,26,12,17,5,33,92,2002/2003
"Williams,Scott",120,292,.411,0,2,.000,120,290,.414,33,42,.786,72,121,193,22,27,32,21,159,273,2002/2003
"Williams,Shammond",228,579,.394,93,261,.356,135,318,.425,78,102,.765,24,147,171,266,77,114,6,140,627,2002/2003
"Williams,Shammond",134,338,.396,56,159,.352,78,179,.436,48,57,.842,12,98,110,128,61,61,3,84,372,2002/2003
"Williams,Shammond",94,241,.390,37,102,.363,57,139,.410,30,45,.667,12,49,61,138,16,53,3,56,255,2002/2003
"Williams,Walt",134,341,.393,64,171,.374,70,170,.412,31,50,.620,53,154,207,59,42,35,26,141,363,2002/2003
"Williamson,Corliss",374,826,.453,2,11,.182,372,815,.456,237,300,.790,147,211,358,104,44,126,27,238,987,2002/2003
"Willis,Kevin",123,257,.479,0,2,.000,123,255,.482,51,83,.614,83,143,226,24,20,60,20,120,297,2002/2003
"Wolkowyski,Rubén",2,4,.500,0,1,.000,2,3,.667,1,4,.250,0,1,1,1,0,1,0,3,5,2002/2003
"Woods,Loren",29,76,.382,1,3,.333,28,73,.384,21,27,.778,27,68,95,19,10,23,13,37,80,2002/2003
"Woods,Qyntel",59,118,.500,3,9,.333,56,109,.514,7,20,.350,15,38,53,12,15,23,1,36,128,2002/2003
"World Peace,Metta",362,846,.428,71,211,.336,291,635,.458,273,371,.736,101,261,362,198,159,145,50,242,1068,2002/2003
"Wright,Lorenzen",325,716,.454,0,5,.000,325,711,.457,147,223,.659,170,358,528,80,51,110,54,209,797,2002/2003
"Yarbrough,Vincent",168,428,.393,21,78,.269,147,350,.420,49,62,.790,36,126,162,130,57,81,33,145,406,2002/2003
"Zhizhi,Wang",62,162,.383,16,47,.340,46,115,.400,42,58,.724,26,51,77,10,8,31,10,41,182,2002/2003
"Abdur-Rahim,Shareef",501,1054,.475,9,34,.265,492,1020,.482,373,429,.869,189,450,639,174,68,184,37,222,1384,2003/2004
"Abdur-Rahim,Shareef",383,790,.485,5,23,.217,378,767,.493,294,334,.880,141,354,495,127,44,131,19,147,1065,2003/2004
"Abdur-Rahim,Shareef",118,264,.447,4,11,.364,114,253,.451,79,95,.832,48,96,144,47,24,53,18,75,319,2003/2004
"Allen,Malik",83,198,.419,0,0,,83,198,.419,25,33,.758,42,77,119,16,12,27,28,81,191,2003/2004
"Allen,Ray",447,1017,.440,148,378,.392,299,639,.468,245,271,.904,69,217,286,268,71,156,11,132,1287,2003/2004
"Alston,Rafer",287,764,.376,161,434,.371,126,330,.382,103,134,.769,26,200,226,372,114,128,18,212,838,2003/2004
"Andersen,Chris",90,203,.443,0,1,.000,90,202,.446,63,107,.589,89,209,298,35,34,48,114,119,243,2003/2004
"Anderson,Derek",230,612,.376,79,259,.305,151,353,.428,155,188,.824,26,156,182,228,66,90,3,79,694,2003/2004
"Anderson,Kenny",113,256,.441,1,4,.250,112,252,.444,35,48,.729,19,62,81,125,26,50,5,73,262,2003/2004
"Anderson,Shandon",238,564,.422,36,128,.281,202,436,.463,123,161,.764,53,169,222,122,68,118,17,182,635,2003/2004
"Anthony,Carmelo",624,1465,.426,69,214,.322,555,1251,.444,408,525,.777,183,315,498,227,97,247,41,225,1725,2003/2004
"Archibald,Robert",9,33,.273,0,0,,9,33,.273,14,31,.452,21,31,52,13,14,10,3,50,32,2003/2004
"Archibald,Robert",0,1,.000,0,0,,0,1,.000,1,2,.500,0,1,1,1,0,1,0,1,1,2003/2004
"Archibald,Robert",1,2,.500,0,0,,1,2,.500,0,2,.000,0,1,1,0,1,0,0,0,2,2003/2004
"Archibald,Robert",8,30,.267,0,0,,8,30,.267,13,27,.481,21,29,50,12,13,9,3,49,29,2003/2004
"Arenas,Gilbert",358,914,.392,125,333,.375,233,581,.401,237,317,.748,55,199,254,275,103,226,12,176,1078,2003/2004
"Armstrong,Brandon",65,175,.371,19,52,.365,46,123,.374,2,4,.500,12,31,43,14,12,24,2,49,151,2003/2004
"Armstrong,Darrell",291,736,.395,135,429,.315,156,307,.508,123,144,.854,63,163,226,311,133,155,16,148,840,2003/2004
"Arroyo,Carlos",339,768,.441,38,117,.325,301,651,.462,181,225,.804,41,144,185,355,63,156,5,165,897,2003/2004
"Atkins,Chucky",192,484,.397,81,241,.336,111,243,.457,73,97,.753,9,84,93,223,45,92,2,102,538,2003/2004
"Atkins,Chucky",88,235,.374,42,130,.323,46,105,.438,31,43,.721,6,42,48,95,19,48,1,60,249,2003/2004
"Atkins,Chucky",104,249,.418,39,111,.351,65,138,.471,42,54,.778,3,42,45,128,26,44,1,42,289,2003/2004
"Augmon,Stacey",143,347,.412,1,7,.143,142,340,.418,110,139,.791,52,122,174,85,55,76,15,114,397,2003/2004
"Baker,Vin",208,432,.481,1,3,.333,207,429,.483,114,157,.726,112,168,280,66,29,77,32,160,531,2003/2004
"Baker,Vin",168,333,.505,0,1,.000,168,332,.506,82,112,.732,76,134,210,54,22,52,23,98,418,2003/2004
"Baker,Vin",40,99,.404,1,2,.500,39,97,.402,32,45,.711,36,34,70,12,7,25,9,62,113,2003/2004
"Banks,Marcus",177,442,.400,27,86,.314,150,356,.421,99,131,.756,30,103,133,175,88,125,13,171,480,2003/2004
"Barbosa,Leandro",210,470,.447,83,210,.395,127,260,.488,47,61,.770,23,100,123,165,93,120,7,184,550,2003/2004
"Barnes,Matt",63,138,.457,2,13,.154,61,125,.488,43,61,.705,53,98,151,48,27,44,3,76,171,2003/2004
"Barros,Dana",2,3,.667,0,0,,2,3,.667,2,2,1.000,0,0,0,0,0,0,0,2,6,2003/2004
"Barry,Brent",215,427,.504,114,252,.452,101,175,.577,91,110,.827,21,183,204,342,85,139,16,121,635,2003/2004
"Barry,Jon",120,297,.404,51,138,.370,69,159,.434,60,71,.845,25,98,123,147,57,53,8,66,351,2003/2004
"Bateer,Mengke",4,7,.571,0,0,,4,7,.571,0,0,,5,3,8,1,1,2,0,10,8,2003/2004
"Battie,Tony",170,384,.443,2,9,.222,168,375,.448,66,89,.742,118,241,359,58,26,63,67,159,408,2003/2004
"Battie,Tony",56,117,.479,1,1,1.000,55,116,.474,23,33,.697,39,79,118,21,8,24,20,55,136,2003/2004
"Battie,Tony",114,267,.427,1,8,.125,113,259,.436,43,56,.768,79,162,241,37,18,39,47,104,272,2003/2004
"Battier,Shane",242,543,.446,65,186,.349,177,357,.496,120,164,.732,102,201,303,101,101,56,58,187,669,2003/2004
"Baxter,Lonny",103,209,.493,1,3,.333,102,206,.495,44,76,.579,64,123,187,20,17,38,29,123,251,2003/2004
"Baxter,Lonny",27,49,.551,1,1,1.000,26,48,.542,5,8,.625,11,24,35,5,1,11,6,31,60,2003/2004
"Baxter,Lonny",60,128,.469,0,1,.000,60,127,.472,30,56,.536,42,79,121,10,14,22,18,69,150,2003/2004
"Baxter,Lonny",16,32,.500,0,1,.000,16,31,.516,9,12,.750,11,20,31,5,2,5,5,23,41,2003/2004
"Beasley,Jerome",1,3,.333,0,0,,1,3,.333,0,0,,0,1,1,0,0,0,0,0,2,2003/2004
"Bell,Raja",329,805,.409,62,166,.373,267,639,.418,195,248,.786,60,181,241,107,63,111,13,262,915,2003/2004
"Bell,Troy",4,18,.222,0,4,.000,4,14,.286,3,3,1.000,3,1,4,4,1,6,0,6,11,2003/2004
"Bender,Jonathan",50,106,.472,9,22,.409,41,84,.488,39,47,.830,9,31,40,9,5,33,11,23,148,2003/2004
"Best,Travis",64,172,.372,3,20,.150,61,152,.401,40,46,.870,17,51,68,112,31,33,4,66,171,2003/2004
"Bibby,Mike",527,1170,.450,148,378,.392,379,792,.479,304,373,.815,67,210,277,444,112,175,18,146,1506,2003/2004
"Billups,Chauncey",392,996,.394,130,335,.388,262,661,.396,404,460,.878,35,241,276,446,84,189,8,177,1318,2003/2004
"Blake,Steve",157,407,.386,75,202,.371,82,205,.400,55,67,.821,18,99,117,209,57,128,7,100,444,2003/2004
"Blount,Corie",115,253,.455,0,3,.000,115,250,.460,15,27,.556,98,177,275,55,49,43,24,135,245,2003/2004
"Blount,Corie",97,206,.471,0,3,.000,97,203,.478,13,24,.542,76,130,206,45,38,35,19,86,207,2003/2004
"Blount,Corie",18,47,.383,0,0,,18,47,.383,2,3,.667,22,47,69,10,11,8,5,49,38,2003/2004
"Blount,Mark",342,604,.566,0,0,,342,604,.566,159,221,.719,207,382,589,75,80,150,106,253,843,2003/2004
"Bogans,Keith",183,454,.403,67,187,.358,116,267,.434,65,103,.631,106,211,317,98,46,75,10,128,498,2003/2004
"Booth,Calvin",135,290,.466,0,2,.000,135,288,.469,75,94,.798,86,194,280,28,17,45,101,150,345,2003/2004
"Boozer,Carlos",471,900,.523,1,6,.167,470,894,.526,219,285,.768,230,627,857,148,74,134,55,199,1162,2003/2004
"Borchardt,Curtis",22,56,.393,0,1,.000,22,55,.400,14,18,.778,13,41,54,15,4,18,14,40,58,2003/2004
"Bosh,Chris",327,712,.459,5,14,.357,322,698,.461,202,288,.701,191,366,557,78,59,107,106,215,861,2003/2004
"Boumtje-Boumtje,Ruben",1,5,.200,0,0,,1,5,.200,2,2,1.000,0,1,1,1,0,0,1,2,4,2003/2004
"Bowen,Bruce",211,502,.420,77,212,.363,134,290,.462,66,114,.579,45,208,253,113,84,90,33,166,565,2003/2004
"Bowen,Ryan",18,53,.340,0,0,,18,53,.340,10,12,.833,39,48,87,18,18,6,16,47,46,2003/2004
"Boykins,Earl",321,766,.419,55,171,.322,266,595,.447,142,162,.877,42,101,143,295,51,100,3,84,839,2003/2004
"Bradley,Michael",7,15,.467,0,0,,7,15,.467,1,2,.500,6,17,23,1,3,7,0,14,15,2003/2004
"Bradley,Michael",1,3,.333,0,0,,1,3,.333,1,2,.500,1,10,11,1,1,3,0,6,3,2003/2004
"Bradley,Michael",6,12,.500,0,0,,6,12,.500,0,0,,5,7,12,0,2,4,0,8,12,2003/2004
"Bradley,Shawn",89,188,.473,0,1,.000,89,187,.476,41,49,.837,72,101,173,20,33,17,74,130,219,2003/2004
"Braggs,Torraye",16,33,.485,0,0,,16,33,.485,8,12,.667,18,21,39,7,4,13,2,29,40,2003/2004
"Braggs,Torraye",13,28,.464,0,0,,13,28,.464,8,12,.667,15,19,34,6,4,12,2,21,34,2003/2004
"Braggs,Torraye",3,5,.600,0,0,,3,5,.600,0,0,,3,2,5,1,0,1,0,8,6,2003/2004
"Brand,Elton",484,982,.493,0,1,.000,484,981,.493,411,532,.773,269,445,714,227,64,193,154,229,1379,2003/2004
"Bremer,J.R.",43,158,.272,19,74,.257,24,84,.286,13,20,.650,9,27,36,51,18,24,4,32,118,2003/2004
"Bremer,J.R.",39,137,.285,19,66,.288,20,71,.282,13,20,.650,7,26,33,39,18,19,4,27,110,2003/2004
"Bremer,J.R.",4,21,.190,0,8,.000,4,13,.308,0,0,,2,1,3,12,0,5,0,5,8,2003/2004
"Brewer,Jamison",13,35,.371,5,14,.357,8,21,.381,1,6,.167,2,9,11,17,7,10,0,9,32,2003/2004
"Brezec,Primož",12,26,.462,0,0,,12,26,.462,4,6,.667,5,10,15,3,0,6,3,13,28,2003/2004
"Brown,Damone",1,10,.100,0,0,,1,10,.100,1,2,.500,3,2,5,0,2,1,0,2,3,2003/2004
"Brown,Devin",85,196,.434,4,14,.286,81,182,.445,60,74,.811,38,92,130,33,15,38,4,61,234,2003/2004
"Brown,Kedrick",117,254,.461,38,99,.384,79,155,.510,17,27,.630,41,105,146,64,30,29,7,80,289,2003/2004
"Brown,Kedrick",45,99,.455,12,32,.375,33,67,.493,8,13,.615,18,50,68,25,17,12,2,38,110,2003/2004
"Brown,Kedrick",72,155,.465,26,67,.388,46,88,.523,9,14,.643,23,55,78,39,13,17,5,42,179,2003/2004
"Brown,Kwame",288,589,.489,1,2,.500,287,587,.489,228,334,.683,178,372,550,112,66,140,52,144,805,2003/2004
"Brown,P.J.",339,712,.476,0,1,.000,339,711,.477,158,185,.854,237,453,690,155,78,101,73,203,836,2003/2004
"Brown,Tierre",2,4,.500,0,0,,2,4,.500,2,4,.500,0,1,1,2,0,7,0,1,6,2003/2004
"Brunson,Rick",40,105,.381,11,23,.478,29,82,.354,27,31,.871,9,28,37,82,25,33,3,44,118,2003/2004
"Brunson,Rick",2,4,.500,0,0,,2,4,.500,0,0,,0,0,0,2,0,0,0,0,4,2003/2004
"Brunson,Rick",38,101,.376,11,23,.478,27,78,.346,27,31,.871,9,28,37,80,25,33,3,44,114,2003/2004
"Bryant,Kobe",516,1178,.438,71,217,.327,445,961,.463,454,533,.852,103,256,359,330,112,171,28,176,1557,2003/2004
"Buckner,Greg",66,175,.377,12,44,.273,54,131,.412,20,27,.741,28,75,103,45,21,34,4,77,164,2003/2004
"Buford,Rodney",19,56,.339,0,2,.000,19,54,.352,3,6,.500,6,9,15,7,6,4,1,9,41,2003/2004
"Butler,Caron",240,631,.380,10,42,.238,230,589,.390,133,176,.756,92,234,326,126,75,91,13,162,623,2003/2004
"Butler,Mitchell",54,124,.435,11,30,.367,43,94,.457,15,24,.625,24,47,71,32,22,24,4,54,134,2003/2004
"Butler,Rasual",119,250,.476,50,108,.463,69,142,.486,16,21,.762,4,57,61,23,10,28,13,72,304,2003/2004
"Čabarkapa,Žarko",81,197,.411,6,32,.188,75,165,.455,35,53,.660,26,73,99,40,10,54,13,75,203,2003/2004
"Camby,Marcus",262,549,.477,0,2,.000,262,547,.479,98,136,.721,211,516,727,132,86,98,187,239,622,2003/2004
"Campbell,Elden",138,314,.439,0,0,,138,314,.439,85,124,.685,52,157,209,45,21,63,50,137,361,2003/2004
"Cardinal,Brian",220,466,.472,55,124,.444,165,342,.482,238,271,.878,100,217,317,103,66,84,20,206,733,2003/2004
"Carroll,Matt",7,16,.438,1,3,.333,6,13,.462,4,6,.667,1,5,6,2,1,6,0,8,19,2003/2004
"Carroll,Matt",5,11,.455,1,3,.333,4,8,.500,2,2,1.000,0,3,3,1,0,2,0,3,13,2003/2004
"Carroll,Matt",2,5,.400,0,0,,2,5,.400,2,4,.500,1,2,3,1,1,4,0,5,6,2003/2004
"Carter,Anthony",11,37,.297,0,3,.000,11,34,.324,0,0,,2,9,11,12,4,12,0,9,22,2003/2004
"Carter,Maurice",11,35,.314,4,11,.364,7,24,.292,16,20,.800,2,9,11,4,0,9,0,10,42,2003/2004
"Carter,Maurice",5,14,.357,1,3,.333,4,11,.364,11,12,.917,0,3,3,2,0,6,0,5,22,2003/2004
"Carter,Maurice",6,21,.286,3,8,.375,3,13,.231,5,8,.625,2,6,8,2,0,3,0,5,20,2003/2004
"Carter,Vince",608,1457,.417,93,243,.383,515,1214,.424,336,417,.806,95,254,349,348,88,223,65,212,1645,2003/2004
"Cassell,Sam",620,1270,.488,74,186,.398,546,1084,.504,289,331,.873,44,227,271,592,102,220,18,247,1603,2003/2004
"Cato,Kelvin",161,360,.447,0,0,,161,360,.447,96,142,.676,153,319,472,72,52,84,96,203,418,2003/2004
"Chandler,Tyson",67,158,.424,0,1,.000,67,157,.427,79,118,.669,82,188,270,23,17,38,43,87,213,2003/2004
"Cheaney,Calbert",278,578,.481,0,10,.000,278,568,.489,47,77,.610,77,183,260,136,60,85,12,184,603,2003/2004
"Christie,Doug",317,688,.461,49,142,.345,268,546,.491,148,172,.860,69,260,329,347,151,155,41,186,831,2003/2004
"Clark,Keon",2,6,.333,0,0,,2,6,.333,0,0,,1,6,7,1,1,0,0,1,4,2003/2004
"Claxton,Speedy",224,524,.427,4,22,.182,220,502,.438,182,224,.813,38,118,156,267,97,102,9,146,634,2003/2004
"Cleaves,Mateen",7,23,.304,0,1,.000,7,22,.318,1,2,.500,1,6,7,19,4,5,2,13,15,2003/2004
"Coleman,Derrick",107,259,.413,8,36,.222,99,223,.444,49,65,.754,45,147,192,46,23,57,26,79,271,2003/2004
"Coles,Bimbo",12,34,.353,0,0,,12,34,.353,4,6,.667,2,8,10,15,3,9,0,27,28,2003/2004
"Collier,Jason",79,165,.479,1,4,.250,78,161,.484,67,85,.788,36,75,111,17,11,31,11,71,226,2003/2004
"Collins,Jarron",147,295,.498,0,1,.000,147,294,.500,188,262,.718,117,199,316,77,26,79,18,255,482,2003/2004
"Collins,Jason",163,384,.424,0,2,.000,163,382,.427,136,184,.739,143,257,400,153,67,97,56,251,462,2003/2004
"Cook,Brian",67,141,.475,0,5,.000,67,136,.493,21,28,.750,31,70,101,20,16,17,16,64,155,2003/2004
"Cook,Omar",7,27,.259,0,1,.000,7,26,.269,0,0,,3,3,6,24,10,10,0,14,14,2003/2004
"Crawford,Chris",211,471,.448,44,113,.389,167,358,.466,103,119,.866,58,117,175,45,37,55,20,131,569,2003/2004
"Crawford,Jamal",509,1318,.386,165,521,.317,344,797,.432,200,240,.833,46,237,283,405,111,193,29,161,1383,2003/2004
"Croshere,Austin",119,307,.388,56,144,.389,63,163,.387,93,104,.894,60,183,243,52,24,55,14,101,387,2003/2004
"Curry,Eddy",417,840,.496,1,1,1.000,416,839,.496,235,350,.671,143,308,451,68,24,177,83,258,1070,2003/2004
"Curry,Michael",76,196,.388,3,15,.200,73,181,.403,49,58,.845,22,65,87,53,23,48,5,153,204,2003/2004
"Dalembert,Samuel",270,499,.541,0,1,.000,270,498,.542,112,174,.644,194,432,626,21,44,86,189,273,652,2003/2004
"Dampier,Erick",348,650,.535,0,2,.000,348,648,.537,217,332,.654,344,543,887,60,33,131,137,227,913,2003/2004
"Daniels,Antonio",187,398,.470,42,116,.362,145,282,.514,155,184,.842,23,119,142,298,45,61,6,64,571,2003/2004
"Daniels,Marquis",203,411,.494,11,36,.306,192,375,.512,60,78,.769,66,80,146,116,53,44,12,51,477,2003/2004
"Davis,Antonio",266,660,.403,0,0,,266,660,.403,176,230,.765,207,464,671,137,37,114,65,206,708,2003/2004
"Davis,Antonio",46,120,.383,0,0,,46,120,.383,37,49,.755,49,94,143,14,8,21,8,45,129,2003/2004
"Davis,Antonio",220,540,.407,0,0,,220,540,.407,139,181,.768,158,370,528,123,29,93,57,161,579,2003/2004
"Davis,Baron",554,1402,.395,187,582,.321,367,820,.448,237,352,.673,66,221,287,501,158,215,27,178,1532,2003/2004
"Davis,Dale",133,281,.473,0,0,,133,281,.473,65,106,.613,158,240,398,72,43,40,62,154,331,2003/2004
"Davis,Hubert",1,11,.091,0,1,.000,1,10,.100,2,2,1.000,2,6,8,4,2,3,0,12,4,2003/2004
"Davis,Hubert",0,2,.000,0,1,.000,0,1,.000,0,0,,0,0,0,1,0,1,0,4,0,2003/2004
"Davis,Hubert",1,9,.111,0,0,,1,9,.111,2,2,1.000,2,6,8,3,2,2,0,8,4,2003/2004
"Davis,Josh",2,5,.400,0,2,.000,2,3,.667,1,1,1.000,1,4,5,0,0,2,0,3,5,2003/2004
"Davis,Ricky",446,950,.469,52,140,.371,394,810,.486,196,273,.718,77,281,358,259,96,189,22,171,1140,2003/2004
"Davis,Ricky",134,311,.431,17,48,.354,117,263,.445,51,75,.680,18,103,121,111,25,68,8,51,336,2003/2004
"Davis,Ricky",312,639,.488,35,92,.380,277,547,.506,145,198,.732,59,178,237,148,71,121,14,120,804,2003/2004
"DeClercq,Andrew",93,195,.477,0,0,,93,195,.477,44,54,.815,131,186,317,44,47,54,32,217,230,2003/2004
"Delk,Tony",70,184,.380,20,66,.303,50,118,.424,37,44,.841,16,43,59,28,27,17,7,46,197,2003/2004
"Dial,Derrick",9,28,.321,2,9,.222,7,19,.368,6,8,.750,5,8,13,2,6,1,0,6,26,2003/2004
"Diaw,Boris",140,313,.447,6,26,.231,134,287,.467,56,93,.602,111,231,342,182,59,126,37,191,342,2003/2004
"Dickau,Dan",37,98,.378,10,30,.333,27,68,.397,11,14,.786,7,19,26,38,17,26,0,44,95,2003/2004
"Dickau,Dan",21,49,.429,3,10,.300,18,39,.462,4,6,.667,4,12,16,18,9,13,0,22,49,2003/2004
"Dickau,Dan",16,49,.327,7,20,.350,9,29,.310,7,8,.875,3,7,10,20,8,13,0,22,46,2003/2004
"Dickens,Kaniel",3,3,1.000,0,0,,3,3,1.000,1,2,.500,2,0,2,0,0,1,0,3,7,2003/2004
"Diop,DeSagana",57,147,.388,0,0,,57,147,.388,12,20,.600,72,127,199,34,26,29,51,116,126,2003/2004
"Divac,Vlade",314,668,.470,2,13,.154,312,655,.476,170,260,.654,136,327,463,432,57,173,77,222,800,2003/2004
"Dixon,Juan",247,637,.388,59,198,.298,188,439,.428,111,139,.799,30,118,148,137,82,104,4,111,664,2003/2004
"Doleac,Michael",140,322,.435,0,0,,140,322,.435,45,52,.865,88,177,265,44,23,48,36,142,325,2003/2004
"Doleac,Michael",100,225,.444,0,0,,100,225,.444,31,36,.861,60,129,189,30,17,37,30,84,231,2003/2004
"Doleac,Michael",40,97,.412,0,0,,40,97,.412,14,16,.875,28,48,76,14,6,11,6,58,94,2003/2004
"Dooling,Keyon",137,352,.389,8,46,.174,129,306,.422,78,94,.830,17,62,79,130,45,65,6,108,360,2003/2004
"Drew,Bryce",4,18,.222,1,7,.143,3,11,.273,3,3,1.000,0,6,6,13,4,8,0,1,12,2003/2004
"Drobnjak,Predrag",149,379,.393,11,36,.306,138,343,.402,73,86,.849,54,142,196,39,22,48,24,85,382,2003/2004
"Duncan,Tim",592,1181,.501,2,12,.167,590,1169,.505,352,588,.599,227,632,859,213,62,183,185,164,1538,2003/2004
"Dunleavy,Mike",323,720,.449,94,254,.370,229,466,.491,137,185,.741,87,355,442,220,68,143,13,169,877,2003/2004
"Dupree,Ronald",111,282,.394,4,9,.444,107,273,.392,66,105,.629,55,112,167,55,32,51,18,134,292,2003/2004
"Ebi,Ndudi",6,14,.429,0,0,,6,14,.429,1,4,.250,2,1,3,3,0,3,4,6,13,2003/2004
"Eisley,Howard",166,451,.368,52,163,.319,114,288,.396,76,89,.854,20,109,129,273,56,98,5,137,460,2003/2004
"Eisley,Howard",80,202,.396,28,85,.329,52,117,.444,32,36,.889,7,59,66,156,30,50,3,85,220,2003/2004
"Eisley,Howard",86,249,.345,24,78,.308,62,171,.363,44,53,.830,13,50,63,117,26,48,2,52,240,2003/2004
"Elson,Francisco",94,199,.472,0,1,.000,94,198,.475,30,45,.667,65,138,203,32,35,35,39,145,218,2003/2004
"Ely,Melvin",66,153,.431,0,1,.000,66,152,.434,25,42,.595,48,53,101,22,9,20,17,68,157,2003/2004
"Evans,Reggie",67,165,.406,0,3,.000,67,162,.414,83,148,.561,156,252,408,33,54,65,10,176,217,2003/2004
"Ferguson,Desmond",5,12,.417,3,8,.375,2,4,.500,0,2,.000,0,4,4,1,0,1,0,0,13,2003/2004
"Finley,Michael",514,1159,.443,150,370,.405,364,789,.461,164,193,.850,78,247,325,212,84,83,39,118,1342,2003/2004
"Fisher,Derek",203,576,.352,52,179,.291,151,397,.380,122,153,.797,30,122,152,187,103,79,4,115,580,2003/2004
"Fizer,Marcus",134,350,.383,2,17,.118,132,333,.396,90,120,.750,61,141,202,43,16,51,8,97,360,2003/2004
"Ford,Alton",6,11,.545,0,0,,6,11,.545,3,6,.500,3,8,11,3,0,3,1,9,15,2003/2004
"Ford,T.J.",153,398,.384,5,21,.238,148,377,.393,80,98,.816,37,140,177,356,60,139,3,123,391,2003/2004
"Fortson,Danny",71,139,.511,0,0,,71,139,.511,75,92,.815,114,136,250,9,12,37,11,148,217,2003/2004
"Foster,Jeff",197,362,.544,0,4,.000,197,358,.550,103,154,.669,248,362,610,64,71,60,27,189,497,2003/2004
"Fowlkes,Tremaine",15,48,.313,1,8,.125,14,40,.350,13,18,.722,18,35,53,14,9,12,3,37,44,2003/2004
"Fox,Rick",73,186,.392,15,61,.246,58,125,.464,22,30,.733,29,73,102,98,29,48,4,99,183,2003/2004
"Foyle,Adonal",59,130,.454,0,0,,59,130,.454,19,35,.543,54,113,167,17,6,21,46,68,137,2003/2004
"Frahm,Richie",63,139,.453,34,92,.370,29,47,.617,23,26,.885,12,44,56,24,16,7,4,50,183,2003/2004
"Francis,Steve",450,1117,.403,73,250,.292,377,867,.435,337,435,.775,116,317,433,493,139,294,35,257,1310,2003/2004
"Fuller,Hiram",3,8,.375,0,0,,3,8,.375,2,6,.333,4,7,11,2,0,4,1,5,8,2003/2004
"Gadzuric,Dan",183,349,.524,0,1,.000,183,348,.526,58,118,.492,126,220,346,28,51,45,105,186,424,2003/2004
"Gaines,Reece",25,86,.291,3,10,.300,22,76,.289,16,25,.640,8,31,39,40,11,18,2,22,69,2003/2004
"Garcia,Alex",1,7,.143,0,0,,1,7,.143,1,2,.500,0,0,0,0,2,1,0,0,3,2003/2004
"Garnett,Kevin",804,1611,.499,11,43,.256,793,1568,.506,368,465,.791,245,894,1139,409,120,212,178,202,1987,2003/2004
"Garrity,Pat",1,3,.333,0,0,,1,3,.333,0,0,,0,0,0,1,0,0,0,2,2,2003/2004
"Gasol,Pau",506,1049,.482,4,15,.267,502,1034,.485,365,511,.714,206,394,600,198,44,187,132,185,1381,2003/2004
"George,Devean",233,571,.408,65,186,.349,168,385,.436,73,96,.760,87,245,332,112,81,88,38,189,604,2003/2004
"Gill,Eddie",15,36,.417,3,8,.375,12,28,.429,17,20,.850,4,13,17,16,9,12,1,16,50,2003/2004
"Gill,Kendall",215,548,.392,9,38,.237,206,510,.404,100,136,.735,61,129,190,89,65,83,16,107,539,2003/2004
"Ginóbili,Manu",330,789,.418,88,245,.359,242,544,.445,239,298,.802,86,258,344,291,136,161,16,181,987,2003/2004
"Giriček,Gordan",316,724,.436,60,152,.395,256,572,.448,135,158,.854,51,175,226,122,56,103,15,144,827,2003/2004
"Giriček,Gordan",188,427,.440,46,113,.407,142,314,.452,67,81,.827,37,127,164,80,41,63,10,98,489,2003/2004
"Giriček,Gordan",128,297,.431,14,39,.359,114,258,.442,68,77,.883,14,48,62,42,15,40,5,46,338,2003/2004
"Glover,Dion",230,589,.390,40,119,.336,190,470,.404,120,156,.769,58,208,266,130,50,102,19,123,620,2003/2004
"Glover,Dion",205,524,.391,36,105,.343,169,419,.403,110,142,.775,54,183,237,115,40,83,17,106,556,2003/2004
"Glover,Dion",25,65,.385,4,14,.286,21,51,.412,10,14,.714,4,25,29,15,10,19,2,17,64,2003/2004
"Goldwire,Anthony",7,22,.318,2,8,.250,5,14,.357,1,1,1.000,1,6,7,11,5,3,0,5,17,2003/2004
"Goldwire,Anthony",5,14,.357,2,6,.333,3,8,.375,1,1,1.000,1,5,6,10,3,2,0,5,13,2003/2004
"Goldwire,Anthony",2,8,.250,0,2,.000,2,6,.333,0,0,,0,1,1,1,2,1,0,0,4,2003/2004
"Gooden,Drew",369,829,.445,9,42,.214,360,787,.457,167,262,.637,160,356,516,89,62,126,72,196,914,2003/2004
"Grant,Brian",289,613,.471,0,1,.000,289,612,.472,86,110,.782,174,350,524,69,51,82,35,254,664,2003/2004
"Grant,Horace",92,224,.411,0,1,.000,92,223,.413,39,54,.722,79,154,233,71,24,29,21,70,223,2003/2004
"Grant,Paul",11,23,.478,0,0,,11,23,.478,3,8,.375,7,10,17,3,1,7,1,17,25,2003/2004
"Green,Willie",143,357,.401,19,61,.311,124,296,.419,59,81,.728,16,49,65,53,26,59,5,83,364,2003/2004
"Griffin,Adrian",5,18,.278,1,2,.500,4,16,.250,0,4,.000,1,18,19,10,7,3,2,17,11,2003/2004
"Gugliotta,Tom",70,203,.345,1,4,.250,69,199,.347,20,28,.714,65,122,187,63,31,39,12,81,161,2003/2004
"Gugliotta,Tom",31,99,.313,0,1,.000,31,98,.316,6,8,.750,15,41,56,21,14,20,4,34,68,2003/2004
"Gugliotta,Tom",39,104,.375,1,3,.333,38,101,.376,14,20,.700,50,81,131,42,17,19,8,47,93,2003/2004
"Haislip,Marcus",36,74,.486,1,2,.500,35,72,.486,20,28,.714,21,32,53,4,6,9,12,25,93,2003/2004
"Ham,Darvin",37,75,.493,1,2,.500,36,73,.493,21,35,.600,47,46,93,16,13,31,8,63,96,2003/2004
"Hamilton,Richard",530,1166,.455,18,68,.265,512,1098,.466,297,342,.868,78,201,279,310,103,210,17,222,1375,2003/2004
"Hamilton,Zendon",51,95,.537,0,0,,51,95,.537,67,96,.698,49,97,146,13,8,27,8,74,169,2003/2004
"Handlogten,Ben",25,47,.532,0,0,,25,47,.532,18,27,.667,22,33,55,6,3,10,4,32,68,2003/2004
"Hansen,Travis",46,130,.354,9,30,.300,37,100,.370,22,27,.815,30,40,70,19,10,15,9,67,123,2003/2004
"Hardaway,Anfernee",279,679,.411,30,79,.380,249,600,.415,111,138,.804,69,218,287,176,70,107,20,146,699,2003/2004
"Hardaway,Anfernee",120,271,.443,14,35,.400,106,236,.449,42,49,.857,27,71,98,97,28,42,8,65,296,2003/2004
"Hardaway,Anfernee",159,408,.390,16,44,.364,143,364,.393,69,89,.775,42,147,189,79,42,65,12,81,403,2003/2004
"Harpring,Matt",193,410,.471,8,33,.242,185,377,.491,108,157,.688,91,156,247,63,22,65,2,102,502,2003/2004
"Harrington,Al",421,909,.463,21,77,.273,400,832,.481,185,252,.734,163,345,508,131,80,163,22,250,1048,2003/2004
"Harrington,Othella",100,202,.495,0,0,,100,202,.495,58,78,.744,58,119,177,29,12,65,14,134,258,2003/2004
"Harris,Lucious",187,463,.404,38,101,.376,149,362,.412,66,78,.846,39,101,140,135,41,53,2,74,478,2003/2004
"Hart,Jason",71,159,.447,2,9,.222,69,150,.460,33,43,.767,10,69,79,81,28,29,5,59,177,2003/2004
"Harvey,Donnell",89,201,.443,0,3,.000,89,198,.449,61,83,.735,48,116,164,21,24,45,27,129,239,2003/2004
"Harvey,Donnell",36,89,.404,0,3,.000,36,86,.419,26,39,.667,29,43,72,8,10,22,11,44,98,2003/2004
"Harvey,Donnell",53,112,.473,0,0,,53,112,.473,35,44,.795,19,73,92,13,14,23,16,85,141,2003/2004
"Haslem,Udonis",205,447,.459,0,3,.000,205,444,.462,140,183,.765,189,284,473,51,33,74,24,197,550,2003/2004
"Hassell,Trenton",177,381,.465,4,13,.308,173,368,.470,48,61,.787,68,189,257,133,36,46,54,200,406,2003/2004
"Hayes,Jarvis",278,695,.400,40,131,.305,238,564,.422,77,98,.786,71,193,264,106,71,110,11,157,673,2003/2004
"Haywood,Brendan",200,388,.515,0,1,.000,200,387,.517,137,234,.585,186,201,387,43,32,80,100,154,537,2003/2004
"Heal,Shane",7,24,.292,4,18,.222,3,6,.500,4,5,.800,1,3,4,5,1,5,0,2,22,2003/2004
"Henderson,Alan",10,21,.476,0,0,,10,21,.476,4,6,.667,11,10,21,2,1,3,2,1,24,2003/2004
"Hilário,Nenê",334,630,.530,0,2,.000,334,628,.532,240,352,.682,154,349,503,168,116,183,41,280,908,2003/2004
"Hill,Tyrone",3,5,.600,0,0,,3,5,.600,3,4,.750,5,3,8,0,0,2,1,10,9,2003/2004
"Hinrich,Kirk",318,823,.386,144,369,.390,174,454,.383,135,168,.804,42,217,259,517,101,204,21,276,915,2003/2004
"Hoiberg,Fred",178,383,.465,76,172,.442,102,211,.483,98,116,.845,21,247,268,109,66,44,10,136,530,2003/2004
"Horry,Robert",141,348,.405,41,108,.380,100,240,.417,69,107,.645,108,164,272,101,48,55,49,165,392,2003/2004
"House,Eddie",161,449,.359,51,136,.375,110,313,.351,36,45,.800,28,110,138,148,65,63,4,92,409,2003/2004
"Houston,Allan",340,781,.435,87,202,.431,253,579,.437,157,172,.913,20,101,121,99,38,102,2,105,924,2003/2004
"Howard,Josh",229,532,.430,20,66,.303,209,466,.448,97,138,.703,149,219,368,97,69,67,54,168,575,2003/2004
"Howard,Juwan",529,1169,.453,0,1,.000,529,1168,.453,318,393,.809,171,399,570,158,54,178,22,284,1376,2003/2004
"Hudson,Troy",80,207,.386,31,77,.403,49,130,.377,27,33,.818,4,31,35,70,7,34,0,32,218,2003/2004
"Hughes,Larry",401,1009,.397,79,232,.341,322,777,.414,267,335,.797,96,230,326,148,95,152,26,147,1148,2003/2004
"Humphrey,Ryan",1,4,.250,0,1,.000,1,3,.333,0,0,,2,1,3,1,1,2,0,3,2,2003/2004
"Hunter,Brandon",53,116,.457,0,3,.000,53,113,.469,19,43,.442,50,68,118,19,13,22,1,40,125,2003/2004
"Hunter,Lindsey",49,143,.343,14,50,.280,35,93,.376,5,8,.625,13,54,67,85,39,34,6,45,117,2003/2004
"Hunter,Steven",82,155,.529,0,0,,82,155,.529,23,69,.333,54,116,170,12,5,29,73,101,187,2003/2004
"Ilgauskas,Zydrunas",466,965,.483,2,7,.286,464,958,.484,303,406,.746,279,374,653,109,39,163,201,277,1237,2003/2004
"Iverson,Allen",435,1125,.387,57,199,.286,378,926,.408,339,455,.745,34,144,178,324,115,209,5,87,1266,2003/2004
"Jackson,Bobby",263,592,.444,81,219,.370,182,373,.488,82,109,.752,55,119,174,105,49,63,8,106,689,2003/2004
"Jackson,Jim",382,900,.424,162,405,.400,220,495,.444,107,127,.843,52,435,487,226,86,175,23,227,1033,2003/2004
"Jackson,Marc",71,171,.415,0,1,.000,71,170,.418,64,81,.790,45,81,126,18,12,24,6,45,206,2003/2004
"Jackson,Mark",34,100,.340,7,41,.171,27,59,.458,28,39,.718,10,60,70,119,17,53,1,41,103,2003/2004
"Jackson,Stephen",536,1261,.425,145,427,.340,391,834,.469,233,297,.785,97,273,370,244,142,223,20,216,1450,2003/2004
"Jacobsen,Casey",150,360,.417,75,180,.417,75,180,.417,91,111,.820,42,159,201,98,48,68,9,144,466,2003/2004
"James,Jerome",129,259,.498,0,0,,129,259,.498,66,100,.660,78,152,230,32,20,82,60,180,324,2003/2004
"James,LeBron",622,1492,.417,63,217,.290,559,1275,.438,347,460,.754,99,333,432,465,130,273,58,149,1654,2003/2004
"James,Mike",272,657,.414,106,281,.377,166,376,.441,103,127,.811,28,206,234,339,96,124,3,156,753,2003/2004
"James,Mike",213,510,.418,86,226,.381,127,284,.447,76,95,.800,20,156,176,244,70,83,2,113,588,2003/2004
"James,Mike",59,147,.401,20,55,.364,39,92,.424,27,32,.844,8,50,58,95,26,41,1,43,165,2003/2004
"Jamison,Antawn",488,913,.535,16,40,.400,472,873,.541,220,294,.748,233,287,520,70,83,81,30,174,1212,2003/2004
"Jarić,Marko",185,477,.388,51,150,.340,134,327,.410,74,101,.733,44,131,175,281,93,115,20,132,495,2003/2004
"Jefferies,Chris",27,72,.375,17,42,.405,10,30,.333,13,20,.650,5,24,29,7,4,19,7,36,84,2003/2004
"Jefferies,Chris",3,6,.500,1,3,.333,2,3,.667,1,1,1.000,0,1,1,1,0,1,0,0,8,2003/2004
"Jefferies,Chris",24,66,.364,16,39,.410,8,27,.296,12,19,.632,5,23,28,6,4,18,7,36,76,2003/2004
"Jefferson,Richard",555,1115,.498,48,132,.364,507,983,.516,357,468,.763,109,355,464,315,92,198,28,224,1515,2003/2004
"Jeffries,Jared",177,469,.377,5,30,.167,172,439,.392,105,171,.614,180,244,424,93,48,107,28,212,464,2003/2004
"Johnsen,Britton",17,59,.288,1,12,.083,16,47,.340,7,16,.438,15,30,45,12,7,14,1,28,42,2003/2004
"Johnson,Anthony",167,411,.406,41,122,.336,126,289,.436,75,94,.798,28,102,130,202,64,75,8,138,450,2003/2004
"Johnson,Avery",80,199,.402,0,3,.000,80,196,.408,52,78,.667,3,30,33,111,26,51,3,34,212,2003/2004
"Johnson,DerMarr",36,97,.371,13,36,.361,23,61,.377,28,31,.903,5,34,39,11,8,16,7,32,113,2003/2004
"Johnson,Ervin",55,103,.534,0,1,.000,55,102,.539,17,28,.607,61,171,232,24,27,30,43,156,127,2003/2004
"Johnson,Joe",555,1291,.430,83,272,.305,472,1019,.463,174,232,.750,80,305,385,362,93,199,26,177,1367,2003/2004
"Johnson,Linton",72,203,.355,7,33,.212,65,170,.382,22,37,.595,59,124,183,27,37,37,32,90,173,2003/2004
"Jones,Dahntay",15,53,.283,1,4,.250,14,49,.286,5,11,.455,7,16,23,12,5,12,6,23,36,2003/2004
"Jones,Damon",210,524,.401,98,273,.359,112,251,.446,55,72,.764,15,155,170,478,30,103,4,92,573,2003/2004
"Jones,Eddie",473,1156,.409,177,479,.370,296,677,.437,278,333,.835,38,270,308,258,92,129,34,226,1401,2003/2004
"Jones,Fred",123,311,.395,27,89,.303,96,222,.432,124,149,.832,25,101,126,173,65,73,18,132,397,2003/2004
"Jones,James",2,9,.222,1,4,.250,1,5,.200,2,2,1.000,0,2,2,0,1,0,0,1,7,2003/2004
"Jones,Jumaine",33,96,.344,13,44,.295,20,52,.385,14,23,.609,24,44,68,14,12,19,9,48,93,2003/2004
"Jones,Popeye",0,2,.000,0,0,,0,2,.000,0,0,,1,0,1,0,0,0,0,2,0,2003/2004
"Kaman,Chris",200,435,.460,0,2,.000,200,433,.462,99,142,.697,126,335,461,85,23,155,73,211,499,2003/2004
"Kapono,Jason",52,129,.403,21,44,.477,31,85,.365,20,24,.833,19,36,55,14,13,21,2,41,145,2003/2004
"Kidd,Jason",368,959,.384,94,293,.321,274,666,.411,206,249,.827,85,343,428,618,122,214,14,110,1036,2003/2004
"Kirilenko,Andrei",412,931,.443,68,201,.338,344,730,.471,392,496,.790,226,403,629,244,150,215,215,174,1284,2003/2004
"Kittles,Kerry",434,959,.453,97,276,.351,337,683,.493,107,136,.787,56,271,327,206,125,95,40,144,1072,2003/2004
"Knight,Brevin",105,246,.427,2,8,.250,103,238,.433,49,65,.754,14,98,112,204,84,72,1,107,261,2003/2004
"Knight,Brevin",1,3,.333,0,0,,1,3,.333,0,0,,0,3,3,4,3,3,1,1,2,2003/2004
"Knight,Brevin",58,138,.420,1,5,.200,57,133,.429,19,27,.704,11,50,61,102,52,44,0,50,136,2003/2004
"Knight,Brevin",46,105,.438,1,3,.333,45,102,.441,30,38,.789,3,45,48,98,29,25,0,56,123,2003/2004
"Korver,Kyle",115,327,.352,81,207,.391,34,120,.283,19,24,.792,30,81,111,40,25,41,8,102,330,2003/2004
"Kukoč,Toni",211,506,.417,49,168,.292,162,338,.479,145,199,.729,60,211,271,200,59,110,21,110,616,2003/2004
"Laettner,Christian",119,256,.465,6,21,.286,113,235,.481,40,50,.800,50,182,232,89,37,42,28,102,284,2003/2004
"LaFrentz,Raef",57,124,.460,8,40,.200,49,84,.583,10,13,.769,30,49,79,24,8,11,13,47,132,2003/2004
"Lampe,Maciej",43,88,.489,0,4,.000,43,84,.512,10,13,.769,9,35,44,9,3,15,3,28,96,2003/2004
"Lampley,Sean",13,20,.650,0,0,,13,20,.650,8,12,.667,2,9,11,2,0,3,1,2,34,2003/2004
"Langhi,Dan",5,14,.357,1,2,.500,4,12,.333,2,2,1.000,0,4,4,0,0,2,0,7,13,2003/2004
"Langhi,Dan",2,6,.333,0,0,,2,6,.333,2,2,1.000,0,3,3,0,0,2,0,5,6,2003/2004
"Langhi,Dan",3,8,.375,1,2,.500,2,6,.333,0,0,,0,1,1,0,0,0,0,2,7,2003/2004
"LaRue,Rusty",1,3,.333,1,1,1.000,0,2,.000,1,2,.500,0,3,3,2,2,4,0,2,4,2003/2004
"Lenard,Voshon",394,933,.422,106,289,.367,288,644,.447,144,182,.791,46,154,200,151,61,101,12,177,1038,2003/2004
"Lewis,Quincy",7,20,.350,2,5,.400,5,15,.333,0,0,,1,6,7,2,2,3,2,10,16,2003/2004
"Lewis,Rashard",535,1229,.435,145,386,.376,390,843,.463,206,270,.763,133,385,518,175,99,135,54,233,1421,2003/2004
"Livingston,Randy",2,10,.200,0,3,.000,2,7,.286,4,6,.667,2,5,7,4,2,4,0,7,8,2003/2004
"López,Raül",223,517,.431,25,85,.294,198,432,.458,101,117,.863,24,131,155,305,62,174,2,200,572,2003/2004
"Lue,Tyronn",309,714,.433,80,209,.383,229,505,.453,101,131,.771,26,161,187,317,61,124,5,185,799,2003/2004
"Lynch,George",149,375,.397,43,139,.309,106,236,.449,34,51,.667,96,216,312,117,48,64,18,159,375,2003/2004
"Madsen,Mark",101,204,.495,0,6,.000,101,198,.510,57,118,.483,134,138,272,28,33,47,18,175,259,2003/2004
"Maggette,Corey",453,1013,.447,76,231,.329,377,782,.482,526,620,.848,96,334,430,224,65,207,16,217,1508,2003/2004
"Magloire,Jamaal",383,809,.473,0,1,.000,383,808,.474,353,470,.751,268,579,847,86,43,201,101,278,1119,2003/2004
"Malone,Karl",193,400,.483,0,1,.000,193,399,.484,168,225,.747,61,306,367,163,50,103,20,116,554,2003/2004
"Marbury,Stephon",598,1386,.431,87,274,.318,511,1112,.460,356,436,.817,58,205,263,719,129,249,9,172,1639,2003/2004
"Marbury,Stephon",262,606,.432,37,118,.314,225,488,.461,147,185,.795,19,98,117,281,64,97,5,74,708,2003/2004
"Marbury,Stephon",336,780,.431,50,156,.321,286,624,.458,209,251,.833,39,107,146,438,65,152,4,98,931,2003/2004
"Marion,Shawn",590,1341,.440,90,265,.340,500,1076,.465,228,268,.851,212,525,737,214,167,156,104,203,1498,2003/2004
"Marshall,Donyell",470,1020,.461,131,325,.403,339,695,.488,134,182,.736,210,598,808,122,93,117,124,247,1205,2003/2004
"Marshall,Donyell",57,136,.419,11,27,.407,46,109,.422,14,20,.700,28,71,99,28,13,22,20,47,139,2003/2004
"Marshall,Donyell",413,884,.467,120,298,.403,293,586,.500,120,162,.741,182,527,709,94,80,95,104,200,1066,2003/2004
"Martin,Darrick",20,67,.299,6,26,.231,14,41,.341,9,9,1.000,2,5,7,23,2,7,1,23,55,2003/2004
"Martin,Kenyon",439,900,.488,7,25,.280,432,875,.494,201,294,.684,133,484,617,160,95,168,82,230,1086,2003/2004
"Mashburn,Jamal",156,398,.392,19,67,.284,137,331,.414,65,80,.813,19,98,117,47,14,37,5,42,396,2003/2004
"Mason,Desmond",409,867,.472,9,39,.231,400,828,.483,356,463,.769,93,266,359,152,60,148,24,191,1183,2003/2004
"Mason,Roger",32,98,.327,13,39,.333,19,59,.322,19,22,.864,1,30,31,26,11,20,6,36,96,2003/2004
"Mason,Roger",1,11,.091,1,6,.167,0,5,.000,0,0,,0,3,3,3,1,2,0,5,3,2003/2004
"Mason,Roger",31,87,.356,12,33,.364,19,54,.352,19,22,.864,1,27,28,23,10,18,6,31,93,2003/2004
"Massenburg,Tony",104,219,.475,0,1,.000,104,218,.477,43,63,.683,57,131,188,29,14,45,18,144,251,2003/2004
"McCarty,Walter",203,523,.388,137,366,.374,66,157,.420,62,82,.756,28,211,239,124,72,91,22,179,605,2003/2004
"McCaskill,Amal",47,117,.402,0,1,.000,47,116,.405,19,27,.704,48,85,133,20,12,25,20,89,113,2003/2004
"McCoy,Jelani",0,0,,0,0,,0,0,,0,0,,1,3,4,0,0,1,0,4,0,2003/2004
"McDyess,Antonio",126,268,.470,0,0,,126,268,.470,38,69,.551,70,187,257,36,37,57,24,117,290,2003/2004
"McDyess,Antonio",65,142,.458,0,0,,65,142,.458,22,38,.579,31,88,119,20,12,27,11,46,152,2003/2004
"McDyess,Antonio",61,126,.484,0,0,,61,126,.484,16,31,.516,39,99,138,16,25,30,13,71,138,2003/2004
"McGrady,Tracy",653,1566,.417,174,513,.339,479,1053,.455,398,500,.796,95,307,402,370,93,179,42,129,1878,2003/2004
"McInnis,Jeff",334,747,.447,46,127,.362,288,620,.465,114,143,.797,33,143,176,430,72,120,6,163,828,2003/2004
"McInnis,Jeff",196,416,.471,15,47,.319,181,369,.491,58,76,.763,16,78,94,196,36,61,2,94,465,2003/2004
"McInnis,Jeff",138,331,.417,31,80,.388,107,251,.426,56,67,.836,17,65,82,234,36,59,4,69,363,2003/2004
"McKie,Aaron",265,577,.459,75,172,.436,190,405,.469,84,111,.757,45,208,253,195,85,103,23,142,689,2003/2004
"McLeod,Keith",27,82,.329,1,10,.100,26,72,.361,33,43,.767,5,29,34,59,16,29,1,39,88,2003/2004
"Medvedenko,Stanislav",237,537,.441,0,3,.000,237,534,.444,89,116,.767,148,195,343,57,38,59,18,191,563,2003/2004
"Mercer,Ron",90,211,.427,2,7,.286,88,204,.431,13,17,.765,10,39,49,22,14,26,5,37,195,2003/2004
"Mihm,Chris",186,381,.488,0,0,,186,381,.488,110,166,.663,156,257,413,21,37,90,63,208,482,2003/2004
"Mihm,Chris",59,127,.465,0,0,,59,127,.465,34,48,.708,47,93,140,10,9,25,22,58,152,2003/2004
"Mihm,Chris",127,254,.500,0,0,,127,254,.500,76,118,.644,109,164,273,11,28,65,41,150,330,2003/2004
"Miles,Darius",365,753,.485,7,40,.175,358,713,.502,124,193,.642,112,247,359,162,67,130,61,168,861,2003/2004
"Miles,Darius",143,331,.432,5,30,.167,138,301,.458,39,72,.542,48,119,167,80,25,56,27,84,330,2003/2004
"Miles,Darius",222,422,.526,2,10,.200,220,412,.534,85,121,.702,64,128,192,82,42,74,34,84,531,2003/2004
"Miličić,Darko",17,65,.262,0,1,.000,17,64,.266,14,24,.583,11,32,43,7,7,13,15,33,48,2003/2004
"Miller,Andre",430,941,.457,12,65,.185,418,876,.477,342,411,.832,127,239,366,501,142,215,25,194,1214,2003/2004
"Miller,Brad",373,731,.510,12,38,.316,361,693,.521,256,329,.778,191,552,743,312,68,144,86,247,1014,2003/2004
"Miller,Mike",270,616,.438,80,215,.372,190,401,.474,102,141,.723,42,174,216,232,59,107,14,162,722,2003/2004
"Miller,Oliver",53,100,.530,0,1,.000,53,99,.535,15,23,.652,46,84,130,36,19,33,26,91,121,2003/2004
"Miller,Reggie",260,594,.438,134,334,.401,126,260,.485,146,165,.885,18,170,188,249,65,68,11,96,800,2003/2004
"Ming,Yao",535,1025,.522,0,2,.000,535,1023,.523,361,446,.809,197,538,735,122,22,204,156,273,1431,2003/2004
"Mobley,Cuttino",460,1081,.426,164,420,.390,296,661,.448,176,217,.811,40,322,362,258,107,180,33,179,1260,2003/2004
"Mohammed,Nazr",246,472,.521,0,0,,246,472,.521,100,169,.592,178,296,474,36,55,96,52,195,592,2003/2004
"Mohammed,Nazr",138,280,.493,0,0,,138,280,.493,69,110,.627,101,166,267,20,22,55,27,113,345,2003/2004
"Mohammed,Nazr",108,192,.563,0,0,,108,192,.563,31,59,.525,77,130,207,16,33,41,25,82,247,2003/2004
"Moïso,Jérôme",40,84,.476,0,1,.000,40,83,.482,22,38,.579,41,72,113,8,17,25,12,42,102,2003/2004
"Moore,Mikki",50,99,.505,0,0,,50,99,.505,30,35,.857,29,55,84,19,7,22,13,65,130,2003/2004
"Moore,Mikki",1,5,.200,0,0,,1,5,.200,0,0,,1,1,2,0,0,0,0,1,2,2003/2004
"Moore,Mikki",49,94,.521,0,0,,49,94,.521,30,35,.857,28,54,82,19,7,22,13,64,128,2003/2004
"Mourning,Alonzo",33,71,.465,0,0,,33,71,.465,30,34,.882,8,19,27,8,2,10,6,32,96,2003/2004
"Murphy,Troy",107,243,.440,5,17,.294,102,226,.451,60,80,.750,48,125,173,20,12,34,17,58,279,2003/2004
"Murray,Lamond",76,215,.353,21,60,.350,55,155,.355,24,35,.686,14,76,90,28,15,38,7,47,197,2003/2004
"Murray,Ronald",389,915,.425,67,229,.293,322,686,.469,168,235,.715,45,159,204,205,81,149,28,158,1013,2003/2004
"Murray,Tracy",3,12,.250,2,5,.400,1,7,.143,0,1,.000,3,2,5,1,1,2,0,3,8,2003/2004
"Mutombo,Dikembe",141,295,.478,0,0,,141,295,.478,81,119,.681,145,292,437,25,17,54,123,141,363,2003/2004
"N'Diaye,Mamadou",27,69,.391,0,0,,27,69,.391,44,59,.746,43,69,112,0,8,18,25,59,98,2003/2004
"N'Diaye,Mamadou",0,1,.000,0,0,,0,1,.000,0,0,,0,1,1,0,0,1,1,1,0,2003/2004
"N'Diaye,Mamadou",27,68,.397,0,0,,27,68,.397,44,59,.746,43,68,111,0,8,17,24,58,98,2003/2004
"Nachbar,Boštjan",47,132,.356,23,63,.365,24,69,.348,21,29,.724,8,62,70,30,14,23,14,72,138,2003/2004
"Nailon,Lee",147,327,.450,0,3,.000,147,324,.454,47,58,.810,64,79,143,38,15,45,8,93,341,2003/2004
"Nailon,Lee",63,138,.457,0,0,,63,138,.457,16,19,.842,26,37,63,17,10,24,7,48,142,2003/2004
"Nailon,Lee",11,27,.407,0,0,,11,27,.407,7,9,.778,8,6,14,4,1,0,0,9,29,2003/2004
"Nailon,Lee",73,162,.451,0,3,.000,73,159,.459,24,30,.800,30,36,66,17,4,21,1,36,170,2003/2004
"Nájera,Eduardo",72,162,.444,2,4,.500,70,158,.443,30,46,.652,67,89,156,25,35,29,19,90,176,2003/2004
"Nash,Steve",397,845,.470,104,257,.405,293,588,.498,230,251,.916,59,173,232,687,67,209,8,139,1128,2003/2004
"Nesterović,Rasho",328,700,.469,0,0,,328,700,.469,54,114,.474,257,376,633,114,51,107,165,247,710,2003/2004
"Newble,Ira",108,276,.391,2,19,.105,106,257,.412,36,46,.783,65,90,155,72,25,54,19,109,254,2003/2004
"Norris,Moochie",80,217,.369,20,58,.345,60,159,.377,54,71,.761,10,55,65,121,44,64,5,51,234,2003/2004
"Norris,Moochie",27,87,.310,8,23,.348,19,64,.297,18,24,.750,2,28,30,48,16,30,2,16,80,2003/2004
"Norris,Moochie",53,130,.408,12,35,.343,41,95,.432,36,47,.766,8,27,35,73,28,34,3,35,154,2003/2004
"Nowitzki,Dirk",605,1310,.462,99,290,.341,506,1020,.496,371,423,.877,90,580,670,207,92,135,104,216,1680,2003/2004
"O'Neal,Jermaine",608,1400,.434,2,18,.111,606,1382,.438,348,460,.757,193,585,778,164,59,181,199,248,1566,2003/2004
"O'Neal,Shaquille",554,948,.584,0,0,,554,948,.584,331,676,.490,246,523,769,196,34,195,166,225,1439,2003/2004
"Oakley,Charles",2,6,.333,0,0,,2,6,.333,5,6,.833,0,5,5,2,0,1,0,8,9,2003/2004
"Odom,Lamar",485,1127,.430,61,205,.298,424,922,.460,340,458,.742,160,616,776,327,85,236,71,273,1371,2003/2004
"Okur,Mehmet",251,542,.463,18,48,.375,233,494,.472,162,209,.775,160,261,421,69,36,101,63,138,682,2003/2004
"Ollie,Kevin",95,257,.370,4,9,.444,91,248,.367,147,176,.835,23,147,170,234,51,81,8,119,341,2003/2004
"Olowokandi,Michael",121,285,.425,0,0,,121,285,.425,36,61,.590,78,167,245,24,16,54,68,137,278,2003/2004
"Ostertag,Greg",208,437,.476,0,1,.000,208,436,.477,113,195,.579,221,357,578,123,30,99,139,228,529,2003/2004
"Outlaw,Bo",159,312,.510,0,4,.000,159,308,.516,61,116,.526,125,217,342,90,73,69,70,170,379,2003/2004
"Outlaw,Travis",3,7,.429,0,0,,3,7,.429,2,4,.500,2,2,4,1,1,1,0,1,8,2003/2004
"Overton,Doug",99,245,.404,3,23,.130,96,222,.432,23,31,.742,16,70,86,138,26,58,2,89,224,2003/2004
"Overton,Doug",3,8,.375,0,0,,3,8,.375,2,2,1.000,0,1,1,4,1,2,0,4,8,2003/2004
"Overton,Doug",96,237,.405,3,23,.130,93,214,.435,21,29,.724,16,69,85,134,25,56,2,85,216,2003/2004
"Pachulia,Zaza",68,175,.389,0,0,,68,175,.389,58,90,.644,69,105,174,13,21,34,12,87,194,2003/2004
"Pack,Robert",22,52,.423,0,0,,22,52,.423,5,6,.833,4,14,18,27,12,16,1,20,49,2003/2004
"Padgett,Scott",74,167,.443,28,65,.431,46,102,.451,24,32,.750,46,93,139,23,12,22,13,73,200,2003/2004
"Palacio,Milt",104,298,.349,4,26,.154,100,272,.368,45,68,.662,15,87,102,184,41,87,11,90,257,2003/2004
"Pargo,Jannero",81,199,.407,22,62,.355,59,137,.431,23,27,.852,8,29,37,70,13,47,6,50,207,2003/2004
"Pargo,Jannero",6,16,.375,2,4,.500,4,12,.333,0,0,,0,6,6,11,2,12,0,5,14,2003/2004
"Pargo,Jannero",9,29,.310,0,5,.000,9,24,.375,0,0,,0,4,4,12,4,5,1,7,18,2003/2004
"Pargo,Jannero",66,154,.429,20,53,.377,46,101,.455,23,27,.852,8,19,27,47,7,30,5,38,175,2003/2004
"Parker,Tony",423,946,.447,62,199,.312,361,747,.483,191,272,.702,43,194,237,411,61,179,7,148,1099,2003/2004
"Parks,Cherokee",4,10,.400,0,0,,4,10,.400,4,6,.667,4,6,10,1,0,2,3,7,12,2003/2004
"Patterson,Ruben",200,395,.506,2,12,.167,198,383,.517,105,190,.553,129,139,268,139,84,105,21,152,507,2003/2004
"Pavlović,Sasha",149,376,.396,19,70,.271,130,306,.425,65,84,.774,44,115,159,60,41,67,16,187,382,2003/2004
"Payton,Gary",482,1024,.471,55,165,.333,427,859,.497,180,252,.714,72,270,342,449,96,151,19,169,1199,2003/2004
"Peeler,Anthony",156,348,.448,68,141,.482,88,207,.425,51,61,.836,31,122,153,120,56,77,10,103,431,2003/2004
"Penigar,Desmond",14,28,.500,0,0,,14,28,.500,4,4,1.000,6,18,24,3,2,6,2,14,32,2003/2004
"Penney,Kirk",1,6,.167,1,3,.333,0,3,.000,0,0,,0,1,1,1,1,3,0,1,3,2003/2004
"Perkins,Kendrick",8,15,.533,0,0,,8,15,.533,6,9,.667,5,9,14,3,0,5,2,6,22,2003/2004
"Person,Wesley",126,314,.401,55,138,.399,71,176,.403,31,39,.795,16,101,117,66,19,38,9,38,338,2003/2004
"Person,Wesley",33,107,.308,11,43,.256,22,64,.344,6,8,.750,2,16,18,23,5,16,2,11,83,2003/2004
"Person,Wesley",80,168,.476,36,76,.474,44,92,.478,19,25,.760,12,62,74,38,11,18,6,22,215,2003/2004
"Person,Wesley",13,39,.333,8,19,.421,5,20,.250,6,6,1.000,2,23,25,5,3,4,1,5,40,2003/2004
"Peterson,Morris",238,587,.405,126,340,.371,112,247,.453,76,94,.809,35,226,261,113,88,69,14,206,678,2003/2004
"Piatkowski,Eric",72,191,.377,43,122,.352,29,69,.420,14,16,.875,10,63,73,26,16,29,5,42,201,2003/2004
"Pierce,Paul",602,1497,.402,115,384,.299,487,1113,.438,517,631,.819,69,453,522,410,131,303,52,234,1836,2003/2004
"Piétrus,Mickaël",96,231,.416,35,105,.333,61,126,.484,52,75,.693,48,71,119,27,32,40,12,100,279,2003/2004
"Pippen,Scottie",53,140,.379,13,48,.271,40,92,.435,17,27,.630,20,48,68,50,21,29,9,38,136,2003/2004
"Planinić,Zoran",53,129,.411,9,32,.281,44,97,.454,38,60,.633,14,41,55,68,13,36,3,70,153,2003/2004
"Pollard,Scot",47,114,.412,0,0,,47,114,.412,12,21,.571,67,97,164,10,23,22,26,110,106,2003/2004
"Polynice,Olden",0,0,,0,0,,0,0,,0,0,,1,1,2,1,1,4,0,2,0,2003/2004
"Pope,Mark",1,2,.500,0,0,,1,2,.500,0,1,.000,0,3,3,0,1,3,0,8,2,2003/2004
"Posey,James",368,770,.478,112,290,.386,256,480,.533,278,335,.830,92,311,403,122,137,112,40,248,1126,2003/2004
"Potapenko,Vitaly",200,409,.489,0,0,,200,409,.489,59,92,.641,101,188,289,53,22,77,28,161,459,2003/2004
"Prince,Tayshaun",338,723,.467,57,157,.363,281,566,.496,108,141,.766,93,297,390,191,63,119,69,149,841,2003/2004
"Przybilla,Joel",18,50,.360,0,0,,18,50,.360,13,31,.419,32,79,111,7,5,18,17,53,49,2003/2004
"Przybilla,Joel",0,0,,0,0,,0,0,,1,2,.500,1,9,10,3,0,2,0,5,1,2003/2004
"Przybilla,Joel",18,50,.360,0,0,,18,50,.360,12,29,.414,31,70,101,4,5,16,17,48,48,2003/2004
"Radmanović,Vladimir",345,812,.425,140,377,.371,205,435,.471,95,127,.748,104,302,406,142,80,109,42,187,925,2003/2004
"Randolph,Zach",663,1368,.485,1,5,.200,662,1363,.486,299,393,.761,242,609,851,163,68,247,41,227,1626,2003/2004
"Ratliff,Theo",266,549,.485,0,0,,266,549,.485,140,217,.645,195,419,614,71,54,120,307,300,672,2003/2004
"Ratliff,Theo",171,373,.458,0,0,,171,373,.458,96,147,.653,105,276,381,51,30,86,166,189,438,2003/2004
"Ratliff,Theo",95,176,.540,0,0,,95,176,.540,44,70,.629,90,143,233,20,24,34,141,111,234,2003/2004
"Rebrača,Željko",34,77,.442,0,0,,34,77,.442,23,30,.767,23,35,58,6,5,17,11,52,91,2003/2004
"Rebrača,Željko",22,54,.407,0,0,,22,54,.407,22,28,.786,19,30,49,4,5,13,9,45,66,2003/2004
"Rebrača,Željko",12,23,.522,0,0,,12,23,.522,1,2,.500,4,5,9,2,0,4,2,7,25,2003/2004
"Redd,Michael",633,1439,.440,127,363,.350,506,1076,.470,383,441,.868,118,289,407,185,81,116,6,152,1776,2003/2004
"Rice,Glen",22,76,.289,5,28,.179,17,48,.354,17,17,1.000,9,32,41,24,6,13,0,22,66,2003/2004
"Richardson,Jason",563,1284,.438,77,273,.282,486,1011,.481,258,377,.684,124,400,524,226,86,196,41,182,1461,2003/2004
"Richardson,Quentin",425,1068,.398,120,341,.352,305,727,.420,151,204,.740,146,268,414,139,67,141,19,130,1121,2003/2004
"Ridnour,Luke",145,350,.414,27,80,.338,118,270,.437,65,79,.823,35,73,108,163,52,80,7,105,382,2003/2004
"Robinson,Clifford",366,945,.387,112,314,.357,254,631,.403,123,173,.711,54,268,322,271,68,173,73,237,967,2003/2004
"Robinson,Eddie",157,326,.482,1,5,.200,156,321,.486,28,43,.651,27,77,104,58,33,45,10,57,343,2003/2004
"Robinson,Glenn",275,614,.448,34,100,.340,241,514,.469,114,137,.832,46,143,189,57,42,106,9,96,698,2003/2004
"Rogers,Rodney",207,505,.410,50,152,.329,157,353,.445,75,98,.765,100,207,307,137,59,98,27,183,539,2003/2004
"Rooks,Sean",54,151,.358,0,1,.000,54,150,.360,33,37,.892,24,73,97,29,14,22,10,89,141,2003/2004
"Rooks,Sean",34,94,.362,0,0,,34,94,.362,12,15,.800,10,40,50,11,9,15,5,48,80,2003/2004
"Rooks,Sean",20,57,.351,0,1,.000,20,56,.357,21,22,.955,14,33,47,18,5,7,5,41,61,2003/2004
"Rose,Jalen",383,952,.402,69,202,.342,314,750,.419,187,231,.810,34,232,266,329,51,208,22,184,1022,2003/2004
"Rose,Jalen",75,200,.375,23,54,.426,52,146,.356,39,51,.765,7,57,64,56,12,37,4,45,212,2003/2004
"Rose,Jalen",308,752,.410,46,148,.311,262,604,.434,148,180,.822,27,175,202,273,39,171,18,139,810,2003/2004
"Rose,Malik",173,404,.428,0,3,.000,173,401,.431,183,225,.813,110,210,320,69,36,112,24,164,529,2003/2004
"Ruffin,Michael",38,117,.325,0,0,,38,117,.325,16,38,.421,78,129,207,41,22,42,21,103,92,2003/2004
"Rush,Kareem",190,432,.440,48,138,.348,142,294,.483,31,52,.596,20,77,97,59,33,48,20,109,459,2003/2004
"Russell,Bryon",98,244,.402,43,112,.384,55,132,.417,50,65,.769,32,114,146,71,32,37,12,110,289,2003/2004
"Salmons,John",161,416,.387,50,147,.340,111,269,.413,71,92,.772,38,158,196,134,62,77,16,122,443,2003/2004
"Sampson,Jamal",11,23,.478,0,0,,11,23,.478,7,12,.583,23,29,52,7,2,6,4,16,29,2003/2004
"Santiago,Daniel",78,163,.479,0,0,,78,163,.479,61,90,.678,35,97,132,24,19,32,21,98,217,2003/2004
"Scalabrine,Brian",86,218,.394,10,41,.244,76,177,.429,58,70,.829,42,131,173,65,21,42,14,113,240,2003/2004
"Sesay,Ansu",81,178,.455,6,21,.286,75,157,.478,32,46,.696,43,49,92,19,19,23,20,66,200,2003/2004
"Shirley,Paul",10,23,.435,0,1,.000,10,22,.455,1,3,.333,8,8,16,4,1,9,1,9,21,2003/2004
"Simmons,Bobby",147,373,.394,2,12,.167,145,361,.402,141,169,.834,115,147,262,96,51,73,17,169,437,2003/2004
"Skinner,Brian",255,513,.497,0,0,,255,513,.497,79,138,.572,119,292,411,49,30,78,61,165,589,2003/2004
"Slay,Tamar",21,60,.350,4,12,.333,17,48,.354,7,14,.500,10,15,25,14,7,11,1,20,53,2003/2004
"Smith,Jabari",26,70,.371,0,3,.000,26,67,.388,12,20,.600,11,20,31,11,2,7,6,25,64,2003/2004
"Smith,Joe",311,708,.439,1,5,.200,310,703,.441,207,241,.859,230,413,643,78,47,82,94,209,830,2003/2004
"Smith,Leon",1,2,.500,0,0,,1,2,.500,0,0,,1,1,2,0,0,0,0,1,2,2003/2004
"Smith,Steve",119,293,.406,43,107,.402,76,186,.409,77,83,.928,27,54,81,56,15,42,6,91,358,2003/2004
"Smith,Theron",16,43,.372,6,12,.500,10,31,.323,6,8,.750,13,28,41,7,5,14,5,18,44,2003/2004
"Snow,Eric",295,715,.413,2,18,.111,293,697,.420,252,316,.797,62,219,281,563,97,187,6,213,844,2003/2004
"Songaila,Darius",133,273,.487,0,0,,133,273,.487,71,88,.807,91,134,225,48,42,43,12,126,337,2003/2004
"Sprewell,Latrell",518,1266,.409,99,299,.331,419,967,.433,240,295,.814,56,254,310,286,88,158,21,101,1375,2003/2004
"Stackhouse,Jerry",128,321,.399,23,65,.354,105,256,.410,83,103,.806,16,78,94,103,24,88,3,49,362,2003/2004
"Stepania,Vladimir",43,103,.417,0,0,,43,103,.417,22,36,.611,50,75,125,23,11,19,15,61,108,2003/2004
"Stevenson,DeShawn",376,871,.432,19,71,.268,357,800,.446,138,204,.676,79,219,298,158,52,120,17,140,909,2003/2004
"Stevenson,DeShawn",261,586,.445,7,30,.233,254,556,.457,89,133,.669,43,135,178,92,28,80,16,86,618,2003/2004
"Stevenson,DeShawn",115,285,.404,12,41,.293,103,244,.422,49,71,.690,36,84,120,66,24,40,1,54,291,2003/2004
"Stewart,Michael",5,12,.417,0,0,,5,12,.417,3,4,.750,8,21,29,0,2,3,10,34,13,2003/2004
"Stewart,Michael",3,7,.429,0,0,,3,7,.429,2,2,1.000,5,13,18,0,1,1,8,21,8,2003/2004
"Stewart,Michael",2,5,.400,0,0,,2,5,.400,1,2,.500,3,8,11,0,1,2,2,13,5,2003/2004
"Stojaković,Peja",665,1386,.480,240,554,.433,425,832,.511,394,425,.927,91,417,508,173,108,153,14,159,1964,2003/2004
"Stoudamire,Damon",408,1018,.401,156,427,.365,252,591,.426,127,145,.876,52,256,308,500,99,180,9,173,1099,2003/2004
"Stoudemire,Amar'e",411,865,.475,1,5,.200,410,860,.477,310,435,.713,157,339,496,78,64,177,89,188,1133,2003/2004
"Strickland,Erick",79,196,.403,29,66,.439,50,130,.385,44,51,.863,13,58,71,90,26,54,2,63,231,2003/2004
"Strickland,Rod",150,353,.425,10,36,.278,140,317,.442,72,98,.735,34,121,155,244,35,85,11,76,382,2003/2004
"Strickland,Rod",122,269,.454,10,33,.303,112,236,.475,57,76,.750,24,94,118,185,27,67,7,59,311,2003/2004
"Strickland,Rod",28,84,.333,0,3,.000,28,81,.346,15,22,.682,10,27,37,59,8,18,4,17,71,2003/2004
"Šundov,Bruno",4,10,.400,0,0,,4,10,.400,3,6,.500,2,8,10,1,0,3,0,9,11,2003/2004
"Šundov,Bruno",3,9,.333,0,0,,3,9,.333,3,6,.500,2,8,10,0,0,3,0,7,9,2003/2004
"Šundov,Bruno",1,1,1.000,0,0,,1,1,1.000,0,0,,0,0,0,1,0,0,0,2,2,2003/2004
"Sura,Bob",202,485,.416,21,79,.266,181,406,.446,171,226,.757,100,226,326,233,62,105,14,158,596,2003/2004
"Sura,Bob",71,173,.410,9,36,.250,62,137,.453,48,69,.696,30,73,103,89,37,39,9,86,199,2003/2004
"Sura,Bob",131,312,.420,12,43,.279,119,269,.442,123,157,.783,70,153,223,144,25,66,5,72,397,2003/2004
"Sweetney,Mike",69,140,.493,0,1,.000,69,139,.496,42,58,.724,68,89,157,14,18,32,12,57,180,2003/2004
"Swift,Stromile",268,571,.469,1,4,.250,267,567,.471,190,262,.725,141,237,378,38,56,88,118,188,727,2003/2004
"Szczerbiak,Wally",106,236,.449,20,46,.435,86,190,.453,53,64,.828,24,64,88,33,12,28,1,42,285,2003/2004
"Taylor,Maurice",367,765,.480,0,2,.000,367,763,.481,128,174,.736,131,253,384,107,43,149,47,253,862,2003/2004
"Terry,Jason",499,1196,.417,146,421,.347,353,775,.455,215,260,.827,49,287,336,437,124,229,16,192,1359,2003/2004
"Thomas,Etan",257,526,.489,0,0,,257,526,.489,191,295,.647,183,345,528,68,36,113,123,219,705,2003/2004
"Thomas,Kenny",381,813,.469,1,5,.200,380,808,.470,243,323,.752,261,489,750,111,82,172,33,219,1006,2003/2004
"Thomas,Kurt",392,829,.473,0,3,.000,392,826,.475,106,127,.835,145,517,662,149,56,132,80,298,890,2003/2004
"Thomas,Tim",363,813,.446,73,194,.376,290,619,.468,171,218,.784,64,256,320,124,64,116,20,196,970,2003/2004
"Thomas,Tim",226,510,.443,47,130,.362,179,380,.471,93,122,.762,38,167,205,90,40,73,15,127,592,2003/2004
"Thomas,Tim",137,303,.452,26,64,.406,111,239,.464,78,96,.813,26,89,115,34,24,43,5,69,378,2003/2004
"Tinsley,Jamaal",153,370,.414,77,207,.372,76,163,.466,49,67,.731,28,108,136,303,84,110,17,132,432,2003/2004
"Traylor,Robert",145,287,.505,2,5,.400,143,282,.507,70,128,.547,106,156,262,43,39,62,37,161,362,2003/2004
"Trent,Gary",155,328,.473,0,6,.000,155,322,.481,69,91,.758,83,133,216,49,12,54,17,129,379,2003/2004
"Trepagnier,Jeff",10,38,.263,2,4,.500,8,34,.235,3,6,.500,6,9,15,4,3,6,0,7,25,2003/2004
"Trybański,Cezary",0,4,.000,0,0,,0,4,.000,1,2,.500,0,1,1,0,1,2,1,3,1,2003/2004
"Trybański,Cezary",0,2,.000,0,0,,0,2,.000,0,0,,0,1,1,0,0,2,1,1,0,2003/2004
"Trybański,Cezary",0,2,.000,0,0,,0,2,.000,1,2,.500,0,0,0,0,1,0,0,2,1,2003/2004
"Tsakalidis,Jake",67,133,.504,0,0,,67,133,.504,36,61,.590,37,91,128,18,9,23,22,79,170,2003/2004
"Tskitishvili,Nikoloz",40,122,.328,3,11,.273,37,111,.333,23,29,.793,24,39,63,10,6,17,8,50,106,2003/2004
"Türkoğlu,Hedo",262,645,.406,101,241,.419,161,404,.399,114,161,.708,52,306,358,154,80,94,32,165,739,2003/2004
"Udoka,Ime",3,9,.333,0,1,.000,3,8,.375,2,4,.500,1,4,5,2,2,3,1,3,8,2003/2004
"Van Exel,Nick",187,479,.390,46,150,.307,141,329,.429,70,99,.707,16,88,104,206,20,78,2,57,490,2003/2004
"Van Horn,Keith",410,903,.454,93,233,.399,317,670,.473,249,290,.859,149,352,501,120,68,169,33,215,1162,2003/2004
"Van Horn,Keith",273,613,.445,60,161,.373,213,452,.471,163,199,.819,98,245,343,83,52,119,18,151,769,2003/2004
"Van Horn,Keith",137,290,.472,33,72,.458,104,218,.477,86,91,.945,51,107,158,37,16,50,15,64,393,2003/2004
"Vaughn,Jacque",107,277,.386,3,20,.150,104,257,.405,53,68,.779,12,104,116,195,44,84,2,126,270,2003/2004
"Voskuhl,Jake",152,300,.507,0,0,,152,300,.507,134,181,.740,123,220,343,57,42,77,25,258,438,2003/2004
"Vraneš,Slavko",0,1,.000,0,0,,0,1,.000,0,0,,0,0,0,0,0,0,0,1,0,2003/2004
"Wade,Dwyane",371,798,.465,16,53,.302,355,745,.477,233,312,.747,85,162,247,275,86,196,34,140,991,2003/2004
"Wagner,Dajuan",112,306,.366,31,86,.360,81,220,.368,32,47,.681,9,49,58,51,26,41,7,89,287,2003/2004
"Walker,Antoine",483,1129,.428,82,305,.269,401,824,.487,103,186,.554,198,486,684,369,65,202,65,212,1151,2003/2004
"Walker,Samaki",38,99,.384,0,2,.000,38,97,.392,29,44,.659,42,70,112,6,9,15,11,54,105,2003/2004
"Wallace,Ben",315,748,.421,1,8,.125,314,740,.424,142,290,.490,324,682,1006,138,143,123,246,162,773,2003/2004
"Wallace,Gerald",32,89,.360,0,2,.000,32,87,.368,11,24,.458,35,39,74,19,14,8,14,37,75,2003/2004
"Wallace,John",61,145,.421,5,13,.385,56,132,.424,31,40,.775,12,47,59,14,5,24,8,38,158,2003/2004
"Wallace,Rasheed",425,974,.436,82,248,.331,343,726,.472,156,212,.736,102,357,459,156,61,119,122,190,1088,2003/2004
"Wallace,Rasheed",296,669,.442,59,173,.341,237,496,.478,115,155,.742,69,229,298,114,36,87,72,131,766,2003/2004
"Wallace,Rasheed",8,24,.333,1,6,.167,7,18,.389,3,3,1.000,1,5,6,2,1,3,5,0,20,2003/2004
"Wallace,Rasheed",121,281,.431,22,69,.319,99,212,.467,38,54,.704,32,123,155,40,24,29,45,59,302,2003/2004
"Walton,Luke",65,153,.425,13,39,.333,52,114,.456,31,44,.705,39,88,127,113,28,44,8,70,174,2003/2004
"Ward,Charlie",160,390,.410,84,206,.408,76,184,.413,20,27,.741,12,132,144,215,64,96,11,107,424,2003/2004
"Ward,Charlie",115,260,.442,59,138,.428,56,122,.459,16,21,.762,10,86,96,170,47,69,8,74,305,2003/2004
"Ward,Charlie",45,130,.346,25,68,.368,20,62,.323,4,6,.667,2,46,48,45,17,27,3,33,119,2003/2004
"Watson,Earl",172,464,.371,26,106,.245,146,358,.408,90,138,.652,49,129,178,402,91,146,19,175,460,2003/2004
"Weatherspoon,Clarence",104,211,.493,0,1,.000,104,210,.495,53,72,.736,74,130,204,30,30,35,15,75,261,2003/2004
"Weatherspoon,Clarence",18,40,.450,0,0,,18,40,.450,18,19,.947,14,36,50,13,8,9,2,19,54,2003/2004
"Weatherspoon,Clarence",86,171,.503,0,1,.000,86,170,.506,35,53,.660,60,94,154,17,22,26,13,56,207,2003/2004
"Webber,Chris",174,421,.413,1,5,.200,173,416,.416,81,114,.711,48,152,200,105,31,60,20,76,430,2003/2004
"Wells,Bonzi",363,850,.427,22,69,.319,341,781,.437,138,183,.754,78,182,260,139,91,161,19,197,886,2003/2004
"Wells,Bonzi",68,175,.389,1,8,.125,67,167,.401,21,27,.778,21,40,61,35,20,32,3,38,158,2003/2004
"Wells,Bonzi",295,675,.437,21,61,.344,274,614,.446,117,156,.750,57,142,199,104,71,129,16,159,728,2003/2004
"Welsch,Jiří",262,612,.428,69,181,.381,193,431,.448,153,206,.743,60,236,296,183,101,129,7,176,746,2003/2004
"Wesley,David",311,800,.389,92,285,.323,219,515,.425,137,182,.753,28,106,134,175,71,100,14,147,851,2003/2004
"West,David",108,228,.474,0,2,.000,108,226,.478,57,80,.713,117,180,297,60,27,48,28,117,273,2003/2004
"White,Jahidi",99,190,.521,0,0,,99,190,.521,63,126,.500,97,164,261,7,25,66,51,176,261,2003/2004
"White,Jahidi",0,1,.000,0,0,,0,1,.000,0,0,,0,0,0,0,0,1,1,0,0,2003/2004
"White,Jahidi",99,189,.524,0,0,,99,189,.524,63,126,.500,97,164,261,7,25,65,50,176,261,2003/2004
"White,Rodney",215,468,.459,33,87,.379,182,381,.478,78,104,.750,44,121,165,60,32,78,20,105,541,2003/2004
"Whitney,Chris",17,45,.378,8,18,.444,9,27,.333,5,5,1.000,3,12,15,14,6,6,2,6,47,2003/2004
"Wilcox,Chris",227,436,.521,0,1,.000,227,435,.522,105,150,.700,125,180,305,51,29,80,20,183,559,2003/2004
"Wilks,Mike",17,36,.472,6,10,.600,11,26,.423,10,12,.833,3,13,16,17,3,7,0,15,50,2003/2004
"Williams,Aaron",172,342,.503,1,3,.333,171,339,.504,105,155,.677,101,193,294,81,34,89,46,187,450,2003/2004
"Williams,Alvin",201,496,.405,26,89,.292,175,407,.430,66,85,.776,18,132,150,224,55,78,10,114,494,2003/2004
"Williams,Eric",231,598,.386,35,127,.276,196,471,.416,215,283,.760,65,221,286,120,70,88,9,180,712,2003/2004
"Williams,Eric",77,177,.435,11,32,.344,66,145,.455,78,109,.716,21,74,95,25,22,31,1,52,243,2003/2004
"Williams,Eric",154,421,.366,24,95,.253,130,326,.399,137,174,.787,44,147,191,95,48,57,8,128,469,2003/2004
"Williams,Frank",80,208,.385,18,60,.300,62,148,.419,41,48,.854,8,45,53,121,25,63,6,58,219,2003/2004
"Williams,Jason",290,713,.407,120,364,.330,170,349,.487,82,98,.837,25,122,147,492,92,136,5,97,782,2003/2004
"Williams,Jerome",158,336,.470,0,8,.000,158,328,.482,106,155,.684,177,298,475,72,90,74,8,134,422,2003/2004
"Williams,Jerome",28,57,.491,0,1,.000,28,56,.500,21,29,.724,35,93,128,11,19,23,3,30,77,2003/2004
"Williams,Jerome",130,279,.466,0,7,.000,130,272,.478,85,126,.675,142,205,347,61,71,51,5,104,345,2003/2004
"Williams,Mo",115,303,.380,10,39,.256,105,264,.398,44,56,.786,23,49,72,76,28,51,2,87,284,2003/2004
"Williams,Scott",90,186,.484,2,3,.667,88,183,.481,16,27,.593,38,94,132,17,20,16,16,95,198,2003/2004
"Williams,Scott",53,101,.525,2,2,1.000,51,99,.515,9,13,.692,23,49,72,6,15,6,7,45,117,2003/2004
"Williams,Scott",37,85,.435,0,1,.000,37,84,.440,7,14,.500,15,45,60,11,5,10,9,50,81,2003/2004
"Williams,Shammond",87,232,.375,30,100,.300,57,132,.432,51,58,.879,9,51,60,116,37,47,2,62,255,2003/2004
"Williams,Shammond",59,151,.391,25,74,.338,34,77,.442,40,45,.889,9,34,43,64,23,26,1,40,183,2003/2004
"Williams,Shammond",28,81,.346,5,26,.192,23,55,.418,11,13,.846,0,17,17,52,14,21,1,22,72,2003/2004
"Williamson,Corliss",304,602,.505,0,0,,304,602,.505,144,197,.731,88,168,256,57,30,113,20,204,752,2003/2004
"Willis,Kevin",70,150,.467,0,1,.000,70,149,.470,24,39,.615,37,61,98,11,21,32,9,61,164,2003/2004
"Woods,Loren",44,96,.458,0,0,,44,96,.458,33,55,.600,65,69,134,10,11,26,19,52,121,2003/2004
"Woods,Qyntel",88,237,.371,10,29,.345,78,208,.375,38,60,.633,46,90,136,46,20,52,14,88,224,2003/2004
"World Peace,Metta",468,1112,.421,75,242,.310,393,870,.452,322,439,.733,100,285,385,272,152,202,50,194,1333,2003/2004
"Wright,Lorenzen",257,586,.439,0,5,.000,257,581,.442,96,131,.733,144,301,445,71,45,77,58,192,610,2003/2004
"Zhizhi,Wang",17,46,.370,4,14,.286,13,32,.406,9,10,.900,4,14,18,2,3,6,5,13,47,2003/2004
"Zhizhi,Wang",0,1,.000,0,0,,0,1,.000,4,4,1.000,0,4,4,0,0,0,1,0,4,2003/2004
"Zhizhi,Wang",17,45,.378,4,14,.286,13,31,.419,5,6,.833,4,10,14,2,3,6,4,13,43,2003/2004
"Abdur-Rahim,Shareef",337,670,.503,15,39,.385,322,631,.510,220,254,.866,123,269,392,111,49,117,26,150,909,2004/2005
"Alexander,Cory",16,49,.327,8,19,.421,8,30,.267,9,12,.750,8,21,29,37,9,19,1,29,49,2004/2005
"Allen,Malik",84,177,.475,0,0,,84,177,.475,26,28,.929,40,59,99,18,9,18,22,53,194,2004/2005
"Allen,Malik",35,76,.461,0,0,,35,76,.461,13,14,.929,24,28,52,11,4,11,11,29,83,2004/2005
"Allen,Malik",49,101,.485,0,0,,49,101,.485,13,14,.929,16,31,47,7,5,7,11,24,111,2004/2005
"Allen,Ray",640,1494,.428,209,556,.376,431,938,.459,378,428,.883,79,268,347,289,84,171,5,167,1867,2004/2005
"Allen,Tony",184,387,.475,12,31,.387,172,356,.483,112,152,.737,85,136,221,64,76,77,24,156,492,2004/2005
"Alston,Rafer",403,974,.414,139,389,.357,264,585,.451,191,258,.740,42,237,279,514,118,170,7,212,1136,2004/2005
"Andersen,Chris",191,358,.534,0,3,.000,191,355,.538,131,190,.689,137,273,410,71,14,64,100,144,513,2004/2005
"Anderson,Derek",152,391,.389,58,151,.384,94,240,.392,70,87,.805,25,103,128,143,36,70,4,89,432,2004/2005
"Anderson,Kenny",85,201,.423,6,13,.462,79,188,.420,27,37,.730,24,64,88,103,33,49,0,87,203,2004/2005
"Anderson,Kenny",81,190,.426,6,13,.462,75,177,.424,27,37,.730,23,60,83,98,33,46,0,81,195,2004/2005
"Anderson,Kenny",4,11,.364,0,0,,4,11,.364,0,0,,1,4,5,5,0,3,0,6,8,2004/2005
"Anderson,Shandon",98,217,.452,5,29,.172,93,188,.495,54,66,.818,41,150,191,70,40,50,14,138,255,2004/2005
"Anderson,Shandon",0,2,.000,0,1,.000,0,1,.000,0,0,,1,0,1,0,0,1,0,2,0,2004/2005
"Anderson,Shandon",98,215,.456,5,28,.179,93,187,.497,54,66,.818,40,150,190,70,40,49,14,136,255,2004/2005
"Anthony,Carmelo",530,1230,.431,42,158,.266,488,1072,.455,456,573,.796,141,285,426,194,68,224,30,229,1558,2004/2005
"Araújo,Rafael",76,175,.434,1,3,.333,75,172,.436,43,55,.782,59,126,185,16,21,52,8,157,196,2004/2005
"Arenas,Gilbert",656,1523,.431,205,562,.365,451,961,.469,521,640,.814,83,295,378,411,139,242,23,245,2038,2004/2005
"Ariza,Trevor",172,389,.442,3,13,.231,169,376,.449,121,174,.695,89,153,242,85,70,73,18,150,468,2004/2005
"Armstrong,Darrell",89,277,.321,28,111,.252,61,166,.367,58,68,.853,35,80,115,178,45,67,8,92,264,2004/2005
"Armstrong,Darrell",53,159,.333,17,70,.243,36,89,.404,19,21,.905,16,32,48,65,15,28,2,30,142,2004/2005
"Armstrong,Darrell",36,118,.305,11,41,.268,25,77,.325,39,47,.830,19,48,67,113,30,39,6,62,122,2004/2005
"Arroyo,Carlos",167,429,.389,8,30,.267,159,399,.398,119,149,.799,26,78,104,280,44,107,4,143,461,2004/2005
"Arroyo,Carlos",93,232,.401,7,18,.389,86,214,.402,53,63,.841,11,35,46,152,20,55,3,67,246,2004/2005
"Arroyo,Carlos",74,197,.376,1,12,.083,73,185,.395,66,86,.767,15,43,58,128,24,52,1,76,215,2004/2005
"Atkins,Chucky",388,910,.426,176,455,.387,212,455,.466,163,203,.803,31,166,197,358,73,151,2,181,1115,2004/2005
"Augmon,Stacey",68,167,.407,0,0,,68,167,.407,57,77,.740,45,54,99,36,23,31,8,83,193,2004/2005
"Baker,Maurice",0,1,.000,0,0,,0,1,.000,0,0,,1,1,2,1,1,1,0,3,0,2004/2005
"Baker,Maurice",0,0,,0,0,,0,0,,0,0,,0,0,0,0,0,0,0,0,0,2004/2005
"Baker,Maurice",0,1,.000,0,0,,0,1,.000,0,0,,1,1,2,1,1,1,0,3,0,2004/2005
"Baker,Vin",13,42,.310,0,1,.000,13,41,.317,9,17,.529,17,22,39,10,2,17,4,38,35,2004/2005
"Baker,Vin",13,38,.342,0,1,.000,13,37,.351,7,15,.467,17,20,37,9,2,15,4,31,33,2004/2005
"Baker,Vin",0,4,.000,0,0,,0,4,.000,2,2,1.000,0,2,2,1,0,2,0,7,2,2004/2005
"Banks,Marcus",115,286,.402,21,59,.356,94,227,.414,121,163,.742,29,97,126,155,63,79,13,146,372,2004/2005
"Barbosa,Leandro",168,354,.475,51,139,.367,117,215,.544,55,69,.797,32,98,130,126,30,87,7,127,442,2004/2005
"Barnes,Matt",62,151,.411,5,22,.227,57,129,.442,35,58,.603,49,84,133,57,30,45,7,80,164,2004/2005
"Barrett,Andre",45,124,.363,14,52,.269,31,72,.431,14,19,.737,11,29,40,69,19,27,1,51,118,2004/2005
"Barrett,Andre",20,69,.290,9,37,.243,11,32,.344,7,10,.700,5,14,19,42,14,16,0,35,56,2004/2005
"Barrett,Andre",25,55,.455,5,15,.333,20,40,.500,7,9,.778,6,15,21,27,5,11,1,16,62,2004/2005
"Barry,Brent",194,459,.423,100,280,.357,94,179,.525,113,135,.837,29,161,190,178,39,64,20,123,601,2004/2005
"Barry,Jon",161,368,.438,71,165,.430,90,203,.443,62,71,.873,26,133,159,167,60,67,9,95,455,2004/2005
"Barry,Jon",31,77,.403,11,32,.344,20,45,.444,10,13,.769,4,17,21,28,14,14,2,28,83,2004/2005
"Barry,Jon",130,291,.447,60,133,.451,70,158,.443,52,58,.897,22,116,138,139,46,53,7,67,372,2004/2005
"Battie,Tony",163,354,.460,0,6,.000,163,348,.468,68,94,.723,109,343,452,42,30,81,81,244,394,2004/2005
"Battier,Shane",271,613,.442,70,177,.395,201,436,.461,180,228,.789,158,255,413,126,91,75,77,201,792,2004/2005
"Baxter,Lonny",3,11,.273,0,0,,3,11,.273,0,2,.000,4,4,8,0,0,4,0,10,6,2004/2005
"Bell,Raja",303,667,.454,54,134,.403,249,533,.467,112,150,.747,48,153,201,91,44,79,8,205,772,2004/2005
"Bender,Jonathan",16,40,.400,1,5,.200,15,35,.429,3,6,.500,5,9,14,4,1,10,2,9,36,2004/2005
"Best,Travis",190,452,.420,26,85,.306,164,367,.447,108,122,.885,19,88,107,143,66,67,9,148,514,2004/2005
"Bibby,Mike",560,1264,.443,131,364,.360,429,900,.477,320,413,.775,77,255,332,541,124,203,30,191,1571,2004/2005
"Biedriņš,Andris",45,78,.577,0,1,.000,45,77,.584,19,40,.475,47,71,118,12,12,12,24,87,109,2004/2005
"Billups,Chauncey",404,913,.442,165,387,.426,239,526,.454,343,382,.898,48,223,271,464,81,180,9,194,1316,2004/2005
"Blake,Steve",61,186,.328,36,93,.387,25,93,.269,33,41,.805,18,53,71,69,13,39,0,47,191,2004/2005
"Blount,Mark",327,618,.529,0,1,.000,327,617,.530,117,164,.713,143,254,397,129,33,158,64,229,771,2004/2005
"Bobbitt,Tony",2,5,.400,1,2,.500,1,3,.333,0,0,,0,3,3,0,0,0,0,1,5,2004/2005
"Bogans,Keith",262,688,.381,57,173,.329,205,515,.398,133,183,.727,76,150,226,135,68,122,8,167,714,2004/2005
"Bonner,Matt",247,463,.533,39,92,.424,208,371,.561,56,71,.789,108,177,285,48,39,40,19,220,589,2004/2005
"Booth,Calvin",49,108,.454,0,1,.000,49,107,.458,26,32,.813,29,78,107,8,15,16,28,78,124,2004/2005
"Booth,Calvin",34,79,.430,0,1,.000,34,78,.436,14,16,.875,16,42,58,4,11,8,16,55,82,2004/2005
"Booth,Calvin",15,29,.517,0,0,,15,29,.517,12,16,.750,13,36,49,4,4,8,12,23,42,2004/2005
"Boozer,Carlos",361,693,.521,0,1,.000,361,692,.522,187,268,.698,141,316,457,144,41,137,24,179,909,2004/2005
"Borchardt,Curtis",74,172,.430,0,0,,74,172,.430,52,71,.732,86,138,224,49,10,52,32,160,200,2004/2005
"Bosh,Chris",473,1005,.471,3,10,.300,470,995,.472,412,542,.760,194,524,718,153,76,187,113,226,1361,2004/2005
"Bowen,Bruce",251,598,.420,102,253,.403,149,345,.432,71,112,.634,50,235,285,126,55,57,39,175,675,2004/2005
"Bowen,Ryan",47,111,.423,3,6,.500,44,105,.419,14,21,.667,21,55,76,18,23,7,5,61,111,2004/2005
"Boykins,Earl",340,824,.413,56,166,.337,284,658,.432,279,303,.921,37,106,143,372,78,121,12,122,1015,2004/2005
"Bradley,Michael",15,24,.625,0,1,.000,15,23,.652,3,8,.375,8,20,28,5,1,5,2,12,33,2004/2005
"Bradley,Michael",3,7,.429,0,0,,3,7,.429,0,0,,3,11,14,2,1,1,2,4,6,2004/2005
"Bradley,Michael",8,12,.667,0,0,,8,12,.667,2,6,.333,5,6,11,2,0,3,0,8,18,2004/2005
"Bradley,Michael",4,5,.800,0,1,.000,4,4,1.000,1,2,.500,0,3,3,1,0,1,0,0,9,2004/2005
"Bradley,Shawn",84,186,.452,0,0,,84,186,.452,43,63,.683,70,144,214,15,25,33,63,153,211,2004/2005
"Braggs,Torraye",3,7,.429,0,0,,3,7,.429,0,0,,7,5,12,0,0,2,0,4,6,2004/2005
"Brand,Elton",629,1251,.503,0,3,.000,629,1248,.504,364,484,.752,296,474,770,208,62,183,169,240,1622,2004/2005
"Brewer,Jamison",11,37,.297,3,15,.200,8,22,.364,6,13,.462,6,16,22,12,8,13,1,11,31,2004/2005
"Brezec,Primož",387,756,.512,0,0,,387,756,.512,164,220,.745,226,305,531,86,33,106,55,183,938,2004/2005
"Brown,Damone",23,62,.371,4,11,.364,19,51,.373,4,9,.444,10,18,28,14,1,15,6,17,54,2004/2005
"Brown,Devin",173,409,.423,45,121,.372,128,288,.444,103,130,.792,37,139,176,92,39,53,12,83,494,2004/2005
"Brown,Kedrick",2,6,.333,0,3,.000,2,3,.667,8,10,.800,1,10,11,4,3,5,1,4,12,2004/2005
"Brown,Kwame",109,237,.460,0,0,,109,237,.460,74,129,.574,72,134,206,39,25,67,15,112,292,2004/2005
"Brown,P.J.",338,758,.446,0,0,,338,758,.446,210,243,.864,266,471,737,178,74,101,50,233,886,2004/2005
"Brown,Tierre",124,348,.356,26,72,.361,98,276,.355,59,75,.787,21,72,93,155,32,74,1,59,333,2004/2005
"Brunson,Rick",166,442,.376,48,130,.369,118,312,.378,57,74,.770,23,164,187,410,82,125,7,106,437,2004/2005
"Bryant,Kobe",573,1324,.433,131,387,.339,442,937,.472,542,664,.816,95,297,392,398,86,270,53,174,1819,2004/2005
"Buckner,Greg",160,303,.528,49,121,.405,111,182,.610,63,81,.778,66,142,208,133,75,49,6,169,432,2004/2005
"Buford,Rodney",187,489,.382,34,108,.315,153,381,.402,37,45,.822,33,156,189,63,40,35,4,101,445,2004/2005
"Burks,Antonio",28,60,.467,3,11,.273,25,49,.510,14,19,.737,1,11,12,28,13,12,1,25,73,2004/2005
"Butler,Caron",441,991,.445,38,125,.304,403,866,.465,275,319,.862,146,304,450,146,110,125,23,213,1195,2004/2005
"Butler,Jackie",4,4,1.000,0,0,,4,4,1.000,2,2,1.000,0,0,0,0,1,1,0,0,10,2004/2005
"Butler,Rasual",163,409,.399,57,153,.373,106,256,.414,37,48,.771,15,136,151,62,18,37,29,104,420,2004/2005
"Čabarkapa,Žarko",86,177,.486,13,36,.361,73,141,.518,53,65,.815,35,67,102,25,10,30,5,59,238,2004/2005
"Čabarkapa,Žarko",4,7,.571,0,0,,4,7,.571,1,1,1.000,2,1,3,0,0,0,0,0,9,2004/2005
"Čabarkapa,Žarko",82,170,.482,13,36,.361,69,134,.515,52,64,.813,33,66,99,25,10,30,5,59,229,2004/2005
"Camby,Marcus",279,600,.465,0,4,.000,279,596,.468,125,173,.723,131,530,661,152,61,103,199,177,683,2004/2005
"Campbell,Elden",39,123,.317,0,2,.000,39,121,.322,42,55,.764,28,65,93,19,8,29,7,57,120,2004/2005
"Campbell,Elden",0,7,.000,0,0,,0,7,.000,2,4,.500,3,8,11,3,0,1,1,10,2,2004/2005
"Campbell,Elden",39,116,.336,0,2,.000,39,114,.342,40,51,.784,25,57,82,16,8,28,6,47,118,2004/2005
"Cardinal,Brian",160,432,.370,44,125,.352,116,307,.378,158,181,.873,63,162,225,114,88,83,19,172,522,2004/2005
"Carlisle,Geno",2,3,.667,0,0,,2,3,.667,4,6,.667,1,0,1,1,0,1,0,1,8,2004/2005
"Carroll,Matt",70,180,.389,13,39,.333,57,141,.404,71,83,.855,13,47,60,17,17,25,2,37,224,2004/2005
"Carter,Anthony",72,177,.407,2,17,.118,70,160,.438,35,51,.686,12,57,69,161,35,62,18,88,181,2004/2005
"Carter,Vince",696,1541,.452,127,313,.406,569,1228,.463,367,460,.798,106,295,401,327,109,168,48,243,1886,2004/2005
"Carter,Vince",124,302,.411,19,59,.322,105,243,.432,50,72,.694,28,38,66,61,25,22,15,56,317,2004/2005
"Carter,Vince",572,1239,.462,108,254,.425,464,985,.471,317,388,.817,78,257,335,266,84,146,33,187,1569,2004/2005
"Cassell,Sam",319,687,.464,27,103,.262,292,584,.500,134,155,.865,25,132,157,301,36,109,14,160,799,2004/2005
"Cato,Kelvin",160,297,.539,0,0,,160,297,.539,112,143,.783,102,314,416,40,55,64,82,170,432,2004/2005
"Chalmers,Lionel",42,125,.336,12,49,.245,30,76,.395,15,24,.625,4,27,31,51,13,24,0,30,111,2004/2005
"Chandler,Tyson",207,419,.494,0,2,.000,207,417,.496,226,336,.673,261,514,775,65,69,118,141,268,640,2004/2005
"Cheaney,Calbert",113,265,.426,0,3,.000,113,262,.431,24,37,.649,32,92,124,64,17,35,15,95,250,2004/2005
"Childress,Josh",302,642,.470,13,56,.232,289,586,.493,190,231,.823,195,287,482,151,74,106,35,184,807,2004/2005
"Christie,Doug",130,332,.392,15,62,.242,115,270,.426,70,78,.897,38,139,177,199,80,104,18,106,345,2004/2005
"Christie,Doug",83,204,.407,10,39,.256,73,165,.442,50,56,.893,29,94,123,153,43,68,13,61,226,2004/2005
"Christie,Doug",47,128,.367,5,23,.217,42,105,.400,20,22,.909,9,45,54,46,37,36,5,45,119,2004/2005
"Claxton,Speedy",257,611,.421,11,61,.180,246,550,.447,187,254,.736,37,147,184,374,109,119,8,184,712,2004/2005
"Claxton,Speedy",216,501,.431,10,52,.192,206,449,.459,162,213,.761,32,121,153,286,87,92,6,154,604,2004/2005
"Claxton,Speedy",41,110,.373,1,9,.111,40,101,.396,25,41,.610,5,26,31,88,22,27,2,30,108,2004/2005
"Cleaves,Mateen",5,14,.357,0,2,.000,5,12,.417,3,4,.750,2,4,6,7,2,2,0,2,13,2004/2005
"Coleman,Derrick",3,14,.214,0,2,.000,3,12,.250,3,3,1.000,3,12,15,0,0,2,0,6,9,2004/2005
"Collier,Jason",174,376,.463,6,14,.429,168,362,.464,48,71,.676,84,100,184,18,15,63,13,147,402,2004/2005
"Collins,Jarron",65,157,.414,0,1,.000,65,156,.417,83,119,.697,57,107,164,61,11,34,6,146,213,2004/2005
"Collins,Jason",186,451,.412,2,6,.333,184,445,.413,137,209,.656,153,335,488,105,71,91,71,322,511,2004/2005
"Collison,Nick",190,354,.537,0,3,.000,190,351,.541,83,118,.703,156,220,376,32,34,62,50,252,463,2004/2005
"Cook,Brian",176,422,.417,78,199,.392,98,223,.439,28,37,.757,63,153,216,35,23,29,26,139,458,2004/2005
"Cook,Omar",10,24,.417,0,4,.000,10,20,.500,3,6,.500,2,5,7,22,6,6,1,6,23,2004/2005
"Crawford,Jamal",437,1097,.398,185,512,.361,252,585,.431,182,216,.843,33,170,203,302,92,148,19,135,1241,2004/2005
"Croshere,Austin",188,497,.378,45,174,.259,143,323,.443,226,256,.883,103,272,375,98,48,104,17,154,647,2004/2005
"Curry,Eddy",393,730,.538,0,0,,393,730,.538,226,314,.720,116,222,338,37,21,163,58,202,1012,2004/2005
"Curry,Michael",13,29,.448,0,0,,13,29,.448,4,8,.500,8,19,27,15,5,5,4,39,30,2004/2005
"Dalembert,Samuel",250,477,.524,0,0,,250,477,.524,89,148,.601,187,355,542,35,46,114,121,241,589,2004/2005
"Dampier,Erick",202,367,.550,0,3,.000,202,364,.555,138,228,.605,183,318,501,51,15,102,80,205,542,2004/2005
"Daniels,Antonio",273,623,.438,49,165,.297,224,458,.489,248,304,.816,20,149,169,309,51,78,3,78,843,2004/2005
"Daniels,Erik",6,18,.333,1,2,.500,5,16,.313,0,0,,7,11,18,4,2,6,0,7,13,2004/2005
"Daniels,Marquis",220,504,.437,7,35,.200,213,469,.454,98,133,.737,87,129,216,128,83,86,14,124,545,2004/2005
"Davis,Antonio",193,419,.461,0,0,,193,419,.461,115,152,.757,152,276,428,80,27,96,41,147,501,2004/2005
"Davis,Baron",291,752,.387,118,354,.333,173,398,.435,185,243,.761,32,143,175,362,81,131,14,126,885,2004/2005
"Davis,Baron",111,303,.366,44,137,.321,67,166,.404,74,96,.771,16,51,67,129,31,38,4,52,340,2004/2005
"Davis,Baron",180,449,.401,74,217,.341,106,232,.457,111,147,.755,16,92,108,233,50,93,10,74,545,2004/2005
"Davis,Dale",112,234,.479,0,0,,112,234,.479,60,99,.606,152,223,375,47,32,43,65,162,284,2004/2005
"Davis,Dale",45,109,.413,0,0,,45,109,.413,22,38,.579,61,92,153,23,13,20,32,79,112,2004/2005
"Davis,Dale",67,125,.536,0,0,,67,125,.536,38,61,.623,91,131,222,24,19,23,33,83,172,2004/2005
"Davis,Josh",42,111,.378,19,53,.358,23,58,.397,14,17,.824,29,50,79,12,8,15,4,45,117,2004/2005
"Davis,Ricky",481,1041,.462,61,180,.339,420,861,.488,286,351,.815,66,183,249,246,89,205,27,174,1309,2004/2005
"DeClercq,Andrew",4,9,.444,0,0,,4,9,.444,1,3,.333,7,3,10,0,2,1,0,14,9,2004/2005
"Delfino,Carlos",42,117,.359,9,35,.257,33,82,.402,23,40,.575,13,42,55,38,22,23,6,44,116,2004/2005
"Delk,Tony",246,591,.416,72,202,.356,174,389,.447,103,136,.757,28,102,130,104,47,54,3,123,667,2004/2005
"Deng,Luol",280,645,.434,31,117,.265,249,528,.472,120,162,.741,92,230,322,135,48,118,27,98,711,2004/2005
"Diaw,Boris",124,294,.422,9,50,.180,115,244,.471,57,77,.740,54,116,170,149,37,87,18,123,314,2004/2005
"Dickau,Dan",306,756,.405,85,245,.347,221,511,.432,190,228,.833,34,146,180,347,76,145,4,201,887,2004/2005
"Dickau,Dan",1,8,.125,1,3,.333,0,5,.000,2,3,.667,0,1,1,1,0,1,0,1,5,2004/2005
"Dickau,Dan",305,748,.408,84,242,.347,221,506,.437,188,225,.836,34,145,179,346,76,144,4,200,882,2004/2005
"Dickens,Kaniel",4,14,.286,3,9,.333,1,5,.200,2,2,1.000,3,6,9,1,2,2,1,5,13,2004/2005
"Diop,DeSagana",20,69,.290,0,2,.000,20,67,.299,0,5,.000,30,40,70,15,8,12,27,53,40,2004/2005
"Divac,Vlade",13,31,.419,0,0,,13,31,.419,8,12,.667,18,14,32,19,4,14,1,25,34,2004/2005
"Dixon,Juan",186,447,.416,48,147,.327,138,300,.460,87,97,.897,32,87,119,111,43,68,4,98,507,2004/2005
"Doleac,Michael",148,331,.447,0,2,.000,148,329,.450,25,41,.610,74,185,259,47,23,36,22,160,321,2004/2005
"Dooling,Keyon",139,345,.403,19,75,.253,120,270,.444,85,109,.780,11,79,90,132,39,65,11,120,382,2004/2005
"Drobnjak,Predrag",238,543,.438,25,71,.352,213,472,.451,96,120,.800,73,165,238,49,42,78,24,138,597,2004/2005
"Duhon,Chris",172,488,.352,94,265,.355,78,223,.350,49,67,.731,23,190,213,398,82,119,3,205,487,2004/2005
"Duncan,Tim",517,1042,.496,3,9,.333,514,1033,.498,305,455,.670,202,530,732,179,45,127,174,144,1342,2004/2005
"Dunleavy,Mike",408,905,.451,107,276,.388,301,629,.479,134,172,.779,97,338,435,203,79,132,26,198,1057,2004/2005
"Dupree,Ronald",61,127,.480,1,2,.500,60,125,.480,29,47,.617,34,61,95,24,7,22,10,60,152,2004/2005
"Ebi,Ndudi",11,21,.524,0,1,.000,11,20,.550,5,9,.556,6,10,16,1,1,3,1,7,27,2004/2005
"Edwards,Corsley",10,31,.323,0,0,,10,31,.323,7,12,.583,12,13,25,3,3,2,4,19,27,2004/2005
"Edwards,John",11,30,.367,0,0,,11,30,.367,7,14,.500,8,11,19,3,3,8,4,12,29,2004/2005
"Eisley,Howard",161,405,.398,27,103,.262,134,302,.444,66,83,.795,15,75,90,250,45,111,9,156,415,2004/2005
"Ekezie,Obinna",79,182,.434,0,1,.000,79,181,.436,72,93,.774,69,110,179,11,22,45,12,129,230,2004/2005
"Elson,Francisco",101,216,.468,1,3,.333,100,213,.469,45,79,.570,61,140,201,34,34,40,41,129,248,2004/2005
"Ely,Melvin",227,526,.432,0,0,,227,526,.432,122,212,.575,142,184,326,76,32,115,69,199,576,2004/2005
"Emmett,Andre",2,6,.333,0,0,,2,6,.333,3,5,.600,0,2,2,0,0,1,0,4,7,2004/2005
"Evans,Maurice",165,373,.442,27,82,.329,138,291,.474,59,78,.756,88,113,201,45,37,34,8,104,416,2004/2005
"Evans,Reggie",131,275,.476,0,2,.000,131,273,.480,125,234,.534,254,482,736,58,58,104,15,202,387,2004/2005
"Finley,Michael",387,907,.427,116,285,.407,271,622,.436,113,136,.831,45,217,262,169,48,60,18,123,1003,2004/2005
"Fisher,Derek",297,755,.393,108,291,.371,189,464,.407,175,203,.862,38,180,218,301,76,129,4,176,877,2004/2005
"Fizer,Marcus",133,292,.455,0,6,.000,133,286,.465,70,103,.680,29,146,175,64,25,63,13,96,336,2004/2005
"Flores,Luis",14,29,.483,5,10,.500,9,19,.474,2,2,1.000,1,2,3,11,2,11,0,9,35,2004/2005
"Flores,Luis",13,27,.481,4,9,.444,9,18,.500,2,2,1.000,0,2,2,11,2,11,0,9,32,2004/2005
"Flores,Luis",1,2,.500,1,1,1.000,0,1,.000,0,0,,1,0,1,0,0,0,0,0,3,2004/2005
"Fortson,Danny",118,226,.522,0,0,,118,226,.522,227,258,.880,157,191,348,8,15,91,7,265,463,2004/2005
"Foster,Jeff",168,324,.519,0,5,.000,168,319,.527,90,142,.634,205,345,550,43,46,55,12,186,426,2004/2005
"Fowlkes,Tremaine",9,17,.529,1,3,.333,8,14,.571,0,2,.000,3,5,8,0,2,5,0,7,19,2004/2005
"Foyle,Adonal",156,311,.502,0,0,,156,311,.502,40,72,.556,165,264,429,56,26,58,159,201,352,2004/2005
"Frahm,Richie",56,140,.400,31,80,.388,25,60,.417,21,25,.840,17,44,61,30,15,14,4,35,164,2004/2005
"Francis,Steve",563,1330,.423,38,127,.299,525,1203,.436,499,606,.823,126,324,450,547,112,317,28,273,1663,2004/2005
"Freije,Matt",37,127,.291,14,54,.259,23,73,.315,5,8,.625,16,45,61,20,13,17,2,40,93,2004/2005
"Funderburke,Lawrence",3,6,.500,0,0,,3,6,.500,3,5,.600,1,2,3,0,0,0,0,2,9,2004/2005
"Gadzuric,Dan",243,451,.539,0,0,,243,451,.539,107,199,.538,261,413,674,30,47,81,106,224,593,2004/2005
"Gaines,Reece",17,50,.340,4,14,.286,13,36,.361,3,4,.750,1,13,14,7,5,7,1,17,41,2004/2005
"Gaines,Reece",10,27,.370,3,12,.250,7,15,.467,3,4,.750,0,11,11,3,3,4,0,12,26,2004/2005
"Gaines,Reece",7,23,.304,1,2,.500,6,21,.286,0,0,,1,2,3,4,2,3,1,5,15,2004/2005
"Garcia,Alex",18,52,.346,5,18,.278,13,34,.382,3,4,.750,7,8,15,18,4,8,1,15,44,2004/2005
"Garnett,Kevin",683,1360,.502,6,25,.240,677,1335,.507,445,549,.811,247,861,1108,466,121,222,112,207,1817,2004/2005
"Garrity,Pat",123,306,.402,49,147,.333,74,159,.465,29,33,.879,21,103,124,30,19,30,9,107,324,2004/2005
"Gasol,Pau",357,695,.514,1,6,.167,356,689,.517,282,367,.768,130,280,410,135,37,137,93,146,997,2004/2005
"George,Devean",37,104,.356,21,58,.362,16,46,.348,15,20,.750,13,40,53,14,8,12,2,32,110,2004/2005
"Gill,Eddie",81,242,.335,36,117,.308,45,125,.360,71,81,.877,16,96,112,83,59,60,5,105,269,2004/2005
"Gill,Kendall",32,80,.400,3,9,.333,29,71,.408,18,20,.900,11,26,37,27,14,9,4,37,85,2004/2005
"Ginóbili,Manu",367,780,.471,97,258,.376,270,522,.517,355,442,.803,75,254,329,288,119,172,27,190,1186,2004/2005
"Giriček,Gordan",283,632,.448,38,105,.362,245,527,.465,111,137,.810,25,157,182,137,46,90,11,155,715,2004/2005
"Glover,Dion",8,22,.364,1,8,.125,7,14,.500,8,10,.800,3,8,11,4,3,2,3,9,25,2004/2005
"Goldwire,Anthony",57,136,.419,32,80,.400,25,56,.446,26,31,.839,10,49,59,78,15,15,0,32,172,2004/2005
"Goldwire,Anthony",4,15,.267,3,9,.333,1,6,.167,7,8,.875,1,7,8,0,0,1,0,5,18,2004/2005
"Goldwire,Anthony",53,121,.438,29,71,.408,24,50,.480,19,23,.826,9,42,51,78,15,14,0,27,154,2004/2005
"Gooden,Drew",464,943,.492,5,28,.179,459,915,.502,251,310,.810,207,546,753,130,77,133,76,233,1184,2004/2005
"Gordon,Ben",434,1056,.411,134,331,.405,300,725,.414,233,270,.863,55,160,215,164,53,186,10,224,1235,2004/2005
"Grant,Brian",103,209,.493,0,0,,103,209,.493,57,79,.722,101,156,257,34,23,43,23,175,263,2004/2005
"Green,Willie",155,423,.366,30,105,.286,125,318,.393,97,125,.776,22,111,133,100,34,75,6,121,437,2004/2005
"Griffin,Adrian",58,161,.360,2,9,.222,56,152,.368,33,44,.750,52,94,146,53,43,30,4,78,151,2004/2005
"Griffin,Eddie",202,522,.387,67,204,.328,135,318,.425,56,78,.718,128,325,453,53,23,55,118,120,527,2004/2005
"Gugliotta,Tom",99,241,.411,8,26,.308,91,215,.423,33,43,.767,56,135,191,68,41,57,17,104,239,2004/2005
"Gugliotta,Tom",11,37,.297,0,0,,11,37,.297,4,6,.667,15,28,43,12,9,9,4,23,26,2004/2005
"Gugliotta,Tom",88,204,.431,8,26,.308,80,178,.449,29,37,.784,41,107,148,56,32,48,13,81,213,2004/2005
"Haislip,Marcus",13,38,.342,0,1,.000,13,37,.351,6,11,.545,5,10,15,3,2,6,2,15,32,2004/2005
"Ham,Darvin",17,37,.459,0,0,,17,37,.459,12,31,.387,19,16,35,5,6,8,7,39,46,2004/2005
"Hamilton,Richard",510,1160,.440,36,118,.305,474,1042,.455,368,429,.858,74,221,295,372,77,217,13,232,1424,2004/2005
"Hamilton,Zendon",11,32,.344,0,0,,11,32,.344,29,48,.604,18,24,42,6,5,12,2,26,51,2004/2005
"Handlogten,Ben",43,83,.518,0,1,.000,43,82,.524,9,17,.529,23,42,65,13,7,18,5,55,95,2004/2005
"Hardaway,Anfernee",110,260,.423,15,50,.300,95,210,.452,34,46,.739,19,70,89,74,28,50,3,79,269,2004/2005
"Harpring,Matt",418,855,.489,9,43,.209,409,812,.504,245,315,.778,196,284,480,142,70,133,16,250,1090,2004/2005
"Harrington,Al",453,986,.459,16,74,.216,437,912,.479,236,351,.672,145,316,461,208,85,204,16,249,1158,2004/2005
"Harrington,Junior",64,178,.360,6,19,.316,58,159,.365,29,35,.829,13,50,63,62,25,41,5,72,163,2004/2005
"Harrington,Othella",217,424,.512,0,0,,217,424,.512,127,177,.718,106,186,292,56,24,84,18,188,561,2004/2005
"Harris,Devin",157,366,.429,44,131,.336,113,235,.481,78,103,.757,28,74,102,169,77,82,19,139,436,2004/2005
"Harris,Lucious",118,299,.395,21,65,.323,97,234,.415,56,69,.812,39,82,121,49,27,29,6,68,313,2004/2005
"Harrison,David",106,184,.576,0,0,,106,184,.576,52,91,.571,48,87,135,13,16,53,55,134,264,2004/2005
"Hart,Jason",257,573,.449,35,95,.368,222,478,.464,157,200,.785,18,185,203,367,99,102,14,167,706,2004/2005
"Harvey,Donnell",2,2,1.000,0,0,,2,2,1.000,4,4,1.000,2,5,7,1,1,1,1,2,8,2004/2005
"Haslem,Udonis",346,641,.540,0,4,.000,346,637,.543,178,225,.791,239,487,726,108,63,113,41,260,870,2004/2005
"Hassell,Trenton",225,475,.474,1,11,.091,224,464,.483,90,114,.789,80,139,219,128,30,64,30,200,541,2004/2005
"Hayes,Jarvis",206,530,.389,42,123,.341,164,407,.403,99,118,.839,41,186,227,90,49,62,9,107,553,2004/2005
"Haywood,Brendan",239,427,.560,0,0,,239,427,.560,159,261,.609,202,262,464,57,52,96,114,218,637,2004/2005
"Henderson,Alan",116,220,.527,0,2,.000,116,218,.532,41,76,.539,164,184,348,21,29,49,37,149,273,2004/2005
"Hilário,Nenê",194,386,.503,0,2,.000,194,384,.505,140,212,.660,104,221,325,84,50,94,48,167,528,2004/2005
"Hill,Grant",517,1015,.509,3,13,.231,514,1002,.513,280,341,.821,77,241,318,220,97,161,28,144,1317,2004/2005
"Hinrich,Kirk",445,1122,.397,145,408,.355,300,714,.420,171,216,.792,32,272,304,494,122,176,21,244,1206,2004/2005
"Hoiberg,Fred",139,284,.489,70,145,.483,69,139,.496,89,102,.873,32,149,181,85,50,20,15,105,437,2004/2005
"Horry,Robert",157,375,.419,51,138,.370,106,237,.447,86,109,.789,91,177,268,80,67,69,60,138,451,2004/2005
"House,Eddie",165,366,.451,44,97,.454,121,269,.450,23,27,.852,16,67,83,96,44,35,6,65,397,2004/2005
"House,Eddie",61,135,.452,12,29,.414,49,106,.462,10,13,.769,2,17,19,24,24,13,3,23,144,2004/2005
"House,Eddie",6,17,.353,4,6,.667,2,11,.182,0,0,,0,3,3,5,2,0,0,3,16,2004/2005
"House,Eddie",98,214,.458,28,62,.452,70,152,.461,13,14,.929,14,47,61,67,18,22,3,39,237,2004/2005
"Houston,Allan",85,205,.415,31,80,.388,54,125,.432,36,43,.837,4,19,23,42,8,21,2,40,237,2004/2005
"Howard,Dwight",352,677,.520,0,2,.000,352,675,.521,277,413,.671,287,536,823,75,77,165,136,232,981,2004/2005
"Howard,Josh",377,793,.475,34,115,.296,343,678,.506,170,232,.733,169,315,484,109,116,122,49,211,958,2004/2005
"Howard,Juwan",244,541,.451,0,1,.000,244,540,.452,97,115,.843,126,220,346,94,32,79,5,143,585,2004/2005
"Hudson,Troy",266,664,.401,89,258,.345,177,406,.436,70,90,.778,19,86,105,283,27,113,6,121,691,2004/2005
"Hughes,Larry",467,1086,.430,59,209,.282,408,877,.465,352,453,.777,74,308,382,285,176,153,18,168,1345,2004/2005
"Humphrey,Ryan",42,103,.408,0,2,.000,42,101,.416,18,37,.486,50,37,87,6,10,23,1,35,102,2004/2005
"Humphries,Kris",116,287,.404,2,6,.333,114,281,.406,44,101,.436,73,124,197,43,25,52,18,96,278,2004/2005
"Hunter,Brandon",37,73,.507,0,0,,37,73,.507,21,39,.538,25,44,69,3,4,22,7,42,95,2004/2005
"Hunter,Lindsey",108,302,.358,23,84,.274,85,218,.390,46,58,.793,38,85,123,130,68,68,13,125,285,2004/2005
"Hunter,Steven",135,220,.614,0,1,.000,135,219,.616,78,163,.479,98,129,227,13,4,44,102,131,348,2004/2005
"Iguodala,Andre",269,546,.493,47,142,.331,222,404,.550,156,210,.743,89,375,464,246,138,139,48,204,741,2004/2005
"Ilgauskas,Zydrunas",458,979,.468,2,7,.286,456,972,.469,402,503,.799,299,373,672,100,53,191,165,313,1320,2004/2005
"Ilunga-Mbenga,Didier",6,14,.429,0,0,,6,14,.429,3,4,.750,3,5,8,0,0,5,5,13,15,2004/2005
"Iverson,Allen",771,1818,.424,104,338,.308,667,1480,.451,656,786,.835,51,248,299,596,180,344,9,140,2302,2004/2005
"Ivey,Royal",85,198,.429,3,9,.333,82,189,.434,47,67,.701,19,65,84,103,39,58,7,140,220,2004/2005
"Jackson,Bobby",109,255,.427,33,96,.344,76,159,.478,50,58,.862,23,62,85,59,14,28,2,58,301,2004/2005
"Jackson,Jermaine",17,33,.515,0,2,.000,17,31,.548,8,13,.615,3,20,23,24,7,10,1,26,42,2004/2005
"Jackson,Jim",248,582,.426,122,295,.414,126,287,.439,54,58,.931,33,236,269,183,35,115,5,153,672,2004/2005
"Jackson,Jim",118,283,.417,54,147,.367,64,136,.471,30,33,.909,10,105,115,86,23,56,1,67,320,2004/2005
"Jackson,Jim",130,299,.435,68,148,.459,62,151,.411,24,25,.960,23,131,154,97,12,59,4,86,352,2004/2005
"Jackson,Luke",10,27,.370,4,6,.667,6,21,.286,5,6,.833,2,4,6,3,0,2,0,4,29,2004/2005
"Jackson,Marc",340,731,.465,0,2,.000,340,729,.466,289,349,.828,184,222,406,81,32,131,18,171,969,2004/2005
"Jackson,Stephen",330,819,.403,103,286,.360,227,533,.426,190,229,.830,44,206,250,119,64,123,14,154,953,2004/2005
"Jacobsen,Casey",165,408,.404,66,177,.373,99,231,.429,151,192,.786,35,132,167,113,33,71,8,104,547,2004/2005
"Jacobsen,Casey",65,157,.414,34,89,.382,31,68,.456,48,62,.774,17,50,67,37,11,27,1,56,212,2004/2005
"Jacobsen,Casey",100,251,.398,32,88,.364,68,163,.417,103,130,.792,18,82,100,76,22,44,7,48,335,2004/2005
"James,Jerome",174,342,.509,0,2,.000,174,340,.512,47,65,.723,81,160,241,19,23,88,111,279,395,2004/2005
"James,LeBron",795,1684,.472,108,308,.351,687,1376,.499,477,636,.750,111,477,588,577,177,262,52,146,2175,2004/2005
"James,Mike",331,751,.441,100,259,.386,231,492,.470,109,145,.752,35,173,208,263,65,106,6,174,871,2004/2005
"James,Mike",205,460,.446,58,152,.382,147,308,.477,67,90,.744,23,99,122,185,40,80,4,114,535,2004/2005
"James,Mike",126,291,.433,42,107,.393,84,184,.457,42,55,.764,12,74,86,78,25,26,2,60,336,2004/2005
"Jamison,Antawn",519,1189,.437,71,208,.341,448,981,.457,225,296,.760,160,359,519,154,55,118,16,151,1334,2004/2005
"Jarić,Marko",189,457,.414,56,151,.371,133,306,.435,59,82,.720,20,141,161,303,84,98,17,107,493,2004/2005
"Jefferson,Al",195,369,.528,0,3,.000,195,366,.533,85,135,.630,119,193,312,24,22,66,55,195,475,2004/2005
"Jefferson,Richard",238,564,.422,30,89,.337,208,475,.438,227,269,.844,49,191,240,133,33,132,17,109,733,2004/2005
"Jeffries,Jared",203,434,.468,16,51,.314,187,383,.488,101,173,.584,152,222,374,151,66,114,35,206,523,2004/2005
"Jenkins,Horace",15,45,.333,0,9,.000,15,36,.417,12,13,.923,3,6,9,9,5,7,1,6,42,2004/2005
"Johnsen,Britton",6,22,.273,0,4,.000,6,18,.333,0,0,,5,5,10,4,1,3,0,10,12,2004/2005
"Johnson,Anthony",203,456,.445,41,108,.380,162,348,.466,85,113,.752,32,147,179,302,59,96,15,144,532,2004/2005
"Johnson,DerMarr",185,371,.499,53,148,.358,132,223,.592,80,101,.792,43,108,151,75,43,65,18,140,503,2004/2005
"Johnson,Ervin",28,54,.519,1,1,1.000,27,53,.509,16,25,.640,43,70,113,6,7,18,13,86,73,2004/2005
"Johnson,Joe",544,1179,.461,177,370,.478,367,809,.454,135,180,.750,120,302,422,291,79,148,24,167,1400,2004/2005
"Johnson,Linton",0,2,.000,0,1,.000,0,1,.000,0,0,,0,3,3,0,1,1,0,1,0,2004/2005
"Jones,Dahntay",83,190,.437,23,60,.383,60,130,.462,44,64,.688,11,58,69,21,13,29,11,81,233,2004/2005
"Jones,Damon",331,726,.456,225,521,.432,106,205,.517,68,86,.791,14,217,231,350,44,98,5,121,955,2004/2005
"Jones,Eddie",351,820,.428,142,382,.372,209,438,.477,174,216,.806,38,367,405,212,86,99,38,251,1018,2004/2005
"Jones,Fred",275,647,.425,87,229,.380,188,418,.450,176,207,.850,34,208,242,196,61,114,31,171,813,2004/2005
"Jones,James",126,318,.396,66,166,.398,60,152,.395,53,62,.855,39,135,174,57,31,43,28,123,371,2004/2005
"Jones,Jumaine",210,486,.432,102,261,.391,108,225,.480,55,75,.733,107,291,398,65,44,49,24,165,577,2004/2005
"Jones,Mark",9,31,.290,0,4,.000,9,27,.333,5,10,.500,6,7,13,6,5,3,2,16,23,2004/2005
"Kaman,Chris",246,495,.497,0,1,.000,246,494,.498,80,121,.661,135,288,423,73,26,115,68,182,572,2004/2005
"Kapono,Jason",269,671,.401,80,194,.412,189,477,.396,70,85,.824,32,132,164,61,40,46,6,132,688,2004/2005
"Kasun,Mario",47,98,.480,0,1,.000,47,97,.485,24,43,.558,52,76,128,8,8,26,13,86,118,2004/2005
"Khryapa,Viktor",54,124,.435,4,11,.364,50,113,.442,23,42,.548,28,80,108,25,20,33,18,80,135,2004/2005
"Kidd,Jason",340,855,.398,129,358,.360,211,497,.425,142,192,.740,94,394,488,545,123,167,9,110,951,2004/2005
"Kirilenko,Andrei",207,420,.493,23,77,.299,184,343,.536,203,259,.784,89,166,255,132,67,90,136,101,640,2004/2005
"Kittles,Kerry",28,73,.384,7,21,.333,21,52,.404,6,10,.600,1,31,32,20,8,7,3,12,69,2004/2005
"Knight,Brandin",0,1,.000,0,0,,0,1,.000,0,0,,0,0,0,1,0,0,0,0,0,2004/2005
"Knight,Brevin",248,587,.422,3,20,.150,245,567,.432,167,196,.852,21,149,170,591,131,147,5,192,666,2004/2005
"Korver,Kyle",317,759,.418,226,558,.405,91,201,.453,82,96,.854,40,339,379,182,103,106,33,265,942,2004/2005
"Krstić,Nenad",281,570,.493,0,2,.000,281,568,.495,185,255,.725,161,240,401,77,32,112,63,280,747,2004/2005
"Kukoč,Toni",105,256,.410,42,116,.362,63,140,.450,44,61,.721,31,129,160,160,39,64,13,70,296,2004/2005
"Kutluay,Ibo",0,1,.000,0,0,,0,1,.000,0,0,,0,1,1,0,0,2,0,1,0,2004/2005
"Laettner,Christian",107,184,.582,1,7,.143,106,177,.599,45,59,.763,36,95,131,41,32,29,15,78,260,2004/2005
"LaFrentz,Raef",341,688,.496,82,225,.364,259,463,.559,120,148,.811,154,399,553,98,42,70,99,262,884,2004/2005
"Lampe,Maciej",49,132,.371,2,4,.500,47,128,.367,15,22,.682,24,65,89,11,5,17,7,51,115,2004/2005
"Lampe,Maciej",17,49,.347,2,3,.667,15,46,.326,8,12,.667,9,23,32,1,1,10,2,20,44,2004/2005
"Lampe,Maciej",32,83,.386,0,1,.000,32,82,.390,7,10,.700,15,42,57,10,4,7,5,31,71,2004/2005
"Lenard,Voshon",10,26,.385,4,12,.333,6,14,.429,5,8,.625,0,6,6,6,1,2,0,2,29,2004/2005
"Lewis,Rashard",532,1151,.462,173,432,.400,359,719,.499,220,283,.777,110,278,388,94,75,123,62,158,1457,2004/2005
"Livingston,Randy",22,52,.423,5,8,.625,17,44,.386,15,17,.882,3,9,12,45,12,14,2,28,64,2004/2005
"Livingston,Shaun",89,215,.414,0,2,.000,89,213,.418,44,59,.746,22,67,89,151,32,75,11,82,222,2004/2005
"López,Raül",57,135,.422,20,45,.444,37,90,.411,27,33,.818,7,32,39,123,22,47,3,78,161,2004/2005
"Lue,Tyronn",295,654,.451,55,155,.355,240,499,.481,142,165,.861,14,135,149,322,33,105,0,168,787,2004/2005
"Lue,Tyronn",48,122,.393,15,45,.333,33,77,.429,14,18,.778,0,40,40,58,8,24,0,48,125,2004/2005
"Lue,Tyronn",247,532,.464,40,110,.364,207,422,.491,128,147,.871,14,95,109,264,25,81,0,120,662,2004/2005
"Lynch,George",68,189,.360,11,37,.297,57,152,.375,17,23,.739,55,119,174,88,32,57,12,83,164,2004/2005
"Madsen,Mark",34,66,.515,0,0,,34,66,.515,20,40,.500,63,65,128,18,7,24,14,103,88,2004/2005
"Maggette,Corey",425,986,.431,51,168,.304,374,818,.457,563,657,.857,70,324,394,225,70,195,8,191,1464,2004/2005
"Magloire,Jamaal",98,227,.432,0,0,,98,227,.432,74,123,.602,79,126,205,29,8,59,23,74,270,2004/2005
"Marbury,Stephon",604,1308,.462,115,325,.354,489,983,.497,458,549,.834,50,198,248,668,122,233,6,186,1781,2004/2005
"Marion,Shawn",613,1289,.476,114,341,.334,499,948,.526,229,275,.833,235,680,915,154,163,125,119,199,1569,2004/2005
"Marks,Sean",27,80,.338,0,3,.000,27,77,.351,22,28,.786,18,38,56,8,3,14,11,29,76,2004/2005
"Marshall,Donyell",262,592,.443,151,363,.416,111,229,.485,72,91,.791,95,333,428,81,57,42,46,136,747,2004/2005
"Martin,Darrick",16,50,.320,5,18,.278,11,32,.344,5,8,.625,3,7,10,28,6,6,0,19,42,2004/2005
"Martin,Kenyon",444,907,.490,0,12,.000,444,895,.496,199,308,.646,146,365,511,170,100,149,78,228,1087,2004/2005
"Martin,Kevin",45,117,.385,5,25,.200,40,92,.435,36,55,.655,29,29,58,22,16,24,3,35,131,2004/2005
"Mason,Desmond",478,1079,.443,1,8,.125,477,1071,.445,420,524,.802,85,227,312,217,58,164,27,198,1377,2004/2005
"Massenburg,Tony",74,182,.407,0,0,,74,182,.407,48,63,.762,54,109,163,14,18,40,20,122,196,2004/2005
"McCarty,Walter",95,235,.404,55,155,.355,40,80,.500,15,29,.517,29,109,138,37,25,36,15,144,260,2004/2005
"McCarty,Walter",62,150,.413,30,90,.333,32,60,.533,8,15,.533,21,56,77,26,15,17,9,85,162,2004/2005
"McCarty,Walter",33,85,.388,25,65,.385,8,20,.400,7,14,.500,8,53,61,11,10,19,6,59,98,2004/2005
"McCoy,Jelani",7,13,.538,0,0,,7,13,.538,1,5,.200,7,14,21,0,3,6,8,24,15,2004/2005
"McDyess,Antonio",307,598,.513,0,1,.000,307,597,.514,126,192,.656,177,305,482,71,46,93,52,204,740,2004/2005
"McGrady,Tracy",715,1660,.431,142,435,.326,573,1225,.468,431,557,.774,71,413,484,448,135,201,52,167,2003,2004/2005
"McInnis,Jeff",377,915,.412,91,264,.345,286,651,.439,130,160,.813,32,125,157,391,56,117,1,177,975,2004/2005
"McKie,Aaron",61,142,.430,20,62,.323,41,80,.513,10,16,.625,20,152,172,103,48,31,17,116,152,2004/2005
"McLeod,Keith",143,408,.350,18,72,.250,125,336,.372,112,146,.767,20,93,113,236,63,99,12,138,416,2004/2005
"Medvedenko,Stanislav",71,156,.455,0,1,.000,71,155,.458,23,28,.821,31,48,79,13,9,13,2,64,165,2004/2005
"Mercer,Ron",65,158,.411,0,3,.000,65,155,.419,7,10,.700,9,31,40,20,16,14,2,20,137,2004/2005
"Mihm,Chris",280,552,.507,0,2,.000,280,550,.509,175,258,.678,197,305,502,50,14,110,108,237,735,2004/2005
"Miles,Darius",336,697,.482,8,23,.348,328,674,.487,129,215,.600,71,228,299,129,75,157,78,189,809,2004/2005
"Miličić,Darko",25,76,.329,0,0,,25,76,.329,17,24,.708,3,40,43,7,2,16,17,31,67,2004/2005
"Miller,Andre",427,895,.477,6,39,.154,421,856,.492,253,302,.838,100,238,338,569,121,220,8,204,1113,2004/2005
"Miller,Anthony",2,3,.667,0,0,,2,3,.667,0,0,,0,1,1,1,1,1,0,2,4,2004/2005
"Miller,Brad",319,609,.524,5,19,.263,314,590,.532,233,287,.812,139,382,521,220,69,82,68,181,876,2004/2005
"Miller,Mike",387,766,.505,140,323,.433,247,443,.558,108,150,.720,36,264,300,220,54,127,23,197,1022,2004/2005
"Miller,Reggie",314,719,.437,96,298,.322,218,421,.518,250,268,.933,18,138,156,146,50,77,5,109,974,2004/2005
"Ming,Yao",538,975,.552,0,0,,538,975,.552,389,497,.783,208,461,669,61,34,196,160,298,1465,2004/2005
"Mobley,Cuttino",408,932,.438,150,342,.439,258,590,.437,168,205,.820,45,184,229,188,74,133,30,152,1134,2004/2005
"Mobley,Cuttino",128,296,.432,58,125,.464,70,171,.409,55,69,.797,11,52,63,42,23,41,9,49,369,2004/2005
"Mobley,Cuttino",280,636,.440,92,217,.424,188,419,.449,113,136,.831,34,132,166,146,51,92,21,103,765,2004/2005
"Mohammed,Nazr",289,602,.480,0,1,.000,289,601,.481,153,227,.674,247,339,586,34,58,108,86,236,731,2004/2005
"Mohammed,Nazr",234,460,.509,0,1,.000,234,459,.510,121,171,.708,169,270,439,26,53,81,53,172,589,2004/2005
"Mohammed,Nazr",55,142,.387,0,0,,55,142,.387,32,56,.571,78,69,147,8,5,27,33,64,142,2004/2005
"Moïso,Jérôme",9,18,.500,0,1,.000,9,17,.529,10,13,.769,10,27,37,1,3,7,6,13,28,2004/2005
"Moïso,Jérôme",3,9,.333,0,1,.000,3,8,.375,8,9,.889,6,17,23,0,2,6,3,7,14,2004/2005
"Moïso,Jérôme",3,4,.750,0,0,,3,4,.750,2,4,.500,3,4,7,0,0,1,1,2,8,2004/2005
"Moïso,Jérôme",3,5,.600,0,0,,3,5,.600,0,0,,1,6,7,1,1,0,2,4,6,2004/2005
"Moore,Mikki",144,287,.502,1,5,.200,143,282,.507,107,136,.787,97,149,246,47,19,63,32,173,396,2004/2005
"Mourning,Alonzo",100,212,.472,0,0,,100,212,.472,82,141,.582,53,145,198,18,8,57,74,82,282,2004/2005
"Mourning,Alonzo",68,150,.453,0,0,,68,150,.453,51,86,.593,31,96,127,14,5,45,41,50,187,2004/2005
"Mourning,Alonzo",32,62,.516,0,0,,32,62,.516,31,55,.564,22,49,71,4,3,12,33,32,95,2004/2005
"Murphy,Troy",392,947,.414,59,148,.399,333,799,.417,233,319,.730,251,505,756,97,53,108,33,190,1076,2004/2005
"Murray,Lamond",132,310,.426,46,105,.438,86,205,.420,61,80,.763,44,120,164,47,32,54,16,85,371,2004/2005
"Murray,Ronald",131,363,.361,24,95,.253,107,268,.399,59,80,.738,15,83,98,65,30,57,11,59,345,2004/2005
"Mutombo,Dikembe",108,217,.498,0,0,,108,217,.498,106,143,.741,150,276,426,10,16,51,101,135,322,2004/2005
"N'Diaye,Mamadou",8,20,.400,0,1,.000,8,19,.421,4,7,.571,9,9,18,1,1,0,5,20,20,2004/2005
"Nachbar,Boštjan",161,411,.392,75,196,.383,86,215,.400,97,117,.829,24,158,182,74,29,73,16,183,494,2004/2005
"Nachbar,Boštjan",15,43,.349,10,21,.476,5,22,.227,9,12,.750,4,26,30,9,1,5,0,30,49,2004/2005
"Nachbar,Boštjan",146,368,.397,65,175,.371,81,193,.420,88,105,.838,20,132,152,65,28,68,16,153,445,2004/2005
"Nailon,Lee",415,869,.478,0,2,.000,415,867,.479,133,165,.806,128,170,298,109,36,110,16,190,963,2004/2005
"Nájera,Eduardo",145,322,.450,6,21,.286,139,301,.462,58,91,.637,102,141,243,65,41,61,24,148,354,2004/2005
"Nájera,Eduardo",70,172,.407,6,15,.400,64,157,.408,29,45,.644,53,65,118,37,18,32,10,71,175,2004/2005
"Nájera,Eduardo",75,150,.500,0,6,.000,75,144,.521,29,46,.630,49,76,125,28,23,29,14,77,179,2004/2005
"Nash,Steve",430,857,.502,94,218,.431,336,639,.526,211,238,.887,57,192,249,861,74,245,6,136,1165,2004/2005
"Nelson,Jameer",286,628,.455,44,141,.312,242,487,.497,73,107,.682,52,141,193,237,78,117,3,199,689,2004/2005
"Nesterović,Rasho",198,430,.460,0,0,,198,430,.460,14,30,.467,184,275,459,71,31,73,117,207,410,2004/2005
"Newble,Ira",182,424,.429,19,53,.358,163,371,.439,55,69,.797,78,142,220,91,50,61,18,144,438,2004/2005
"Nocioni,Andrés",241,601,.401,25,97,.258,216,504,.429,170,222,.766,69,317,386,122,37,135,34,208,677,2004/2005
"Norris,Moochie",35,109,.321,0,12,.000,35,97,.361,20,24,.833,10,36,46,39,18,27,2,44,90,2004/2005
"Norris,Moochie",32,93,.344,0,12,.000,32,81,.395,18,22,.818,9,33,42,34,17,25,2,42,82,2004/2005
"Norris,Moochie",3,16,.188,0,0,,3,16,.188,2,2,1.000,1,3,4,5,1,2,0,2,8,2004/2005
"Nowitzki,Dirk",663,1445,.459,91,228,.399,572,1217,.470,615,708,.869,96,661,757,240,97,176,119,219,2032,2004/2005
"O'Neal,Jermaine",386,854,.452,1,6,.167,385,848,.454,295,391,.754,85,303,388,82,25,131,88,173,1068,2004/2005
"O'Neal,Shaquille",658,1095,.601,0,0,,658,1095,.601,353,765,.461,253,507,760,200,36,203,171,262,1669,2004/2005
"Odom,Lamar",366,774,.473,36,117,.308,330,657,.502,207,298,.695,134,519,653,238,42,161,65,211,975,2004/2005
"Okafor,Emeka",448,1003,.447,0,1,.000,448,1002,.447,209,343,.609,275,520,795,64,62,125,125,214,1105,2004/2005
"Okur,Mehmet",354,756,.468,17,63,.270,337,693,.486,329,387,.850,194,422,616,166,32,141,68,227,1054,2004/2005
"Ollie,Kevin",11,31,.355,0,0,,11,31,.355,6,9,.667,3,16,19,19,5,6,0,16,28,2004/2005
"Olowokandi,Michael",161,353,.456,0,0,,161,353,.456,46,69,.667,106,218,324,29,15,68,56,193,368,2004/2005
"Ostertag,Greg",37,84,.440,0,2,.000,37,82,.451,13,38,.342,55,112,167,37,7,24,40,88,87,2004/2005
"Outlaw,Bo",12,34,.353,0,0,,12,34,.353,5,9,.556,16,37,53,13,6,8,12,29,29,2004/2005
"Outlaw,Travis",133,267,.498,4,10,.400,129,257,.502,49,75,.653,40,81,121,35,30,39,40,77,319,2004/2005
"Pachulia,Zaza",160,354,.452,0,1,.000,160,353,.453,138,185,.746,131,247,378,60,44,70,34,166,458,2004/2005
"Padgett,Scott",98,233,.421,50,126,.397,48,107,.449,29,40,.725,47,138,185,55,33,30,10,119,275,2004/2005
"Palacio,Milt",175,392,.446,2,12,.167,173,380,.455,115,155,.742,26,108,134,279,48,104,13,126,467,2004/2005
"Pargo,Jannero",82,213,.385,23,66,.348,59,147,.401,17,23,.739,12,35,47,76,16,45,1,53,204,2004/2005
"Parker,Smush",18,43,.419,3,13,.231,15,30,.500,9,13,.692,4,8,12,15,5,19,0,16,48,2004/2005
"Parker,Smush",11,28,.393,2,9,.222,9,19,.474,9,13,.692,2,7,9,11,3,10,0,13,33,2004/2005
"Parker,Smush",7,15,.467,1,4,.250,6,11,.545,0,0,,2,1,3,4,2,9,0,3,15,2004/2005
"Parker,Tony",539,1118,.482,43,156,.276,496,962,.516,210,323,.650,47,251,298,491,98,215,4,167,1331,2004/2005
"Patterson,Ruben",319,601,.531,2,25,.080,317,576,.550,169,282,.599,126,147,273,138,106,143,21,164,809,2004/2005
"Pavlović,Sasha",120,276,.435,30,78,.385,90,198,.455,44,64,.688,15,56,71,49,29,47,4,121,314,2004/2005
"Payton,Gary",339,725,.468,42,129,.326,297,596,.498,153,201,.761,48,188,236,469,88,148,12,121,873,2004/2005
"Peeler,Anthony",56,150,.373,25,65,.385,31,85,.365,16,18,.889,14,51,65,57,18,28,2,39,153,2004/2005
"Penney,Kirk",1,3,.333,0,1,.000,1,2,.500,0,0,,0,1,1,1,0,2,0,0,2,2004/2005
"Perkins,Kendrick",56,119,.471,0,0,,56,119,.471,37,58,.638,53,123,176,21,9,43,37,98,149,2004/2005
"Person,Wesley",107,226,.473,41,89,.461,66,137,.482,9,13,.692,3,80,83,39,19,17,4,30,264,2004/2005
"Person,Wesley",25,57,.439,8,21,.381,17,36,.472,4,4,1.000,1,21,22,11,6,7,0,6,62,2004/2005
"Person,Wesley",82,169,.485,33,68,.485,49,101,.485,5,9,.556,2,59,61,28,13,10,4,24,202,2004/2005
"Peterson,Morris",356,848,.420,129,335,.385,227,513,.442,188,226,.832,71,269,340,169,91,93,18,219,1029,2004/2005
"Piatkowski,Eric",111,258,.430,57,134,.425,54,124,.435,45,56,.804,15,64,79,51,29,37,1,67,324,2004/2005
"Pierce,Paul",556,1223,.455,108,292,.370,448,931,.481,549,668,.822,78,461,539,348,133,230,39,255,1769,2004/2005
"Piétrus,Mickaël",214,501,.427,67,195,.344,147,306,.480,141,202,.698,65,124,189,82,46,92,18,139,636,2004/2005
"Planinić,Zoran",78,174,.448,15,40,.375,63,134,.470,46,66,.697,19,50,69,44,25,41,0,76,217,2004/2005
"Podkolzin,Pavel",0,0,,0,0,,0,0,,1,2,.500,0,2,2,0,0,2,0,4,1,2004/2005
"Pollard,Scot",79,167,.473,0,0,,79,167,.473,33,49,.673,85,120,205,18,30,31,24,123,191,2004/2005
"Pope,Mark",2,6,.333,0,0,,2,6,.333,0,0,,5,3,8,1,1,1,2,5,4,2004/2005
"Posey,James",127,356,.357,55,178,.309,72,178,.404,96,111,.865,45,174,219,88,48,69,23,134,405,2004/2005
"Potapenko,Vitaly",45,87,.517,0,1,.000,45,86,.523,27,31,.871,30,48,78,9,7,12,3,53,117,2004/2005
"Prince,Tayshaun",469,963,.487,47,138,.341,422,825,.512,221,274,.807,133,302,435,247,56,135,71,161,1206,2004/2005
"Profit,Laron",56,128,.438,8,28,.286,48,100,.480,16,25,.640,24,52,76,37,16,27,5,44,136,2004/2005
"Przybilla,Joel",199,333,.598,0,0,,199,333,.598,90,174,.517,178,410,588,74,24,98,163,239,488,2004/2005
"Radmanović,Vladimir",266,650,.409,128,329,.389,138,321,.430,81,103,.786,52,237,289,86,57,80,31,172,741,2004/2005
"Radojević,Aleksandar",6,19,.316,0,0,,6,19,.316,7,10,.700,9,19,28,6,0,15,2,32,19,2004/2005
"Ramos,Peter John",5,10,.500,0,0,,5,10,.500,1,2,.500,1,3,4,0,0,3,1,4,11,2004/2005
"Randolph,Zach",332,741,.448,0,6,.000,332,735,.452,207,254,.815,142,300,442,86,34,112,17,112,871,2004/2005
"Ratliff,Theo",115,257,.447,0,0,,115,257,.447,74,107,.692,111,220,331,34,23,56,158,183,304,2004/2005
"Rebrača,Željko",133,234,.568,0,0,,133,234,.568,73,85,.859,49,135,184,26,13,49,40,130,339,2004/2005
"Redd,Michael",625,1418,.441,104,293,.355,521,1125,.463,369,432,.854,72,240,312,172,63,133,8,152,1723,2004/2005
"Reed,Justin",15,29,.517,0,3,.000,15,26,.577,11,15,.733,8,8,16,10,3,5,1,12,41,2004/2005
"Reiner,Jared",10,30,.333,0,0,,10,30,.333,1,4,.250,13,25,38,1,3,9,7,35,21,2004/2005
"Richardson,Jason",610,1368,.446,125,370,.338,485,998,.486,214,309,.693,125,299,424,281,105,169,32,156,1559,2004/2005
"Richardson,Quentin",407,1045,.389,226,631,.358,181,414,.437,136,184,.739,91,388,479,158,96,102,27,197,1176,2004/2005
"Ridnour,Luke",299,739,.405,67,178,.376,232,561,.414,159,180,.883,55,149,204,483,94,149,23,185,824,2004/2005
"Robinson,Bernard",36,81,.444,3,8,.375,33,73,.452,18,26,.692,14,34,48,30,11,20,4,42,93,2004/2005
"Robinson,Clifford",202,523,.386,67,193,.347,135,330,.409,62,97,.639,54,155,209,104,62,66,53,181,533,2004/2005
"Robinson,Clifford",141,354,.398,42,127,.331,99,227,.436,35,58,.603,31,83,114,74,44,41,39,107,359,2004/2005
"Robinson,Clifford",61,169,.361,25,66,.379,36,103,.350,27,39,.692,23,72,95,30,18,25,14,74,174,2004/2005
"Robinson,Glenn",34,77,.442,2,6,.333,32,71,.451,20,23,.870,4,20,24,8,4,7,3,19,90,2004/2005
"Rogers,Rodney",172,450,.382,48,168,.286,124,282,.440,52,70,.743,61,185,246,86,41,86,20,172,444,2004/2005
"Rogers,Rodney",109,289,.377,25,92,.272,84,197,.426,32,42,.762,28,114,142,60,19,66,12,103,275,2004/2005
"Rogers,Rodney",63,161,.391,23,76,.303,40,85,.471,20,28,.714,33,71,104,26,22,20,8,69,169,2004/2005
"Rose,Jalen",527,1159,.455,108,274,.394,419,885,.473,333,390,.854,44,232,276,209,63,180,10,190,1495,2004/2005
"Rose,Malik",198,441,.449,1,10,.100,197,431,.457,137,186,.737,129,212,341,59,46,102,16,208,534,2004/2005
"Rose,Malik",124,267,.464,0,4,.000,124,263,.471,69,99,.697,95,132,227,41,31,56,9,124,317,2004/2005
"Rose,Malik",74,174,.425,1,6,.167,73,168,.435,68,87,.782,34,80,114,18,15,46,7,84,217,2004/2005
"Ross,Quinton",161,373,.432,1,4,.250,160,369,.434,74,110,.673,59,151,210,109,51,54,22,165,397,2004/2005
"Ruffin,Michael",41,99,.414,0,1,.000,41,98,.418,29,67,.433,157,175,332,64,43,44,41,193,111,2004/2005
"Rush,Kareem",157,406,.387,51,137,.372,106,269,.394,37,48,.771,20,69,89,68,20,47,7,74,402,2004/2005
"Rush,Kareem",4,20,.200,2,10,.200,2,10,.200,2,2,1.000,3,7,10,3,2,3,1,7,12,2004/2005
"Rush,Kareem",153,386,.396,49,127,.386,104,259,.402,35,46,.761,17,62,79,65,18,44,6,67,390,2004/2005
"Russell,Bryon",95,252,.377,56,149,.376,39,103,.379,61,77,.792,50,122,172,72,44,35,11,130,307,2004/2005
"Salmons,John",85,210,.405,31,91,.341,54,119,.454,35,48,.729,12,109,121,114,40,51,13,92,236,2004/2005
"Sampson,Jamal",28,62,.452,0,0,,28,62,.452,23,39,.590,36,86,122,8,4,17,17,53,79,2004/2005
"Santiago,Daniel",7,21,.333,0,0,,7,21,.333,8,11,.727,6,13,19,1,3,4,4,28,22,2004/2005
"Scalabrine,Brian",132,332,.398,22,68,.324,110,264,.417,53,69,.768,83,161,244,88,34,66,18,111,339,2004/2005
"Sesay,Ansu",17,42,.405,2,8,.250,15,34,.441,13,24,.542,18,20,38,12,2,8,3,16,49,2004/2005
"Seung-Jin,Ha",10,23,.435,0,0,,10,23,.435,6,11,.545,6,12,18,2,1,12,5,21,26,2004/2005
"Shirley,Paul",5,11,.455,0,0,,5,11,.455,2,4,.500,1,1,2,3,0,1,0,3,12,2004/2005
"Simmons,Bobby",474,1017,.466,50,115,.435,424,902,.470,231,273,.846,128,318,446,205,106,135,16,227,1229,2004/2005
"Skinner,Brian",104,205,.507,0,1,.000,104,204,.510,25,70,.357,107,173,280,43,31,40,49,102,233,2004/2005
"Skinner,Brian",22,57,.386,0,1,.000,22,56,.393,5,17,.294,23,39,62,5,5,13,6,29,49,2004/2005
"Skinner,Brian",82,148,.554,0,0,,82,148,.554,20,53,.377,84,134,218,38,26,27,43,73,184,2004/2005
"Slay,Tamar",13,39,.333,2,12,.167,11,27,.407,0,2,.000,6,8,14,3,5,8,0,20,28,2004/2005
"Smith,Donta",44,113,.389,6,22,.273,38,91,.418,33,48,.688,19,33,52,39,23,25,5,50,127,2004/2005
"Smith,J.R.",295,748,.394,81,281,.288,214,467,.458,111,161,.689,39,113,152,142,55,109,11,135,782,2004/2005
"Smith,Jabari",62,148,.419,1,2,.500,61,146,.418,41,55,.745,29,82,111,38,25,39,14,103,166,2004/2005
"Smith,Joe",319,621,.514,0,1,.000,319,620,.515,175,228,.768,179,362,541,67,43,79,38,222,813,2004/2005
"Smith,Josh",274,602,.455,4,23,.174,270,579,.466,163,237,.688,147,310,457,127,59,135,144,157,715,2004/2005
"Smith,Steve",102,248,.411,41,105,.390,61,143,.427,69,80,.863,15,50,65,71,14,27,7,82,314,2004/2005
"Smith,Steve",93,218,.427,38,90,.422,55,128,.430,67,77,.870,13,36,49,57,12,24,7,74,291,2004/2005
"Smith,Steve",9,30,.300,3,15,.200,6,15,.400,2,3,.667,2,14,16,14,2,3,0,8,23,2004/2005
"Smith,Theron",44,136,.324,3,12,.250,41,124,.331,14,16,.875,39,77,116,28,6,27,4,58,105,2004/2005
"Snow,Eric",125,327,.382,13,45,.289,112,282,.397,59,80,.738,37,118,155,317,67,89,16,189,322,2004/2005
"Snyder,Kirk",122,328,.372,30,85,.353,92,243,.379,64,96,.667,50,71,121,36,26,58,19,116,338,2004/2005
"Songaila,Darius",257,488,.527,0,3,.000,257,485,.530,94,111,.847,125,219,344,114,51,70,18,206,608,2004/2005
"Sow,Pape",23,58,.397,0,0,,23,58,.397,16,27,.593,18,39,57,2,12,10,4,46,62,2004/2005
"Sprewell,Latrell",398,961,.414,69,211,.327,329,750,.439,156,188,.830,65,189,254,179,53,127,21,124,1021,2004/2005
"Stackhouse,Jerry",274,662,.414,32,120,.267,242,542,.446,253,298,.849,38,145,183,127,53,106,10,104,833,2004/2005
"Stevenson,DeShawn",174,426,.408,25,67,.373,149,359,.415,56,101,.554,38,64,102,69,16,57,9,73,429,2004/2005
"Stewart,Michael",11,21,.524,0,0,,11,21,.524,3,7,.429,21,19,40,5,6,6,5,32,25,2004/2005
"Stojaković,Peja",451,1016,.444,174,433,.402,277,583,.475,253,275,.920,62,223,285,138,79,102,12,157,1329,2004/2005
"Storey,Awvee",3,10,.300,1,2,.500,2,8,.250,1,2,.500,4,1,5,1,0,0,0,3,8,2004/2005
"Stoudamire,Damon",457,1165,.392,181,490,.369,276,675,.409,182,199,.915,56,254,310,458,86,164,2,158,1277,2004/2005
"Stoudemire,Amar'e",747,1336,.559,3,16,.188,744,1320,.564,583,795,.733,219,494,713,131,77,189,130,278,2080,2004/2005
"Strickland,Erick",114,304,.375,21,83,.253,93,221,.421,52,64,.813,11,92,103,115,30,64,1,103,301,2004/2005
"Strickland,Rod",9,43,.209,1,2,.500,8,41,.195,9,10,.900,3,24,27,39,3,16,2,15,28,2004/2005
"Šundov,Bruno",11,37,.297,1,3,.333,10,34,.294,2,2,1.000,6,7,13,2,2,6,2,16,25,2004/2005
"Sura,Bob",215,504,.427,55,155,.355,160,349,.458,141,188,.750,79,258,337,317,65,147,7,168,626,2004/2005
"Sweetney,Mike",237,446,.531,0,1,.000,237,445,.533,176,235,.749,169,249,418,44,27,108,28,224,650,2004/2005
"Swift,Robert",5,11,.455,0,0,,5,11,.455,5,9,.556,1,4,5,2,1,4,7,16,15,2004/2005
"Swift,Stromile",219,488,.449,0,4,.000,219,484,.452,166,219,.758,92,181,273,43,41,90,92,182,604,2004/2005
"Szczerbiak,Wally",465,919,.506,63,169,.373,402,750,.536,260,304,.855,82,221,303,191,40,132,16,178,1253,2004/2005
"Tabuse,Yuta",1,6,.167,1,1,1.000,0,5,.000,4,4,1.000,2,2,4,3,0,1,0,1,7,2004/2005
"Taylor,Maurice",203,446,.455,3,9,.333,200,437,.458,63,103,.612,67,190,257,67,27,94,20,180,472,2004/2005
"Taylor,Maurice",127,292,.435,3,8,.375,124,284,.437,39,60,.650,41,123,164,53,16,63,12,123,296,2004/2005
"Taylor,Maurice",76,154,.494,0,1,.000,76,153,.497,24,43,.558,26,67,93,14,11,31,8,57,176,2004/2005
"Telfair,Sebastian",169,430,.393,17,69,.246,152,361,.421,105,133,.789,10,94,104,224,35,125,4,120,460,2004/2005
"Terry,Jason",372,743,.501,103,245,.420,269,498,.540,146,173,.844,38,150,188,429,109,147,15,177,993,2004/2005
"Thomas,Billy",34,94,.362,17,56,.304,17,38,.447,7,9,.778,7,29,36,17,14,9,1,29,92,2004/2005
"Thomas,Etan",128,255,.502,0,0,,128,255,.502,76,144,.528,85,159,244,20,17,50,51,133,332,2004/2005
"Thomas,James",12,20,.600,0,0,,12,20,.600,2,6,.333,17,20,37,4,4,7,4,13,26,2004/2005
"Thomas,James",11,18,.611,0,0,,11,18,.611,2,6,.333,15,20,35,4,4,7,4,12,24,2004/2005
"Thomas,James",1,2,.500,0,0,,1,2,.500,0,0,,2,0,2,0,0,0,0,1,2,2004/2005
"Thomas,John",42,86,.488,0,0,,42,86,.488,27,46,.587,39,58,97,17,15,18,13,82,111,2004/2005
"Thomas,Kenny",367,781,.470,1,5,.200,366,776,.472,173,227,.762,184,351,535,152,67,131,17,227,908,2004/2005
"Thomas,Kenny",217,476,.456,1,4,.250,216,472,.458,95,119,.798,106,202,308,77,40,83,6,151,530,2004/2005
"Thomas,Kenny",150,305,.492,0,1,.000,150,304,.493,78,108,.722,78,149,227,75,27,48,11,76,378,2004/2005
"Thomas,Kurt",424,901,.471,2,4,.500,422,897,.470,66,84,.786,170,661,831,160,70,99,79,310,916,2004/2005
"Thomas,Tim",315,718,.439,85,208,.409,230,510,.451,136,173,.786,45,192,237,110,41,113,17,222,851,2004/2005
"Tinsley,Jamaal",218,522,.418,58,156,.372,160,366,.437,122,164,.744,26,134,160,257,81,134,12,112,616,2004/2005
"Traylor,Robert",177,399,.444,0,8,.000,177,391,.453,55,102,.539,136,196,332,61,54,73,50,215,409,2004/2005
"Tsakalidis,Jake",32,64,.500,0,0,,32,64,.500,14,18,.778,21,35,56,10,3,12,16,42,78,2004/2005
"Tskitishvili,Nikoloz",22,74,.297,2,17,.118,20,57,.351,4,7,.571,12,29,41,10,8,19,11,33,50,2004/2005
"Tskitishvili,Nikoloz",15,51,.294,0,7,.000,15,44,.341,4,7,.571,11,18,29,4,8,14,8,24,34,2004/2005
"Tskitishvili,Nikoloz",7,23,.304,2,10,.200,5,13,.385,0,0,,1,11,12,6,0,5,3,9,16,2004/2005
"Türkoğlu,Hedo",328,782,.419,93,245,.380,235,537,.438,188,225,.836,62,171,233,153,41,119,18,140,937,2004/2005
"Udrih,Beno",173,390,.444,58,142,.408,115,248,.464,67,89,.753,16,67,83,150,41,77,10,96,471,2004/2005
"Van Exel,Nick",214,561,.381,100,257,.389,114,304,.375,58,74,.784,20,141,161,227,44,92,0,70,586,2004/2005
"Van Horn,Keith",257,564,.456,54,142,.380,203,422,.481,128,157,.815,89,205,294,75,36,81,21,170,696,2004/2005
"Van Horn,Keith",128,285,.449,30,78,.385,98,207,.473,56,65,.862,55,110,165,41,21,47,11,82,342,2004/2005
"Van Horn,Keith",129,279,.462,24,64,.375,105,215,.488,72,92,.783,34,95,129,34,15,34,10,88,354,2004/2005
"Varejão,Anderson",99,193,.513,0,2,.000,99,191,.518,68,127,.535,109,148,257,27,41,26,38,122,266,2004/2005
"Vaughn,Jacque",146,325,.449,5,15,.333,141,310,.455,76,91,.835,17,90,107,135,41,62,1,138,373,2004/2005
"Voskuhl,Jake",27,59,.458,0,0,,27,59,.458,26,38,.684,30,62,92,17,4,20,11,60,80,2004/2005
"Vroman,Jackson",82,199,.412,0,3,.000,82,196,.418,48,75,.640,64,111,175,40,25,64,19,105,212,2004/2005
"Vroman,Jackson",6,16,.375,0,0,,6,16,.375,4,7,.571,5,8,13,7,3,7,2,11,16,2004/2005
"Vroman,Jackson",76,183,.415,0,3,.000,76,180,.422,44,68,.647,59,103,162,33,22,57,17,94,196,2004/2005
"Vujačić,Sasha",33,117,.282,17,63,.270,16,54,.296,18,19,.947,13,49,62,51,12,15,2,41,101,2004/2005
"Wade,Dwyane",630,1318,.478,13,45,.289,617,1273,.485,581,762,.762,110,287,397,520,121,321,82,230,1854,2004/2005
"Wagner,Dajuan",18,55,.327,5,26,.192,13,29,.448,3,4,.750,0,2,2,13,5,9,0,15,44,2004/2005
"Walker,Antoine",581,1377,.422,110,341,.323,471,1036,.455,201,373,.539,182,513,695,265,89,253,58,217,1473,2004/2005
"Walker,Antoine",420,1013,.415,85,268,.317,335,745,.450,157,294,.534,126,371,497,194,64,183,32,147,1082,2004/2005
"Walker,Antoine",161,364,.442,25,73,.342,136,291,.467,44,79,.557,56,142,198,71,25,70,26,70,391,2004/2005
"Walker,Samaki",11,31,.355,0,0,,11,31,.355,2,3,.667,8,10,18,4,3,8,7,25,24,2004/2005
"Wallace,Ben",295,651,.453,1,9,.111,294,642,.458,130,304,.428,292,610,902,123,106,82,176,159,721,2004/2005
"Wallace,Gerald",286,637,.449,17,62,.274,269,575,.468,191,289,.661,118,268,386,137,117,159,91,182,780,2004/2005
"Wallace,Rasheed",467,1062,.440,75,236,.318,392,826,.475,136,195,.697,174,470,644,142,65,127,115,236,1145,2004/2005
"Walton,Luke",74,180,.411,16,61,.262,58,119,.487,34,48,.708,55,87,142,93,26,58,11,70,198,2004/2005
"Ward,Charlie",24,77,.312,16,51,.314,8,26,.308,11,13,.846,6,33,39,43,15,18,0,22,75,2004/2005
"Watson,Earl",236,554,.426,52,163,.319,184,391,.471,91,138,.659,35,129,164,359,83,167,19,184,615,2004/2005
"Weatherspoon,Clarence",47,114,.412,0,0,,47,114,.412,29,35,.829,35,87,122,17,9,15,6,74,123,2004/2005
"Webber,Chris",555,1283,.433,15,44,.341,540,1239,.436,181,228,.794,130,482,612,318,94,182,53,214,1306,2004/2005
"Webber,Chris",412,917,.449,11,29,.379,401,888,.452,143,179,.799,94,353,447,252,68,133,34,144,978,2004/2005
"Webber,Chris",143,366,.391,4,15,.267,139,351,.396,38,49,.776,36,129,165,66,26,49,19,70,328,2004/2005
"Wells,Bonzi",272,617,.441,36,104,.346,236,513,.460,141,188,.750,49,180,229,80,85,90,27,165,721,2004/2005
"Welsch,Jiří",149,371,.402,34,110,.309,115,261,.441,129,169,.763,26,141,167,103,44,73,5,121,461,2004/2005
"Welsch,Jiří",137,320,.428,32,99,.323,105,221,.475,109,141,.773,20,119,139,84,39,58,5,105,415,2004/2005
"Welsch,Jiří",12,51,.235,2,11,.182,10,40,.250,20,28,.714,6,22,28,19,5,15,0,16,46,2004/2005
"Wesley,David",334,840,.398,118,315,.375,216,525,.411,162,189,.857,38,190,228,265,96,113,9,215,948,2004/2005
"Wesley,David",133,342,.389,28,80,.350,105,262,.401,67,76,.882,12,73,85,109,35,54,1,65,361,2004/2005
"Wesley,David",201,498,.404,90,235,.383,111,263,.422,95,113,.841,26,117,143,156,61,59,8,150,587,2004/2005
"West,David",75,172,.436,2,5,.400,73,167,.437,34,50,.680,40,89,129,23,12,37,16,62,186,2004/2005
"West,Delonte",66,155,.426,24,67,.358,42,88,.477,19,27,.704,14,51,65,53,21,24,8,69,175,2004/2005
"White,Jahidi",14,31,.452,0,0,,14,31,.452,14,40,.350,11,23,34,1,2,11,12,31,42,2004/2005
"White,Rodney",121,289,.419,24,60,.400,97,229,.424,27,44,.614,24,65,89,44,32,37,11,64,293,2004/2005
"White,Rodney",98,227,.432,19,44,.432,79,183,.432,21,34,.618,20,54,74,36,30,27,10,51,236,2004/2005
"White,Rodney",23,62,.371,5,16,.313,18,46,.391,6,10,.600,4,11,15,8,2,10,1,13,57,2004/2005
"Wilcox,Chris",169,329,.514,0,0,,169,329,.514,88,144,.611,63,165,228,38,26,77,24,129,426,2004/2005
"Wilkins,Damien",73,168,.435,16,59,.271,57,109,.523,21,34,.618,29,37,66,26,22,16,10,55,183,2004/2005
"Wilks,Mike",32,77,.416,5,16,.313,27,61,.443,12,16,.750,4,21,25,33,14,14,1,26,81,2004/2005
"Williams,Aaron",29,63,.460,0,0,,29,63,.460,15,17,.882,17,43,60,8,5,17,8,70,73,2004/2005
"Williams,Aaron",14,27,.519,0,0,,14,27,.519,9,10,.900,7,24,31,6,4,11,5,25,37,2004/2005
"Williams,Aaron",15,36,.417,0,0,,15,36,.417,6,7,.857,10,19,29,2,1,6,3,45,36,2004/2005
"Williams,Eric",142,330,.430,28,73,.384,114,257,.444,112,161,.696,44,128,172,92,38,60,4,147,424,2004/2005
"Williams,Eric",87,185,.470,17,40,.425,70,145,.483,74,108,.685,28,67,95,42,16,34,2,80,265,2004/2005
"Williams,Eric",55,145,.379,11,33,.333,44,112,.393,38,53,.717,16,61,77,50,22,26,2,67,159,2004/2005
"Williams,Frank",3,20,.150,0,4,.000,3,16,.188,0,0,,2,4,6,11,2,3,3,9,6,2004/2005
"Williams,Jason",266,644,.413,107,330,.324,159,314,.506,80,101,.792,19,103,122,399,75,130,5,91,719,2004/2005
"Williams,Jerome",122,243,.502,0,5,.000,122,238,.513,115,172,.669,115,168,283,41,55,65,10,155,359,2004/2005
"Williams,Mo",323,737,.438,32,99,.323,291,638,.456,136,160,.850,50,194,244,484,74,196,11,221,814,2004/2005
"Williams,Scott",12,41,.293,0,1,.000,12,40,.300,9,11,.818,15,15,30,8,4,5,6,30,33,2004/2005
"Williamson,Corliss",273,584,.467,0,2,.000,273,582,.469,195,244,.799,104,155,259,78,38,86,15,218,741,2004/2005
"Williamson,Corliss",194,417,.465,0,2,.000,194,415,.467,130,165,.788,73,105,178,43,26,60,12,144,518,2004/2005
"Williamson,Corliss",79,167,.473,0,0,,79,167,.473,65,79,.823,31,50,81,35,12,26,3,74,223,2004/2005
"Willis,Kevin",35,90,.389,0,2,.000,35,88,.398,17,23,.739,29,47,76,9,8,15,7,53,87,2004/2005
"Woods,Loren",71,164,.433,0,1,.000,71,163,.436,34,59,.576,81,139,220,17,8,37,39,78,176,2004/2005
"Woods,Qyntel",5,12,.417,0,0,,5,12,.417,0,0,,2,4,6,0,4,2,0,6,10,2004/2005
"World Peace,Metta",59,119,.496,7,17,.412,52,102,.510,47,51,.922,8,37,45,22,12,17,6,27,172,2004/2005
"Wright,Dorell",3,11,.273,0,4,.000,3,7,.429,1,1,1.000,0,1,1,3,4,3,0,2,7,2004/2005
"Wright,Lorenzen",320,683,.469,0,3,.000,320,680,.471,131,198,.662,177,436,613,87,58,100,69,251,771,2004/2005
"Zhizhi,Wang",17,36,.472,2,3,.667,15,33,.455,7,12,.583,6,12,18,5,3,5,2,9,43,2004/2005
"Abdur-Rahim,Shareef",332,632,.525,5,22,.227,327,610,.536,218,278,.784,106,251,357,149,48,108,42,227,887,2005/2006
"Acker,Alex",4,16,.250,1,5,.200,3,11,.273,0,0,,1,4,5,4,1,4,0,4,9,2005/2006
"Allen,Malik",121,247,.490,1,1,1.000,120,246,.488,23,38,.605,44,96,140,20,14,34,16,92,266,2005/2006
"Allen,Ray",681,1500,.454,269,653,.412,412,847,.486,324,359,.903,71,261,332,286,105,188,16,151,1955,2005/2006
"Allen,Tony",129,274,.471,11,34,.324,118,240,.492,100,134,.746,32,79,111,67,51,67,18,126,369,2005/2006
"Alston,Rafer",280,738,.379,102,312,.327,178,426,.418,99,143,.692,36,219,255,425,101,157,15,194,761,2005/2006
"Andersen,Chris",56,98,.571,0,0,,56,98,.571,49,103,.476,61,94,155,6,8,26,41,84,161,2005/2006
"Anderson,Alan",75,181,.414,24,58,.414,51,123,.415,33,41,.805,23,47,70,32,11,32,4,48,207,2005/2006
"Anderson,Derek",108,303,.356,40,134,.299,68,169,.402,93,111,.838,21,122,143,101,23,54,6,98,349,2005/2006
"Anderson,Derek",68,173,.393,19,67,.284,49,106,.462,61,73,.836,12,71,83,53,15,37,4,49,216,2005/2006
"Anderson,Derek",40,130,.308,21,67,.313,19,63,.302,32,38,.842,9,51,60,48,8,17,2,49,133,2005/2006
"Anderson,Shandon",54,126,.429,5,19,.263,49,107,.458,13,18,.722,18,63,81,30,17,24,6,75,126,2005/2006
"Andriuškevičius,Martynas",0,1,.000,0,0,,0,1,.000,0,0,,1,3,4,0,2,0,0,1,0,2005/2006
"Anthony,Carmelo",756,1572,.481,37,152,.243,719,1420,.506,573,709,.808,122,272,394,216,88,218,42,229,2122,2005/2006
"Araújo,Rafael",53,145,.366,0,1,.000,53,144,.368,15,28,.536,43,101,144,15,24,42,6,104,121,2005/2006
"Arenas,Gilbert",746,1668,.447,199,540,.369,547,1128,.485,655,799,.820,59,221,280,484,161,297,25,286,2346,2005/2006
"Ariza,Trevor",93,226,.412,1,5,.200,92,221,.416,77,127,.606,78,140,218,61,57,62,11,100,264,2005/2006
"Ariza,Trevor",61,146,.418,1,3,.333,60,143,.420,42,77,.545,49,88,137,46,43,46,9,78,165,2005/2006
"Ariza,Trevor",32,80,.400,0,2,.000,32,78,.410,35,50,.700,29,52,81,15,14,16,2,22,99,2005/2006
"Armstrong,Darrell",43,128,.336,11,48,.229,32,80,.400,33,42,.786,18,63,81,86,27,58,3,71,130,2005/2006
"Arroyo,Carlos",168,378,.444,7,20,.350,161,358,.450,106,137,.774,33,97,130,232,38,83,4,119,449,2005/2006
"Arroyo,Carlos",57,157,.363,2,6,.333,55,151,.364,42,58,.724,24,46,70,155,19,45,3,77,158,2005/2006
"Arroyo,Carlos",111,221,.502,5,14,.357,106,207,.512,64,79,.810,9,51,60,77,19,38,1,42,291,2005/2006
"Atkins,Chucky",226,573,.394,97,274,.354,129,299,.431,129,163,.791,23,97,120,198,43,87,2,152,678,2005/2006
"Atkins,Chucky",66,174,.379,33,92,.359,33,82,.402,22,31,.710,12,33,45,69,14,30,0,58,187,2005/2006
"Atkins,Chucky",160,399,.401,64,182,.352,96,217,.442,107,132,.811,11,64,75,129,29,57,2,94,491,2005/2006
"Augmon,Stacey",25,73,.342,0,0,,25,73,.342,21,30,.700,18,35,53,23,12,11,6,40,71,2005/2006
"Baker,Vin",7,15,.467,0,0,,7,15,.467,13,18,.722,2,17,19,4,4,9,4,13,27,2005/2006
"Banks,Marcus",219,468,.468,22,63,.349,197,405,.486,118,147,.803,23,112,135,220,54,119,11,162,578,2005/2006
"Banks,Marcus",33,80,.413,6,19,.316,27,61,.443,27,30,.900,4,15,19,32,7,23,0,38,99,2005/2006
"Banks,Marcus",186,388,.479,16,44,.364,170,344,.494,91,117,.778,19,97,116,188,47,96,11,124,479,2005/2006
"Barbosa,Leandro",273,567,.481,87,196,.444,186,371,.501,111,147,.755,31,119,150,158,48,89,6,145,744,2005/2006
"Barnes,Matt",70,140,.500,3,15,.200,67,125,.536,32,47,.681,48,73,121,28,20,30,7,100,175,2005/2006
"Barnes,Matt",11,30,.367,1,4,.250,10,26,.385,3,4,.750,7,17,24,6,4,6,0,8,26,2005/2006
"Barnes,Matt",59,110,.536,2,11,.182,57,99,.576,29,43,.674,41,56,97,22,16,24,7,92,149,2005/2006
"Barrett,Andre",38,104,.365,2,14,.143,36,90,.400,9,12,.750,9,16,25,52,10,15,0,13,87,2005/2006
"Barrett,Andre",3,7,.429,0,1,.000,3,6,.500,3,3,1.000,1,2,3,2,0,1,0,1,9,2005/2006
"Barrett,Andre",35,97,.361,2,13,.154,33,84,.393,6,9,.667,8,14,22,50,10,14,0,12,78,2005/2006
"Barron,Earl",5,16,.313,0,0,,5,16,.313,3,4,.750,2,8,10,0,0,5,0,10,13,2005/2006
"Barry,Brent",156,345,.452,80,202,.396,76,143,.531,39,59,.661,29,130,159,123,39,52,27,99,431,2005/2006
"Barry,Jon",25,65,.385,12,32,.375,13,33,.394,24,29,.828,1,30,31,26,13,22,1,25,86,2005/2006
"Basden,Eddie",15,37,.405,1,7,.143,14,30,.467,8,10,.800,7,21,28,8,9,9,2,17,39,2005/2006
"Bass,Brandon",28,70,.400,0,0,,28,70,.400,12,19,.632,18,50,68,3,3,11,7,18,68,2005/2006
"Batista,Esteban",34,80,.425,0,1,.000,34,79,.430,33,53,.623,61,83,144,7,15,38,11,111,101,2005/2006
"Battie,Tony",280,552,.507,0,6,.000,280,546,.513,89,134,.664,145,312,457,49,46,88,69,250,649,2005/2006
"Battier,Shane",303,621,.488,65,165,.394,238,456,.522,147,208,.707,164,265,429,136,92,90,114,223,818,2005/2006
"Baxter,Lonny",45,104,.433,0,0,,45,104,.433,28,35,.800,45,72,117,4,11,20,8,56,118,2005/2006
"Baxter,Lonny",33,72,.458,0,0,,33,72,.458,16,19,.842,38,46,84,2,9,13,7,48,82,2005/2006
"Baxter,Lonny",12,32,.375,0,0,,12,32,.375,12,16,.750,7,26,33,2,2,7,1,8,36,2005/2006
"Bell,Charlie",180,410,.439,71,168,.423,109,242,.450,63,89,.708,21,99,120,130,59,41,5,126,494,2005/2006
"Bell,Raja",425,930,.457,197,446,.442,228,484,.471,115,146,.788,44,209,253,207,76,89,22,248,1162,2005/2006
"Bender,Jonathan",4,5,.800,0,0,,4,5,.800,2,2,1.000,0,4,4,2,0,0,1,2,10,2005/2006
"Bibby,Mike",597,1382,.432,192,497,.386,405,885,.458,342,403,.849,29,211,240,444,82,199,10,169,1728,2005/2006
"Biedriņš,Andris",118,185,.638,0,0,,118,185,.638,22,72,.306,124,159,283,24,23,34,47,190,258,2005/2006
"Billups,Chauncey",423,1012,.418,184,425,.433,239,587,.407,465,520,.894,41,211,252,699,71,170,8,160,1495,2005/2006
"Blake,Steve",206,470,.438,76,184,.413,130,286,.455,72,91,.791,26,120,146,306,42,83,5,107,560,2005/2006
"Blatche,Andray",26,67,.388,3,13,.231,23,54,.426,10,12,.833,12,26,38,10,5,12,7,36,65,2005/2006
"Blount,Mark",373,734,.508,0,0,,373,734,.508,168,222,.757,96,269,365,99,40,194,76,254,914,2005/2006
"Blount,Mark",194,380,.511,0,0,,194,380,.511,97,127,.764,36,126,162,66,15,120,36,107,485,2005/2006
"Blount,Mark",179,354,.506,0,0,,179,354,.506,71,95,.747,60,143,203,33,25,74,40,147,429,2005/2006
"Bogans,Keith",215,544,.395,65,200,.325,150,344,.436,127,186,.683,55,200,255,128,71,90,9,167,622,2005/2006
"Bogans,Keith",114,288,.396,33,98,.337,81,190,.426,80,105,.762,29,77,106,45,39,41,3,78,341,2005/2006
"Bogans,Keith",101,256,.395,32,102,.314,69,154,.448,47,81,.580,26,123,149,83,32,49,6,89,281,2005/2006
"Bogut,Andrew",323,606,.533,0,3,.000,323,603,.536,122,194,.629,189,384,573,192,49,125,68,259,768,2005/2006
"Bonner,Matt",209,467,.448,102,243,.420,107,224,.478,63,76,.829,86,198,284,56,49,32,31,216,583,2005/2006
"Booth,Calvin",20,47,.426,1,2,.500,19,45,.422,5,9,.556,19,33,52,12,9,8,9,44,46,2005/2006
"Boozer,Carlos",219,399,.549,0,0,,219,399,.549,99,137,.723,73,212,285,88,30,69,8,105,537,2005/2006
"Bosh,Chris",549,1087,.505,0,13,.000,549,1074,.511,474,581,.816,204,443,647,181,50,157,79,209,1572,2005/2006
"Bowen,Bruce",232,536,.433,104,245,.424,128,291,.440,51,84,.607,35,285,320,126,79,67,30,191,619,2005/2006
"Bowen,Ryan",37,124,.298,3,22,.136,34,102,.333,11,14,.786,31,57,88,24,21,13,6,85,88,2005/2006
"Boykins,Earl",271,661,.410,62,179,.346,209,482,.434,152,174,.874,21,60,81,230,48,83,4,73,756,2005/2006
"Bradley,Michael",32,79,.405,1,5,.200,31,74,.419,2,3,.667,40,67,107,17,5,19,7,39,67,2005/2006
"Brand,Elton",756,1435,.527,1,3,.333,755,1432,.527,440,568,.775,236,554,790,208,81,173,201,227,1953,2005/2006
"Brezec,Primož",409,791,.517,0,2,.000,409,789,.518,164,224,.732,181,259,440,45,19,85,32,227,982,2005/2006
"Brown,Devin",207,527,.393,39,118,.331,168,409,.411,158,212,.745,73,134,207,104,44,99,14,153,611,2005/2006
"Brown,Kwame",204,388,.526,0,1,.000,204,387,.527,128,235,.545,182,291,473,72,27,100,46,196,536,2005/2006
"Brown,P.J.",269,583,.461,0,0,,269,583,.461,139,168,.827,182,365,547,90,46,90,50,216,677,2005/2006
"Brunson,Rick",21,54,.389,5,13,.385,16,41,.390,7,12,.583,1,21,22,35,8,22,1,22,54,2005/2006
"Brunson,Rick",5,8,.625,0,1,.000,5,7,.714,0,0,,0,2,2,2,0,3,0,1,10,2005/2006
"Brunson,Rick",16,46,.348,5,12,.417,11,34,.324,7,12,.583,1,19,20,33,8,19,1,21,44,2005/2006
"Bryant,Kobe",978,2173,.450,180,518,.347,798,1655,.482,696,819,.850,71,354,425,360,147,250,30,233,2832,2005/2006
"Buckner,Greg",181,417,.434,86,243,.354,95,174,.546,43,55,.782,31,178,209,127,87,52,20,180,491,2005/2006
"Burke,Pat",63,127,.496,2,7,.286,61,120,.508,13,21,.619,21,52,73,16,6,33,13,62,141,2005/2006
"Burks,Antonio",51,144,.354,1,6,.167,50,138,.362,10,23,.435,4,33,37,76,20,36,0,45,113,2005/2006
"Burleson,Kevin",22,88,.250,10,54,.185,12,34,.353,16,17,.941,4,22,26,48,26,25,2,63,70,2005/2006
"Butler,Caron",494,1086,.455,41,120,.342,453,966,.469,289,332,.870,114,352,466,186,127,175,18,238,1318,2005/2006
"Butler,Jackie",117,215,.544,0,0,,117,215,.544,58,77,.753,67,116,183,25,17,62,31,127,292,2005/2006
"Butler,Rasual",257,633,.406,92,242,.380,165,391,.422,79,114,.693,51,181,232,40,33,65,45,142,685,2005/2006
"Bynum,Andrew",33,82,.402,0,0,,33,82,.402,8,27,.296,34,46,80,9,4,17,22,56,74,2005/2006
"Bynum,Will",21,52,.404,2,9,.222,19,43,.442,10,16,.625,3,9,12,19,7,14,0,10,54,2005/2006
"Čabarkapa,Žarko",67,174,.385,5,20,.250,62,154,.403,60,84,.714,37,74,111,20,13,35,7,87,199,2005/2006
"Calderón,José",132,312,.423,7,43,.163,125,269,.465,78,92,.848,30,111,141,288,42,101,4,93,349,2005/2006
"Camby,Marcus",302,649,.465,1,11,.091,301,638,.472,111,156,.712,132,536,668,115,79,92,184,158,716,2005/2006
"Cardinal,Brian",46,111,.414,13,29,.448,33,82,.402,19,27,.704,11,44,55,33,23,27,0,65,124,2005/2006
"Carroll,Matt",192,476,.403,72,185,.389,120,291,.412,138,168,.821,34,123,157,35,47,48,11,120,594,2005/2006
"Carter,Anthony",53,137,.387,4,15,.267,49,122,.402,40,55,.727,9,53,62,101,24,40,9,71,150,2005/2006
"Carter,Vince",653,1518,.430,125,367,.341,528,1151,.459,480,601,.799,135,327,462,338,94,213,53,235,1911,2005/2006
"Cassell,Sam",493,1112,.443,70,190,.368,423,922,.459,289,335,.863,40,247,287,491,74,175,11,225,1345,2005/2006
"Cato,Kelvin",36,84,.429,0,0,,36,84,.429,26,35,.743,20,50,70,4,6,18,12,52,98,2005/2006
"Cato,Kelvin",31,72,.431,0,0,,31,72,.431,26,35,.743,19,44,63,2,6,16,10,48,88,2005/2006
"Cato,Kelvin",5,12,.417,0,0,,5,12,.417,0,0,,1,6,7,2,0,2,2,4,10,2005/2006
"Chandler,Tyson",160,283,.565,0,1,.000,160,282,.567,97,193,.503,265,449,714,81,41,123,104,298,417,2005/2006
"Cheaney,Calbert",42,108,.389,0,8,.000,42,100,.420,8,8,1.000,20,41,61,19,13,17,2,38,92,2005/2006
"Childress,Josh",278,504,.552,32,65,.492,246,439,.560,154,201,.766,134,253,387,131,86,101,39,184,742,2005/2006
"Christie,Doug",9,26,.346,0,1,.000,9,25,.360,8,12,.667,2,11,13,14,9,6,1,10,26,2005/2006
"Claxton,Speedy",304,736,.413,17,63,.270,287,673,.426,246,320,.769,39,154,193,339,108,154,6,177,871,2005/2006
"Cleaves,Mateen",25,71,.352,4,16,.250,21,55,.382,19,24,.792,2,12,14,42,3,14,2,30,73,2005/2006
"Collins,Jarron",129,280,.461,0,0,,129,280,.461,157,219,.717,134,199,333,97,36,61,27,252,415,2005/2006
"Collins,Jason",104,262,.397,3,12,.250,101,250,.404,44,86,.512,93,249,342,70,46,61,40,251,255,2005/2006
"Collison,Nick",207,394,.525,0,3,.000,207,391,.529,79,113,.699,143,225,368,74,21,77,35,213,493,2005/2006
"Cook,Brian",261,511,.511,36,84,.429,225,427,.527,84,101,.832,88,186,274,74,37,61,32,205,642,2005/2006
"Crawford,Jamal",366,879,.416,101,293,.345,265,586,.452,295,357,.826,36,212,248,301,87,175,15,150,1128,2005/2006
"Croshere,Austin",132,285,.463,54,140,.386,78,145,.538,90,102,.882,62,203,265,62,22,48,7,105,408,2005/2006
"Curry,Eddy",336,597,.563,0,0,,336,597,.563,307,486,.632,145,287,432,19,28,179,56,239,979,2005/2006
"Dalembert,Samuel",196,369,.531,0,1,.000,196,368,.533,93,132,.705,159,382,541,25,34,107,160,244,485,2005/2006
"Dampier,Erick",171,347,.493,0,0,,171,347,.493,127,215,.591,273,367,640,51,27,115,106,263,469,2005/2006
"Daniels,Antonio",230,550,.418,23,101,.228,207,449,.461,284,336,.845,19,153,172,284,52,89,8,96,767,2005/2006
"Daniels,Marquis",246,512,.480,4,19,.211,242,493,.491,138,183,.754,81,143,224,172,67,100,13,143,634,2005/2006
"Davis,Antonio",82,190,.432,0,1,.000,82,189,.434,52,81,.642,90,118,208,21,23,51,10,125,216,2005/2006
"Davis,Antonio",68,159,.428,0,1,.000,68,158,.430,45,61,.738,75,97,172,14,20,43,9,99,181,2005/2006
"Davis,Antonio",14,31,.452,0,0,,14,31,.452,7,20,.350,15,21,36,7,3,8,1,26,35,2005/2006
"Davis,Baron",335,861,.389,102,324,.315,233,537,.434,195,289,.675,45,191,236,480,89,159,14,165,967,2005/2006
"Davis,Dale",9,24,.375,0,1,.000,9,23,.391,8,15,.533,21,32,53,6,0,4,9,23,26,2005/2006
"Davis,Josh",2,7,.286,0,2,.000,2,5,.400,2,3,.667,3,1,4,1,2,1,0,3,6,2005/2006
"Davis,Josh",1,4,.250,0,1,.000,1,3,.333,0,0,,2,1,3,1,1,1,0,2,2,2005/2006
"Davis,Josh",0,0,,0,0,,0,0,,0,0,,0,0,0,0,0,0,0,1,0,2005/2006
"Davis,Josh",1,3,.333,0,1,.000,1,2,.500,2,3,.667,1,0,1,0,1,0,0,0,4,2005/2006
"Davis,Ricky",584,1304,.448,73,242,.302,511,1062,.481,275,345,.797,65,286,351,394,91,213,17,190,1516,2005/2006
"Davis,Ricky",329,709,.464,40,125,.320,289,584,.495,129,164,.787,40,147,187,221,49,115,9,91,827,2005/2006
"Davis,Ricky",255,595,.429,33,117,.282,222,478,.464,146,181,.807,25,139,164,173,42,98,8,99,689,2005/2006
"Delfino,Carlos",91,226,.403,20,60,.333,71,166,.428,45,67,.672,28,85,113,44,21,36,15,86,247,2005/2006
"Delk,Tony",71,161,.441,20,47,.426,51,114,.447,20,27,.741,14,39,53,33,13,19,1,28,182,2005/2006
"Delk,Tony",0,1,.000,0,0,,0,1,.000,2,2,1.000,1,1,2,0,0,0,0,0,2,2005/2006
"Delk,Tony",71,160,.444,20,47,.426,51,113,.451,18,25,.720,13,38,51,33,13,19,1,28,180,2005/2006
"Deng,Luol",442,954,.463,21,78,.269,421,876,.481,207,276,.750,127,389,516,147,72,105,50,128,1112,2005/2006
"Diaw,Boris",449,853,.526,8,30,.267,441,823,.536,174,238,.731,159,399,558,503,58,189,85,260,1080,2005/2006
"Dickau,Dan",17,46,.370,10,20,.500,7,26,.269,18,18,1.000,5,11,16,40,11,18,1,40,62,2005/2006
"Diener,Travis",29,69,.420,25,57,.439,4,12,.333,5,6,.833,4,17,21,16,7,10,0,22,88,2005/2006
"Diogu,Ike",175,334,.524,0,0,,175,334,.524,136,168,.810,95,134,229,29,15,78,30,164,486,2005/2006
"Diop,DeSagana",75,154,.487,1,2,.500,74,152,.487,39,72,.542,145,229,374,23,44,36,146,253,190,2005/2006
"Dixon,Juan",357,821,.435,65,170,.382,292,651,.449,156,194,.804,30,147,177,149,58,113,6,157,935,2005/2006
"Doleac,Michael",37,88,.420,0,0,,37,88,.420,24,30,.800,23,62,85,8,10,14,7,45,98,2005/2006
"Dooling,Keyon",178,405,.440,13,43,.302,165,362,.456,101,121,.835,11,67,78,109,49,82,4,116,470,2005/2006
"Duhon,Chris",215,538,.400,100,278,.360,115,260,.442,117,143,.818,28,192,220,373,70,117,3,152,647,2005/2006
"Duncan,Tim",574,1185,.484,2,5,.400,572,1180,.485,335,533,.629,231,650,881,253,70,198,162,219,1485,2005/2006
"Dunleavy,Mike",331,816,.406,74,260,.285,257,556,.462,196,252,.778,78,321,399,237,60,120,32,199,932,2005/2006
"Dupree,Ronald",33,63,.524,0,1,.000,33,62,.532,14,41,.341,21,28,49,14,12,14,0,44,80,2005/2006
"Edwards,John",31,64,.484,0,0,,31,64,.484,8,11,.727,18,30,48,5,3,12,15,76,70,2005/2006
"Eisley,Howard",34,103,.330,13,42,.310,21,61,.344,20,24,.833,3,30,33,69,11,21,2,34,101,2005/2006
"Eisley,Howard",4,17,.235,1,4,.250,3,13,.231,0,0,,1,13,14,25,3,3,0,11,9,2005/2006
"Eisley,Howard",30,86,.349,12,38,.316,18,48,.375,20,24,.833,2,17,19,44,8,18,2,23,92,2005/2006
"Ellis,Monta",132,318,.415,28,82,.341,104,236,.441,42,59,.712,22,83,105,78,32,58,11,69,334,2005/2006
"Elson,Francisco",151,284,.532,1,5,.200,150,279,.538,49,74,.662,99,240,339,47,54,65,45,211,352,2005/2006
"Ely,Melvin",216,425,.508,0,2,.000,216,423,.511,128,192,.667,94,183,277,76,29,100,44,160,560,2005/2006
"Evans,Maurice",154,341,.452,43,116,.371,111,225,.493,52,65,.800,76,87,163,60,41,39,15,122,403,2005/2006
"Evans,Reggie",131,268,.489,0,1,.000,131,267,.491,115,217,.530,171,331,502,38,40,85,10,166,377,2005/2006
"Evans,Reggie",88,173,.509,0,1,.000,88,172,.512,66,120,.550,114,162,276,23,24,41,5,95,242,2005/2006
"Evans,Reggie",43,95,.453,0,0,,43,95,.453,49,97,.505,57,169,226,15,16,44,5,71,135,2005/2006
"Ewing,Daniel",97,255,.380,22,78,.282,75,177,.424,36,46,.783,23,62,85,84,37,57,6,86,252,2005/2006
"Felix,Noel",6,25,.240,1,3,.333,5,22,.227,5,8,.625,3,10,13,2,2,8,3,13,18,2005/2006
"Felton,Raymond",345,883,.391,97,271,.358,248,612,.405,161,222,.725,77,188,265,446,102,182,8,181,948,2005/2006
"Finley,Michael",286,695,.412,110,279,.394,176,416,.423,98,115,.852,31,216,247,116,37,62,7,97,780,2005/2006
"Fisher,Derek",364,887,.410,117,295,.397,247,592,.417,244,293,.833,36,175,211,352,125,156,8,237,1089,2005/2006
"Fitch,Gerald",30,89,.337,7,26,.269,23,63,.365,17,23,.739,7,23,30,33,7,15,5,28,84,2005/2006
"Fizer,Marcus",9,17,.529,1,1,1.000,8,16,.500,1,2,.500,1,6,7,1,0,2,0,5,20,2005/2006
"Ford,Sharrod",2,3,.667,0,0,,2,3,.667,0,0,,1,2,3,0,0,2,1,7,4,2005/2006
"Ford,T.J.",328,789,.416,35,104,.337,293,685,.428,187,248,.754,63,248,311,473,104,219,7,196,878,2005/2006
"Fortson,Danny",27,51,.529,0,0,,27,51,.529,33,43,.767,31,47,78,2,4,26,2,76,87,2005/2006
"Foster,Jeff",138,250,.552,0,4,.000,138,246,.561,96,159,.604,224,350,574,50,41,64,27,191,372,2005/2006
"Foyle,Adonal",152,300,.507,0,0,,152,300,.507,41,67,.612,143,281,424,33,44,80,125,215,345,2005/2006
"Frahm,Richie",39,100,.390,23,70,.329,16,30,.533,7,10,.700,3,30,33,21,4,8,2,30,108,2005/2006
"Frahm,Richie",24,65,.369,15,48,.313,9,17,.529,3,5,.600,3,20,23,15,3,4,2,22,66,2005/2006
"Frahm,Richie",15,35,.429,8,22,.364,7,13,.538,4,5,.800,0,10,10,6,1,4,0,8,42,2005/2006
"Francis,Steve",333,765,.435,25,83,.301,308,682,.452,314,399,.787,74,216,290,345,74,214,17,204,1005,2005/2006
"Francis,Steve",249,575,.433,18,70,.257,231,505,.457,231,290,.797,60,159,219,262,51,156,11,142,747,2005/2006
"Francis,Steve",84,190,.442,7,13,.538,77,177,.435,83,109,.761,14,57,71,83,23,58,6,62,258,2005/2006
"Frye,Channing",305,640,.477,3,9,.333,302,631,.479,189,229,.825,138,236,374,53,30,97,47,200,802,2005/2006
"Gadzuric,Dan",171,309,.553,0,1,.000,171,308,.555,41,89,.461,91,141,232,24,25,35,43,171,383,2005/2006
"Gai,Deng",0,0,,0,0,,0,0,,0,0,,0,0,0,0,0,0,0,0,0,2005/2006
"Gaines,Reece",6,12,.500,0,2,.000,6,10,.600,1,4,.250,0,0,0,3,1,1,0,1,13,2005/2006
"García,Francisco",130,325,.400,39,137,.285,91,188,.484,78,101,.772,39,146,185,94,41,75,47,135,377,2005/2006
"Garnett,Kevin",626,1191,.526,8,30,.267,618,1161,.532,396,489,.810,214,752,966,308,104,180,107,206,1656,2005/2006
"Garrity,Pat",101,242,.417,50,129,.388,51,113,.451,30,37,.811,31,77,108,38,12,38,9,108,282,2005/2006
"Gasol,Pau",600,1194,.503,3,12,.250,597,1182,.505,425,617,.689,191,522,713,371,46,235,153,184,1628,2005/2006
"George,Devean",170,425,.400,50,160,.313,120,265,.453,58,86,.674,82,192,274,68,66,54,34,159,448,2005/2006
"Gill,Eddie",10,45,.222,7,23,.304,3,22,.136,18,23,.783,0,15,15,12,11,9,1,13,45,2005/2006
"Ginóbili,Manu",309,669,.462,83,217,.382,226,452,.500,280,360,.778,42,188,230,235,101,121,26,156,981,2005/2006
"Giriček,Gordan",166,383,.433,18,59,.305,148,324,.457,43,57,.754,15,55,70,63,16,63,4,87,393,2005/2006
"Goldwire,Anthony",1,7,.143,0,2,.000,1,5,.200,0,0,,0,1,1,2,0,1,0,0,2,2005/2006
"Gomes,Ryan",173,355,.487,3,9,.333,170,346,.491,112,149,.752,102,196,298,58,35,55,5,83,461,2005/2006
"Gooden,Drew",334,652,.512,1,3,.333,333,649,.513,176,258,.682,237,428,665,56,52,106,49,190,845,2005/2006
"Gordon,Ben",486,1152,.422,166,382,.435,320,770,.416,211,268,.787,43,176,219,240,75,180,5,238,1349,2005/2006
"Graham,Joey",198,414,.478,29,87,.333,169,327,.517,108,133,.812,57,187,244,60,37,92,13,228,533,2005/2006
"Graham,Stephen",21,54,.389,2,10,.200,19,44,.432,14,15,.933,5,22,27,7,5,13,2,31,58,2005/2006
"Graham,Stephen",6,16,.375,1,5,.200,5,11,.455,4,4,1.000,1,6,7,3,2,5,0,5,17,2005/2006
"Graham,Stephen",1,5,.200,1,4,.250,0,1,.000,2,2,1.000,0,3,3,1,0,1,0,3,5,2005/2006
"Graham,Stephen",14,33,.424,0,1,.000,14,32,.438,8,9,.889,4,13,17,3,3,7,2,23,36,2005/2006
"Granger,Danny",221,478,.462,30,93,.323,191,385,.496,115,148,.777,131,253,384,90,58,80,62,211,587,2005/2006
"Grant,Brian",27,65,.415,0,0,,27,65,.415,7,8,.875,11,46,57,7,5,7,3,45,61,2005/2006
"Green,Devin",6,28,.214,0,2,.000,6,26,.231,13,21,.619,10,14,24,7,3,5,0,13,25,2005/2006
"Green,Gerald",66,138,.478,6,20,.300,60,118,.508,29,37,.784,10,31,41,18,13,22,4,41,167,2005/2006
"Green,Willie",28,66,.424,10,19,.526,18,47,.383,4,5,.800,1,14,15,5,2,12,0,13,70,2005/2006
"Greene,Orien",100,253,.395,9,40,.225,91,213,.427,45,68,.662,37,108,145,129,77,109,10,181,254,2005/2006
"Griffin,Adrian",98,204,.480,0,2,.000,98,202,.485,41,53,.774,75,152,227,89,51,39,9,113,237,2005/2006
"Griffin,Eddie",130,370,.351,16,82,.195,114,288,.396,44,74,.595,107,282,389,40,13,43,148,125,320,2005/2006
"Grundy,Anthony",19,38,.500,5,15,.333,14,23,.609,9,14,.643,1,16,17,9,7,9,0,14,52,2005/2006
"Hamilton,Richard",649,1322,.491,55,120,.458,594,1202,.494,256,303,.845,84,172,256,275,52,173,16,207,1609,2005/2006
"Hamilton,Zendon",7,14,.500,0,0,,7,14,.500,12,18,.667,3,8,11,0,4,6,0,5,26,2005/2006
"Hamilton,Zendon",7,13,.538,0,0,,7,13,.538,11,16,.688,3,8,11,0,3,6,0,4,25,2005/2006
"Hamilton,Zendon",0,1,.000,0,0,,0,1,.000,1,2,.500,0,0,0,0,1,0,0,1,1,2005/2006
"Hardaway,Anfernee",4,14,.286,0,1,.000,4,13,.308,2,2,1.000,0,10,10,8,2,6,0,7,10,2005/2006
"Harpring,Matt",322,678,.475,14,39,.359,308,639,.482,227,313,.725,158,210,368,98,59,109,14,202,885,2005/2006
"Harrington,Al",551,1220,.452,66,191,.346,485,1029,.471,243,350,.694,132,391,523,238,85,195,14,301,1411,2005/2006
"Harrington,Othella",135,273,.495,0,0,,135,273,.495,77,123,.626,54,100,154,39,7,61,13,131,347,2005/2006
"Harris,Devin",190,405,.469,5,21,.238,185,384,.482,169,236,.716,26,99,125,177,53,84,16,121,554,2005/2006
"Harrison,David",148,294,.503,0,0,,148,294,.503,89,174,.511,84,170,254,14,23,79,59,193,385,2005/2006
"Hart,Jason",86,221,.389,9,31,.290,77,190,.405,37,56,.661,12,59,71,70,31,43,5,85,218,2005/2006
"Haslem,Udonis",300,591,.508,0,2,.000,300,589,.509,157,199,.789,167,467,634,95,50,80,17,216,757,2005/2006
"Hassell,Trenton",286,616,.464,7,23,.304,279,593,.470,131,176,.744,82,134,216,203,43,124,29,201,710,2005/2006
"Hayes,Chuck",59,105,.562,0,1,.000,59,104,.567,29,45,.644,67,112,179,14,26,12,14,76,147,2005/2006
"Hayes,Jarvis",77,183,.421,17,47,.362,60,136,.441,25,30,.833,19,57,76,27,16,22,1,38,196,2005/2006
"Haywood,Brendan",222,432,.514,0,0,,222,432,.514,131,224,.585,200,267,467,46,30,97,104,232,575,2005/2006
"Head,Luther",254,630,.403,113,313,.361,141,317,.445,86,123,.699,33,233,266,215,89,119,9,169,707,2005/2006
"Henderson,Alan",47,91,.516,0,0,,47,91,.516,33,49,.673,60,77,137,10,9,22,12,58,127,2005/2006
"Hilário,Nenê",0,1,.000,0,0,,0,1,.000,0,0,,0,0,0,0,0,2,0,1,0,2005/2006
"Hill,Grant",119,243,.490,2,8,.250,117,235,.498,78,102,.765,15,65,80,48,24,35,6,50,318,2005/2006
"Hinrich,Kirk",451,1078,.418,126,341,.370,325,737,.441,256,314,.815,29,259,288,514,94,188,21,251,1284,2005/2006
"Hodge,Julius",5,13,.385,0,0,,5,13,.385,3,8,.375,5,2,7,6,2,8,0,7,13,2005/2006
"Holcomb,Randy",1,1,1.000,0,0,,1,1,1.000,0,0,,1,0,1,0,0,0,0,2,2,2005/2006
"Horry,Robert",112,292,.384,53,144,.368,59,148,.399,44,68,.647,71,171,242,79,43,41,51,115,321,2005/2006
"House,Eddie",320,759,.422,123,316,.389,197,443,.445,33,41,.805,15,117,132,148,42,76,12,96,796,2005/2006
"Howard,Dwight",468,881,.531,0,2,.000,468,879,.532,356,598,.595,288,734,1022,125,65,217,115,277,1292,2005/2006
"Howard,Josh",350,743,.471,27,63,.429,323,680,.475,196,267,.734,123,248,371,111,68,79,26,167,923,2005/2006
"Howard,Juwan",394,859,.459,0,4,.000,394,855,.461,154,191,.806,168,367,535,112,49,133,8,235,942,2005/2006
"Hudson,Troy",127,333,.381,40,101,.396,87,232,.375,48,52,.923,8,36,44,106,12,40,4,55,342,2005/2006
"Hughes,Larry",192,469,.409,28,76,.368,164,393,.417,146,193,.756,26,135,161,131,53,99,21,117,558,2005/2006
"Humphries,Kris",77,203,.379,0,5,.000,77,198,.389,34,65,.523,56,101,157,30,23,31,16,82,188,2005/2006
"Hunter,Lindsey",37,100,.370,11,43,.256,26,57,.456,2,4,.500,10,30,40,62,19,20,1,44,87,2005/2006
"Hunter,Steven",175,291,.601,0,0,,175,291,.601,71,138,.514,110,161,271,17,12,64,76,120,421,2005/2006
"Iguodala,Andre",344,688,.500,56,158,.354,288,530,.543,263,349,.754,117,364,481,255,135,153,21,198,1007,2005/2006
"Ilgauskas,Zydrunas",450,889,.506,0,5,.000,450,884,.509,317,380,.834,245,346,591,91,38,155,136,280,1217,2005/2006
"Ilunga-Mbenga,Didier",32,60,.533,0,1,.000,32,59,.542,10,20,.500,19,37,56,2,6,16,25,47,74,2005/2006
"Iverson,Allen",815,1822,.447,72,223,.323,743,1599,.465,675,829,.814,44,188,232,532,140,248,10,121,2377,2005/2006
"Ivey,Royal",116,264,.439,4,10,.400,112,254,.441,24,33,.727,31,65,96,74,24,23,7,147,260,2005/2006
"Jack,Jarrett",189,428,.442,20,76,.263,169,352,.480,128,160,.800,18,142,160,219,41,102,2,138,526,2005/2006
"Jackson,Bobby",286,748,.382,129,332,.389,157,416,.377,107,146,.733,44,179,223,195,61,101,1,155,808,2005/2006
"Jackson,Jermaine",11,26,.423,1,4,.250,10,22,.455,12,14,.857,8,19,27,25,4,13,1,19,35,2005/2006
"Jackson,Jim",47,160,.294,18,74,.243,29,86,.337,9,13,.692,11,65,76,35,12,35,6,51,121,2005/2006
"Jackson,Jim",38,129,.295,14,63,.222,24,66,.364,9,13,.692,11,53,64,31,10,30,6,46,99,2005/2006
"Jackson,Jim",9,31,.290,4,11,.364,5,20,.250,0,0,,0,12,12,4,2,5,0,5,22,2005/2006
"Jackson,Luke",29,85,.341,12,36,.333,17,49,.347,26,33,.788,16,24,40,25,11,31,2,30,96,2005/2006
"Jackson,Marc",174,369,.472,1,2,.500,173,367,.471,66,82,.805,86,131,217,44,13,65,8,126,415,2005/2006
"Jackson,Marc",66,148,.446,0,0,,66,148,.446,38,48,.792,30,59,89,22,5,28,6,70,170,2005/2006
"Jackson,Marc",108,221,.489,1,2,.500,107,219,.489,28,34,.824,56,72,128,22,8,37,2,56,245,2005/2006
"Jackson,Stephen",472,1148,.411,117,339,.345,355,809,.439,268,341,.786,48,264,312,225,104,203,43,195,1329,2005/2006
"James,Jerome",56,121,.463,0,0,,56,121,.463,25,40,.625,39,52,91,12,3,51,23,104,137,2005/2006
"James,LeBron",875,1823,.480,127,379,.335,748,1444,.518,601,814,.738,75,481,556,521,123,260,66,181,2478,2005/2006
"James,Mike",576,1228,.469,169,382,.442,407,846,.481,283,338,.837,45,217,262,460,72,206,3,214,1604,2005/2006
"Jamison,Antawn",660,1494,.442,147,373,.394,513,1121,.458,217,297,.731,167,598,765,158,90,137,12,189,1684,2005/2006
"Jarić,Marko",226,566,.399,40,133,.301,186,433,.430,95,138,.688,60,173,233,293,108,127,21,189,587,2005/2006
"Jasikevičius,Šarūnas",170,429,.396,86,236,.364,84,193,.435,121,133,.910,19,134,153,227,40,116,4,108,547,2005/2006
"Jefferson,Al",189,379,.499,0,4,.000,189,375,.504,86,134,.642,97,202,299,30,30,62,46,166,464,2005/2006
"Jefferson,Richard",495,1005,.493,60,188,.319,435,817,.532,471,580,.812,95,439,534,297,59,174,17,193,1521,2005/2006
"Jeffries,Jared",187,415,.451,16,50,.320,171,365,.468,99,168,.589,164,215,379,148,58,99,50,223,489,2005/2006
"Johnson,Amir",7,10,.700,2,3,.667,5,7,.714,4,4,1.000,3,1,4,3,0,4,2,7,20,2005/2006
"Johnson,Anthony",267,603,.443,51,155,.329,216,448,.482,106,141,.752,31,137,168,324,63,115,22,132,691,2005/2006
"Johnson,DerMarr",132,306,.431,56,160,.350,76,146,.521,34,42,.810,19,77,96,55,25,46,26,86,354,2005/2006
"Johnson,Ervin",7,17,.412,0,0,,7,17,.412,1,2,.500,5,19,24,2,1,5,2,23,15,2005/2006
"Johnson,Joe",632,1395,.453,128,360,.356,504,1035,.487,261,330,.791,98,237,335,536,103,267,31,187,1653,2005/2006
"Johnson,Linton",61,149,.409,13,36,.361,48,113,.425,18,27,.667,40,82,122,14,12,28,12,61,153,2005/2006
"Johnson,Linton",5,10,.500,0,0,,5,10,.500,1,4,.250,0,7,7,2,2,4,0,7,11,2005/2006
"Johnson,Linton",56,139,.403,13,36,.361,43,103,.417,17,23,.739,40,75,115,12,10,24,12,54,142,2005/2006
"Jones,Dahntay",109,263,.414,3,21,.143,106,242,.438,60,93,.645,20,84,104,39,38,50,15,108,281,2005/2006
"Jones,Damon",190,491,.387,140,371,.377,50,120,.417,32,50,.640,14,119,133,169,37,55,1,112,552,2005/2006
"Jones,Dwayne",4,10,.400,0,0,,4,10,.400,6,13,.462,10,21,31,2,1,3,3,14,14,2005/2006
"Jones,Eddie",292,722,.404,133,374,.356,159,348,.457,168,215,.781,35,244,279,177,131,93,27,201,885,2005/2006
"Jones,Fred",233,559,.417,63,187,.337,170,372,.457,122,160,.763,18,152,170,154,55,107,20,142,651,2005/2006
"Jones,James",243,581,.418,110,285,.386,133,296,.449,103,121,.851,44,209,253,57,38,35,49,142,699,2005/2006
"Jones,Jumaine",298,736,.405,115,335,.343,183,401,.456,88,121,.727,105,271,376,63,68,74,22,200,799,2005/2006
"Kaman,Chris",369,706,.523,0,2,.000,369,704,.524,194,252,.770,187,563,750,79,45,176,108,269,932,2005/2006
"Kapono,Jason",79,177,.446,21,53,.396,58,124,.468,28,33,.848,12,59,71,37,7,20,3,89,207,2005/2006
"Kasun,Mario",31,69,.449,0,0,,31,69,.449,18,23,.783,24,36,60,3,2,15,3,69,80,2005/2006
"Khryapa,Viktor",158,342,.462,10,30,.333,148,312,.474,77,111,.694,114,193,307,88,50,84,29,209,403,2005/2006
"Kidd,Jason",366,905,.404,139,395,.352,227,510,.445,194,244,.795,86,494,580,672,150,192,29,157,1065,2005/2006
"Kirilenko,Andrei",336,730,.460,36,117,.308,300,613,.489,346,495,.699,161,391,552,299,102,203,220,162,1054,2005/2006
"Kleiza,Linas",77,173,.445,2,13,.154,75,160,.469,57,81,.704,38,78,116,15,10,16,13,87,213,2005/2006
"Knight,Brevin",308,772,.399,3,13,.231,305,759,.402,252,314,.803,35,188,223,610,157,164,4,202,871,2005/2006
"Korolev,Yaroslav",9,30,.300,2,7,.286,7,23,.304,7,10,.700,5,8,13,9,3,6,0,11,27,2005/2006
"Korver,Kyle",327,761,.430,184,438,.420,143,323,.443,101,119,.849,27,243,270,163,65,98,26,224,939,2005/2006
"Krstić,Nenad",447,881,.507,1,4,.250,446,877,.509,185,265,.698,182,331,513,88,32,133,63,297,1080,2005/2006
"Kukoč,Toni",116,298,.389,45,147,.306,71,151,.470,40,56,.714,26,124,150,139,33,66,17,87,317,2005/2006
"LaFrentz,Raef",238,552,.431,112,286,.392,126,266,.474,51,75,.680,80,326,406,115,29,65,72,273,639,2005/2006
"Lampe,Maciej",2,11,.182,0,0,,2,11,.182,0,2,.000,4,5,9,2,0,3,0,2,4,2005/2006
"Lampe,Maciej",0,4,.000,0,0,,0,4,.000,0,0,,1,3,4,2,0,1,0,2,0,2005/2006
"Lampe,Maciej",2,7,.286,0,0,,2,7,.286,0,2,.000,3,2,5,0,0,2,0,0,4,2005/2006
"Lee,David",137,230,.596,0,0,,137,230,.596,71,123,.577,109,194,303,43,30,51,20,124,345,2005/2006
"Lenard,Voshon",75,191,.393,25,78,.321,50,113,.442,16,31,.516,5,42,47,41,21,31,4,39,191,2005/2006
"Lenard,Voshon",42,103,.408,10,35,.286,32,68,.471,5,13,.385,2,26,28,18,8,11,2,21,99,2005/2006
"Lenard,Voshon",33,88,.375,15,43,.349,18,45,.400,11,18,.611,3,16,19,23,13,20,2,18,92,2005/2006
"Lewis,Rashard",538,1151,.467,142,370,.384,396,781,.507,350,428,.818,111,279,390,182,102,141,50,191,1568,2005/2006
"Livingston,Randy",0,2,.000,0,0,,0,2,.000,0,0,,1,3,4,1,1,1,0,6,0,2005/2006
"Livingston,Shaun",149,349,.427,1,8,.125,148,341,.434,53,77,.688,41,142,183,273,46,111,32,160,352,2005/2006
"Lucas III,John",14,36,.389,2,9,.222,12,27,.444,0,0,,2,3,5,12,5,7,0,6,30,2005/2006
"Lue,Tyronn",192,418,.459,58,127,.457,134,291,.460,118,138,.855,13,69,82,157,26,75,3,113,560,2005/2006
"Macijauskas,Arvydas",14,41,.341,3,12,.250,11,29,.379,13,15,.867,3,7,10,5,7,8,0,10,44,2005/2006
"Madsen,Mark",27,66,.409,0,7,.000,27,59,.458,20,47,.426,50,91,141,11,23,26,17,114,74,2005/2006
"Maggette,Corey",167,375,.445,24,71,.338,143,304,.470,212,256,.828,28,141,169,66,19,78,4,95,570,2005/2006
"Magloire,Jamaal",287,615,.467,0,0,,287,615,.467,178,333,.535,220,558,778,56,29,166,80,276,752,2005/2006
"Marbury,Stephon",349,774,.451,33,104,.317,316,670,.472,246,326,.755,25,150,175,382,63,157,4,143,977,2005/2006
"Marion,Shawn",716,1365,.525,96,290,.331,620,1075,.577,241,298,.809,249,710,959,143,160,125,137,223,1769,2005/2006
"Marks,Sean",37,71,.521,0,3,.000,37,68,.544,7,12,.583,12,31,43,7,5,7,7,21,81,2005/2006
"Marshall,Donyell",265,671,.395,128,395,.324,137,276,.496,92,123,.748,105,387,492,60,59,90,41,160,750,2005/2006
"Marshall,Rawle",24,60,.400,1,3,.333,23,57,.404,22,29,.759,8,23,31,10,8,15,7,17,71,2005/2006
"Martin,Darrick",34,97,.351,16,40,.400,18,57,.316,18,24,.750,2,18,20,57,17,15,0,42,102,2005/2006
"Martin,Kenyon",297,600,.495,5,22,.227,292,578,.505,121,170,.712,93,260,353,79,43,72,52,171,720,2005/2006
"Martin,Kevin",262,546,.480,66,179,.369,196,367,.534,188,222,.847,58,203,261,97,55,81,9,138,778,2005/2006
"Mason,Desmond",275,690,.399,1,6,.167,274,684,.401,206,302,.682,64,234,298,66,42,113,17,136,757,2005/2006
"Maxiell,Jason",23,54,.426,0,0,,23,54,.426,14,42,.333,12,16,28,3,4,11,5,14,60,2005/2006
"May,Sean",70,171,.409,0,5,.000,70,166,.422,49,64,.766,42,67,109,22,17,33,12,58,189,2005/2006
"McCants,Rashad",241,535,.450,67,180,.372,174,355,.490,78,106,.736,29,114,143,63,44,86,22,176,627,2005/2006
"McCarty,Walter",33,99,.333,10,45,.222,23,54,.426,12,21,.571,15,53,68,23,8,19,5,52,88,2005/2006
"McDyess,Antonio",285,560,.509,0,2,.000,285,558,.511,68,122,.557,156,280,436,90,46,76,48,220,638,2005/2006
"McGrady,Tracy",410,1011,.406,73,234,.312,337,777,.434,254,340,.747,46,261,307,225,59,120,41,88,1147,2005/2006
"McInnis,Jeff",63,143,.441,3,16,.188,60,127,.472,20,29,.690,11,39,50,52,11,29,2,37,149,2005/2006
"McKie,Aaron",3,12,.250,0,2,.000,3,10,.300,1,2,.500,3,17,20,11,5,2,0,7,7,2005/2006
"McLeod,Keith",120,340,.353,24,82,.293,96,258,.372,106,133,.797,11,67,78,151,42,76,9,131,370,2005/2006
"Medvedenko,Stanislav",1,2,.500,0,0,,1,2,.500,0,0,,0,0,0,1,0,0,0,1,2,2005/2006
"Mihm,Chris",230,459,.501,0,0,,230,459,.501,144,201,.716,137,236,373,61,16,83,73,214,604,2005/2006
"Miles,Aaron",6,18,.333,0,0,,6,18,.333,4,4,1.000,0,14,14,24,4,11,1,13,16,2005/2006
"Miles,C.J.",28,76,.368,5,20,.250,23,56,.411,18,24,.750,18,20,38,16,7,9,2,20,79,2005/2006
"Miles,Darius",235,510,.461,2,10,.200,233,500,.466,87,163,.534,24,158,182,73,42,99,39,100,559,2005/2006
"Miličić,Darko",119,234,.509,0,2,.000,119,232,.513,28,50,.560,44,107,151,41,14,51,77,92,266,2005/2006
"Miličić,Darko",17,33,.515,0,2,.000,17,31,.548,3,8,.375,10,18,28,9,3,15,15,25,37,2005/2006
"Miličić,Darko",102,201,.507,0,0,,102,201,.507,25,42,.595,34,89,123,32,11,36,62,67,229,2005/2006
"Miller,Andre",404,872,.463,5,27,.185,399,845,.472,313,424,.738,92,259,351,674,106,256,18,213,1126,2005/2006
"Miller,Brad",434,877,.495,34,88,.386,400,789,.507,280,338,.828,122,493,615,374,61,180,62,234,1182,2005/2006
"Miller,Mike",354,760,.466,138,339,.407,216,421,.513,168,210,.800,42,355,397,200,52,140,27,173,1014,2005/2006
"Ming,Yao",467,900,.519,0,1,.000,467,899,.519,337,395,.853,148,433,581,85,30,147,94,195,1271,2005/2006
"Mobley,Cuttino",429,1008,.426,83,245,.339,346,763,.453,229,273,.839,50,291,341,238,93,145,36,208,1170,2005/2006
"Mohammed,Nazr",190,377,.504,0,0,,190,377,.504,113,144,.785,163,255,418,40,21,91,49,220,493,2005/2006
"Monia,Sergei",29,87,.333,9,34,.265,20,53,.377,10,14,.714,11,41,52,19,7,12,5,41,77,2005/2006
"Monia,Sergei",29,85,.341,9,33,.273,20,52,.385,8,12,.667,11,40,51,19,6,12,5,41,75,2005/2006
"Monia,Sergei",0,2,.000,0,1,.000,0,1,.000,2,2,1.000,0,1,1,0,1,0,0,0,2,2005/2006
"Moore,Mikki",54,124,.435,0,2,.000,54,122,.443,46,62,.742,44,86,130,27,7,40,15,92,154,2005/2006
"Morris,Terence",16,49,.327,0,2,.000,16,47,.340,3,3,1.000,6,32,38,4,6,7,5,19,35,2005/2006
"Mourning,Alonzo",188,315,.597,0,1,.000,188,314,.599,133,224,.594,125,234,359,11,13,79,173,177,509,2005/2006
"Murphy,Troy",363,838,.433,58,181,.320,305,657,.464,251,319,.787,195,548,743,101,47,108,26,191,1035,2005/2006
"Murray,Lamond",72,181,.398,27,78,.346,45,103,.437,25,40,.625,29,103,132,13,17,22,7,66,196,2005/2006
"Murray,Ronald",321,768,.418,37,141,.262,284,627,.453,172,242,.711,33,120,153,197,68,135,11,133,851,2005/2006
"Murray,Ronald",179,451,.397,17,76,.224,162,375,.432,99,138,.717,18,68,86,120,30,79,4,69,474,2005/2006
"Murray,Ronald",142,317,.448,20,65,.308,122,252,.484,73,104,.702,15,52,67,77,38,56,7,64,377,2005/2006
"Mutombo,Dikembe",50,95,.526,0,0,,50,95,.526,69,91,.758,100,206,306,4,17,35,57,128,169,2005/2006
"N'Dong,Boniface",22,53,.415,0,1,.000,22,52,.423,6,9,.667,15,22,37,7,2,6,5,23,50,2005/2006
"Nachbar,Boštjan",54,156,.346,19,71,.268,35,85,.412,30,44,.682,8,52,60,27,16,24,5,65,157,2005/2006
"Nachbar,Boštjan",42,124,.339,17,57,.298,25,67,.373,25,36,.694,4,45,49,22,13,20,5,52,126,2005/2006
"Nachbar,Boštjan",12,32,.375,2,14,.143,10,18,.556,5,8,.625,4,7,11,5,3,4,0,13,31,2005/2006
"Nailon,Lee",40,80,.500,0,0,,40,80,.500,13,15,.867,23,19,42,7,8,10,4,32,93,2005/2006
"Nájera,Eduardo",127,301,.422,4,12,.333,123,289,.426,89,114,.781,128,197,325,52,53,54,34,165,347,2005/2006
"Nash,Steve",541,1056,.512,150,342,.439,391,714,.548,257,279,.921,47,286,333,826,61,276,12,120,1489,2005/2006
"Nelson,Jameer",347,719,.483,70,165,.424,277,554,.500,141,181,.779,39,141,180,302,70,148,9,174,905,2005/2006
"Nesterović,Rasho",172,334,.515,0,2,.000,172,332,.518,18,30,.600,114,195,309,33,21,53,88,209,362,2005/2006
"Newble,Ira",17,57,.298,3,13,.231,14,44,.318,11,16,.688,21,35,56,9,5,12,10,47,48,2005/2006
"Nocioni,Andrés",383,831,.461,93,238,.391,290,593,.489,204,242,.843,89,411,500,117,40,120,52,252,1063,2005/2006
"Norris,Moochie",46,112,.411,4,14,.286,42,98,.429,29,42,.690,12,42,54,50,20,33,1,49,125,2005/2006
"Norris,Moochie",26,65,.400,0,5,.000,26,60,.433,13,17,.765,9,25,34,29,14,16,1,31,65,2005/2006
"Norris,Moochie",20,47,.426,4,9,.444,16,38,.421,16,25,.640,3,17,20,21,6,17,0,18,60,2005/2006
"Nowitzki,Dirk",751,1564,.480,110,271,.406,641,1293,.496,539,598,.901,115,613,728,226,58,156,83,164,2151,2005/2006
"O'Neal,Jermaine",380,805,.472,3,10,.300,377,795,.474,261,368,.709,102,374,476,133,27,151,117,177,1024,2005/2006
"O'Neal,Shaquille",480,800,.600,0,0,,480,800,.600,221,471,.469,172,369,541,113,23,168,104,230,1181,2005/2006
"Oberto,Fabricio",44,93,.473,0,2,.000,44,91,.484,15,27,.556,57,66,123,27,9,28,11,91,103,2005/2006
"Odom,Lamar",445,925,.481,80,215,.372,365,710,.514,216,313,.690,181,557,738,443,75,213,64,256,1186,2005/2006
"Okafor,Emeka",131,316,.415,0,0,,131,316,.415,82,125,.656,94,167,261,31,22,53,50,88,344,2005/2006
"Okur,Mehmet",519,1128,.460,80,234,.342,439,894,.491,354,454,.780,211,535,746,194,40,163,73,285,1472,2005/2006
"Ollie,Kevin",75,174,.431,1,3,.333,74,171,.433,41,49,.837,13,85,98,101,33,29,3,103,192,2005/2006
"Olowokandi,Michael",107,240,.446,0,0,,107,240,.446,24,47,.511,50,170,220,23,22,55,33,122,238,2005/2006
"Olowokandi,Michael",87,195,.446,0,0,,87,195,.446,19,39,.487,45,134,179,17,19,41,27,100,193,2005/2006
"Olowokandi,Michael",20,45,.444,0,0,,20,45,.444,5,8,.625,5,36,41,6,3,14,6,22,45,2005/2006
"Ostertag,Greg",61,124,.492,0,0,,61,124,.492,24,48,.500,82,143,225,58,6,46,66,129,146,2005/2006
"Outlaw,Bo",35,58,.603,0,0,,35,58,.603,5,8,.625,31,46,77,14,10,17,12,50,75,2005/2006
"Outlaw,Travis",162,368,.440,14,53,.264,148,315,.470,62,89,.697,48,141,189,34,31,37,46,112,400,2005/2006
"Owens,Andre",27,74,.365,3,16,.188,24,58,.414,12,18,.667,11,10,21,8,5,13,0,25,69,2005/2006
"Pachulia,Zaza",307,681,.451,0,2,.000,307,679,.452,297,404,.735,264,349,613,129,89,180,39,286,911,2005/2006
"Padgett,Scott",71,201,.353,42,121,.347,29,80,.363,27,34,.794,56,109,165,41,28,21,12,90,211,2005/2006
"Palacio,Milt",171,403,.424,1,16,.063,170,387,.439,98,150,.653,17,117,134,190,47,110,14,125,441,2005/2006
"Pargo,Jannero",109,292,.373,39,103,.379,70,189,.370,17,21,.810,8,53,61,94,24,61,2,57,274,2005/2006
"Parker,Smush",348,779,.447,120,328,.366,228,451,.506,125,180,.694,37,234,271,302,140,147,16,213,941,2005/2006
"Parker,Tony",623,1136,.548,11,36,.306,612,1100,.556,253,358,.707,38,223,261,460,83,249,4,161,1510,2005/2006
"Patterson,Ruben",327,635,.515,1,13,.077,326,622,.524,203,338,.601,118,126,244,127,76,150,21,150,858,2005/2006
"Patterson,Ruben",188,379,.496,0,7,.000,188,372,.505,138,226,.611,73,81,154,60,42,82,12,79,514,2005/2006
"Patterson,Ruben",139,256,.543,1,6,.167,138,250,.552,65,112,.580,45,45,90,67,34,68,9,71,344,2005/2006
"Paul,Chris",407,947,.430,50,177,.282,357,770,.464,394,465,.847,61,339,400,611,175,183,6,218,1258,2005/2006
"Pavlović,Sasha",87,212,.410,35,96,.365,52,116,.448,32,49,.653,16,64,80,25,19,42,6,103,241,2005/2006
"Payton,Gary",230,547,.420,66,230,.287,164,317,.517,100,126,.794,34,199,233,257,71,102,10,169,626,2005/2006
"Perkins,Kendrick",137,266,.515,0,2,.000,137,264,.519,80,130,.615,140,264,404,69,21,107,105,199,354,2005/2006
"Peterson,Morris",478,1096,.436,177,448,.395,301,648,.465,241,294,.820,65,316,381,190,104,126,15,223,1374,2005/2006
"Petro,Johan",153,300,.510,0,0,,153,300,.510,47,75,.627,109,187,296,15,25,60,51,213,353,2005/2006
"Piatkowski,Eric",24,61,.393,9,33,.273,15,28,.536,2,5,.400,4,19,23,13,6,11,1,20,59,2005/2006
"Pierce,Paul",689,1462,.471,111,314,.354,578,1148,.503,627,812,.772,77,453,530,375,107,273,34,223,2116,2005/2006
"Piétrus,Mickaël",169,418,.404,56,176,.318,113,242,.467,87,143,.608,58,105,163,44,33,78,10,132,481,2005/2006
"Planinić,Zoran",66,183,.361,13,56,.232,53,127,.417,46,66,.697,14,60,74,53,20,43,4,91,191,2005/2006
"Podkolzin,Pavel",0,2,.000,0,0,,0,2,.000,3,6,.500,0,7,7,0,0,2,1,0,3,2005/2006
"Pollard,Scot",70,154,.455,0,0,,70,154,.455,29,38,.763,73,145,218,24,37,26,20,115,169,2005/2006
"Posey,James",159,395,.403,117,290,.403,42,105,.400,48,61,.787,33,286,319,89,54,58,20,196,483,2005/2006
"Potapenko,Vitaly",37,71,.521,0,0,,37,71,.521,10,17,.588,27,37,64,9,2,16,2,50,84,2005/2006
"Potapenko,Vitaly",32,64,.500,0,0,,32,64,.500,10,17,.588,26,36,62,7,2,14,2,44,74,2005/2006
"Potapenko,Vitaly",5,7,.714,0,0,,5,7,.714,0,0,,1,1,2,2,0,2,0,6,10,2005/2006
"Powell,Josh",37,81,.457,0,0,,37,81,.457,36,45,.800,28,53,81,9,7,22,4,52,110,2005/2006
"Price,Ronnie",21,58,.362,6,27,.222,15,31,.484,12,12,1.000,5,10,15,11,6,10,0,10,60,2005/2006
"Prince,Tayshaun",455,999,.455,64,183,.350,391,816,.479,182,238,.765,104,242,346,186,62,91,39,96,1156,2005/2006
"Profit,Laron",40,84,.476,3,18,.167,37,66,.561,21,24,.875,8,35,43,15,11,24,5,25,104,2005/2006
"Przybilla,Joel",131,239,.548,0,0,,131,239,.548,82,154,.532,146,245,391,43,20,76,130,149,344,2005/2006
"Radmanović,Vladimir",262,643,.407,138,354,.390,124,289,.429,93,114,.816,64,294,358,136,61,93,29,210,755,2005/2006
"Radmanović,Vladimir",154,384,.401,72,196,.367,82,188,.436,55,62,.887,39,148,187,72,32,53,15,130,435,2005/2006
"Radmanović,Vladimir",108,259,.417,66,158,.418,42,101,.416,38,52,.731,25,146,171,64,29,40,14,80,320,2005/2006
"Randolph,Shavlik",44,97,.454,0,0,,44,97,.454,43,71,.606,55,78,133,19,19,21,12,83,131,2005/2006
"Randolph,Zach",536,1229,.436,16,55,.291,520,1174,.443,245,343,.714,193,399,592,144,57,165,14,185,1333,2005/2006
"Ratliff,Theo",108,189,.571,0,0,,108,189,.571,54,83,.651,89,190,279,28,18,47,88,143,270,2005/2006
"Rebrača,Željko",52,96,.542,0,0,,52,96,.542,31,41,.756,13,51,64,9,5,24,19,59,135,2005/2006
"Redd,Michael",682,1516,.450,163,413,.395,519,1103,.471,501,571,.877,78,264,342,229,95,170,5,157,2028,2005/2006
"Reed,Justin",119,295,.403,0,1,.000,119,294,.405,87,120,.725,53,71,124,41,23,52,15,163,325,2005/2006
"Reed,Justin",25,74,.338,0,0,,25,74,.338,25,40,.625,13,16,29,7,5,15,4,45,75,2005/2006
"Reed,Justin",94,221,.425,0,1,.000,94,220,.427,62,80,.775,40,55,95,34,18,37,11,118,250,2005/2006
"Richardson,Jason",641,1438,.446,183,477,.384,458,961,.477,276,410,.673,105,333,438,232,97,167,37,206,1741,2005/2006
"Richardson,Quentin",163,459,.355,64,188,.340,99,271,.365,61,91,.670,65,165,230,88,39,56,6,134,451,2005/2006
"Ridnour,Luke",334,799,.418,43,149,.289,291,650,.448,199,227,.877,47,188,235,550,123,162,22,178,910,2005/2006
"Roberson,Anthony",14,31,.452,5,10,.500,9,21,.429,2,2,1.000,0,6,6,5,1,3,0,6,35,2005/2006
"Roberts,Lawrence",20,44,.455,0,2,.000,20,42,.476,11,23,.478,26,23,49,5,8,5,2,30,51,2005/2006
"Robinson,Bernard",157,365,.430,2,21,.095,155,344,.451,106,134,.791,62,157,219,77,81,74,10,141,422,2005/2006
"Robinson,Clifford",219,513,.427,60,175,.343,159,338,.470,52,79,.658,55,212,267,89,44,62,40,206,550,2005/2006
"Robinson,Nate",230,565,.407,58,146,.397,172,419,.411,152,202,.752,56,111,167,147,59,114,1,201,670,2005/2006
"Rose,Jalen",290,685,.423,59,172,.343,231,513,.450,248,318,.780,28,183,211,181,30,115,13,156,887,2005/2006
"Rose,Jalen",180,446,.404,31,115,.270,149,331,.450,166,217,.765,15,114,129,113,20,65,10,101,557,2005/2006
"Rose,Jalen",110,239,.460,28,57,.491,82,182,.451,82,101,.812,13,69,82,68,10,50,3,55,330,2005/2006
"Rose,Malik",105,281,.374,1,1,1.000,104,280,.371,107,137,.781,84,175,259,67,43,80,14,145,318,2005/2006
"Ross,Quinton",130,308,.422,0,7,.000,130,301,.432,57,75,.760,38,132,170,79,51,47,16,155,317,2005/2006
"Ruffin,Michael",34,77,.442,0,2,.000,34,75,.453,37,74,.500,122,149,271,27,33,38,31,179,105,2005/2006
"Rush,Kareem",181,469,.386,57,164,.348,124,305,.407,55,77,.714,18,85,103,50,38,65,13,79,474,2005/2006
"Russell,Bryon",0,0,,0,0,,0,0,,0,0,,0,1,1,1,0,0,0,0,0,2005/2006
"Salmons,John",219,521,.420,26,87,.299,193,434,.445,155,200,.775,48,172,220,223,73,125,13,178,619,2005/2006
"Sampson,Jamal",5,7,.714,0,0,,5,7,.714,0,2,.000,5,13,18,5,0,0,4,5,10,2005/2006
"Sanders,Melvin",16,33,.485,2,3,.667,14,30,.467,7,10,.700,4,19,23,3,5,8,0,20,41,2005/2006
"Scalabrine,Brian",74,193,.383,31,87,.356,43,106,.406,26,36,.722,27,87,114,51,21,50,19,127,205,2005/2006
"Scales,Alex",0,0,,0,0,,0,0,,0,0,,0,0,0,0,0,0,0,0,0,2005/2006
"Schenscher,Luke",16,26,.615,0,0,,16,26,.615,4,13,.308,8,21,29,7,1,5,3,21,36,2005/2006
"Seung-Jin,Ha",18,31,.581,0,0,,18,31,.581,8,17,.471,14,35,49,1,3,14,8,41,44,2005/2006
"Simien,Wayne",58,120,.483,0,0,,58,120,.483,30,34,.882,38,50,88,7,13,24,1,70,146,2005/2006
"Simmons,Bobby",366,808,.453,105,250,.420,261,558,.468,165,200,.825,91,242,333,172,86,123,21,254,1002,2005/2006
"Singleton,James",77,151,.510,10,20,.500,67,131,.511,39,50,.780,63,134,197,29,19,28,21,95,203,2005/2006
"Skinner,Brian",82,160,.513,0,0,,82,160,.513,27,56,.482,76,152,228,30,25,45,43,119,191,2005/2006
"Skinner,Brian",38,69,.551,0,0,,38,69,.551,12,27,.444,30,71,101,17,11,18,20,54,88,2005/2006
"Skinner,Brian",44,91,.484,0,0,,44,91,.484,15,29,.517,46,81,127,13,14,27,23,65,103,2005/2006
"Smith,Charles",30,72,.417,15,38,.395,15,34,.441,5,8,.625,3,13,16,9,5,4,6,28,80,2005/2006
"Smith,Charles",30,71,.423,15,37,.405,15,34,.441,5,8,.625,3,13,16,9,5,4,6,27,80,2005/2006
"Smith,Charles",0,1,.000,0,1,.000,0,0,,0,0,,0,0,0,0,0,0,0,1,0,2005/2006
"Smith,Donta",15,27,.556,2,4,.500,13,23,.565,6,12,.500,3,11,14,9,8,4,0,20,38,2005/2006
"Smith,J.R.",144,366,.393,52,140,.371,92,226,.407,83,101,.822,19,91,110,58,37,54,4,90,423,2005/2006
"Smith,Joe",145,305,.475,0,2,.000,145,303,.479,89,115,.774,83,147,230,31,24,40,13,120,379,2005/2006
"Smith,Josh",329,774,.425,34,110,.309,295,664,.444,210,292,.719,176,355,531,191,64,162,208,260,902,2005/2006
"Snow,Eric",163,399,.409,1,10,.100,162,389,.416,64,93,.688,38,160,198,346,76,116,19,218,391,2005/2006
"Snyder,Kirk",205,453,.453,46,129,.357,159,324,.491,86,117,.735,55,106,161,102,29,70,23,106,542,2005/2006
"Songaila,Darius",236,491,.481,2,5,.400,234,486,.481,94,115,.817,76,170,246,88,35,85,16,157,568,2005/2006
"Sow,Pape",53,123,.431,0,0,,53,123,.431,41,57,.719,54,92,146,8,21,30,19,118,147,2005/2006
"Stackhouse,Jerry",242,603,.401,36,130,.277,206,473,.436,195,221,.882,32,121,153,160,37,121,10,96,715,2005/2006
"Stevenson,DeShawn",359,781,.460,2,15,.133,357,766,.466,180,242,.744,59,182,241,160,58,123,17,178,900,2005/2006
"Stojaković,Peja",445,1018,.437,162,404,.401,283,614,.461,238,260,.915,79,336,415,136,45,103,10,171,1290,2005/2006
"Stojaković,Peja",171,424,.403,71,179,.397,100,245,.408,98,105,.933,34,131,165,68,19,51,2,82,511,2005/2006
"Stojaković,Peja",274,594,.461,91,225,.404,183,369,.496,140,155,.903,45,205,250,68,26,52,8,89,779,2005/2006
"Storey,Awvee",16,41,.390,3,7,.429,13,34,.382,8,14,.571,8,14,22,4,3,5,1,22,43,2005/2006
"Stoudamire,Damon",114,287,.397,36,104,.346,78,183,.426,53,62,.855,23,72,95,128,19,55,1,49,317,2005/2006
"Stoudamire,Salim",204,492,.415,82,216,.380,122,276,.442,99,110,.900,12,104,116,75,27,82,3,118,589,2005/2006
"Stoudemire,Amar'e",9,27,.333,0,1,.000,9,26,.346,8,9,.889,6,10,16,2,1,1,3,4,26,2005/2006
"Sweetney,Mike",200,444,.450,0,0,,200,444,.450,133,204,.652,118,232,350,59,19,95,56,209,533,2005/2006
"Swift,Robert",124,241,.515,0,0,,124,241,.515,53,91,.582,94,170,264,8,15,49,56,142,301,2005/2006
"Swift,Stromile",225,458,.491,0,2,.000,225,456,.493,136,209,.651,103,188,291,25,38,91,50,198,586,2005/2006
"Szczerbiak,Wally",493,1012,.487,102,255,.400,391,757,.517,278,310,.897,77,236,313,213,40,136,19,150,1366,2005/2006
"Szczerbiak,Wally",292,590,.495,58,143,.406,234,447,.523,163,182,.896,36,154,190,112,21,86,15,90,805,2005/2006
"Szczerbiak,Wally",201,422,.476,44,112,.393,157,310,.506,115,128,.898,41,82,123,101,19,50,4,60,561,2005/2006
"Taft,Chris",23,38,.605,0,0,,23,38,.605,1,6,.167,19,17,36,2,2,2,7,25,47,2005/2006
"Taylor,Donell",53,136,.390,4,17,.235,49,119,.412,30,43,.698,16,37,53,45,30,34,4,47,140,2005/2006
"Taylor,Maurice",182,389,.468,0,1,.000,182,388,.469,58,83,.699,65,164,229,53,21,103,14,177,422,2005/2006
"Telfair,Sebastian",228,578,.394,57,162,.352,171,416,.411,130,175,.743,19,101,120,247,66,115,6,167,643,2005/2006
"Terry,Jason",516,1099,.470,171,416,.411,345,683,.505,168,210,.800,31,127,158,306,100,135,27,196,1371,2005/2006
"Thomas,Billy",13,40,.325,10,30,.333,3,10,.300,2,2,1.000,5,9,14,9,10,6,1,19,38,2005/2006
"Thomas,Etan",131,246,.533,0,0,,131,246,.533,75,125,.600,99,180,279,14,20,51,68,148,337,2005/2006
"Thomas,James",10,19,.526,0,0,,10,19,.526,8,14,.571,12,27,39,1,0,7,3,35,28,2005/2006
"Thomas,James",7,13,.538,0,0,,7,13,.538,8,14,.571,8,23,31,1,0,7,3,32,22,2005/2006
"Thomas,James",3,6,.500,0,0,,3,6,.500,0,0,,4,4,8,0,0,0,0,3,6,2005/2006
"Thomas,John",6,15,.400,0,0,,6,15,.400,3,4,.750,10,10,20,2,3,8,2,17,15,2005/2006
"Thomas,John",2,2,1.000,0,0,,2,2,1.000,0,0,,0,0,0,1,0,2,1,3,4,2005/2006
"Thomas,John",3,7,.429,0,0,,3,7,.429,3,4,.750,3,7,10,1,2,4,0,10,9,2005/2006
"Thomas,John",1,6,.167,0,0,,1,6,.167,0,0,,7,3,10,0,1,2,1,4,2,2005/2006
"Thomas,Kenny",305,604,.505,0,1,.000,305,603,.506,138,204,.676,199,419,618,168,72,135,39,196,748,2005/2006
"Thomas,Kurt",190,391,.486,0,0,,190,391,.486,75,92,.815,102,313,415,57,23,57,54,193,455,2005/2006
"Thomas,Tim",113,262,.431,46,111,.414,67,151,.444,28,42,.667,22,109,131,20,16,33,7,78,300,2005/2006
"Thomas,Tim",6,16,.375,1,6,.167,5,10,.500,0,0,,0,4,4,2,0,1,1,1,13,2005/2006
"Thomas,Tim",107,246,.435,45,105,.429,62,141,.440,28,42,.667,22,105,127,18,16,32,6,77,287,2005/2006
"Thompson,Dijon",11,25,.440,4,11,.364,7,14,.500,2,2,1.000,4,7,11,1,3,2,1,6,28,2005/2006
"Tinsley,Jamaal",158,386,.409,16,70,.229,142,316,.449,58,91,.637,35,98,133,211,49,109,6,96,390,2005/2006
"Tsakalidis,Jake",100,165,.606,0,0,,100,165,.606,57,87,.655,78,134,212,13,14,39,32,107,257,2005/2006
"Tskitishvili,Nikoloz",13,37,.351,1,3,.333,12,34,.353,9,14,.643,9,13,22,3,1,6,2,8,36,2005/2006
"Tskitishvili,Nikoloz",1,4,.250,0,0,,1,4,.250,1,2,.500,0,2,2,0,0,2,0,0,3,2005/2006
"Tskitishvili,Nikoloz",12,33,.364,1,3,.333,11,30,.367,8,12,.667,9,11,20,3,1,4,2,8,33,2005/2006
"Turiaf,Ronny",15,30,.500,0,0,,15,30,.500,15,27,.556,11,26,37,8,3,7,10,30,45,2005/2006
"Türkoğlu,Hedo",398,877,.454,114,283,.403,284,594,.478,255,296,.861,70,263,333,216,70,130,21,234,1165,2005/2006
"Udoka,Ime",9,24,.375,1,3,.333,8,21,.381,3,6,.500,3,14,17,6,1,2,0,8,22,2005/2006
"Udrih,Beno",106,233,.455,24,70,.343,82,163,.503,39,50,.780,18,34,52,92,14,53,2,55,275,2005/2006
"Van Exel,Nick",136,343,.397,55,154,.357,81,189,.429,28,41,.683,6,85,91,123,16,57,3,60,355,2005/2006
"Van Horn,Keith",164,387,.424,50,136,.368,114,251,.454,94,113,.832,54,138,192,37,31,71,11,121,472,2005/2006
"Varejão,Anderson",79,150,.527,0,1,.000,79,149,.530,61,119,.513,77,158,235,19,31,27,19,118,219,2005/2006
"Vaughn,Jacque",107,245,.437,1,6,.167,106,239,.444,59,81,.728,16,75,91,123,42,52,1,140,274,2005/2006
"Villanueva,Charlie",435,940,.463,70,214,.327,365,726,.503,113,160,.706,181,340,521,88,60,99,63,247,1053,2005/2006
"Voskuhl,Jake",114,261,.437,1,3,.333,113,258,.438,41,60,.683,62,121,183,39,26,33,23,157,270,2005/2006
"Vroman,Jackson",26,66,.394,0,0,,26,66,.394,21,44,.477,33,53,86,11,12,21,11,78,73,2005/2006
"Vujačić,Sasha",108,312,.346,59,172,.343,49,140,.350,46,52,.885,33,126,159,139,48,50,3,150,321,2005/2006
"Wade,Dwyane",699,1413,.495,13,76,.171,686,1337,.513,629,803,.783,107,323,430,503,146,268,58,217,2040,2005/2006
"Wafer,Von",6,38,.158,2,17,.118,4,21,.190,6,8,.750,5,3,8,4,3,1,0,12,20,2005/2006
"Walker,Antoine",391,898,.435,137,383,.358,254,515,.493,81,129,.628,103,318,421,166,47,150,30,187,1000,2005/2006
"Walker,Samaki",0,2,.000,0,0,,0,2,.000,2,2,1.000,0,3,3,0,0,2,1,7,2,2005/2006
"Wallace,Ben",237,465,.510,0,4,.000,237,461,.514,123,296,.416,301,622,923,158,146,88,181,164,597,2005/2006
"Wallace,Gerald",317,589,.538,14,50,.280,303,539,.562,188,306,.614,123,289,412,96,138,99,115,150,836,2005/2006
"Wallace,Rasheed",459,1067,.430,155,434,.357,304,633,.480,136,183,.743,90,457,547,182,82,85,130,232,1209,2005/2006
"Walsh,Matt",1,1,1.000,0,0,,1,1,1.000,0,2,.000,0,0,0,0,0,1,0,0,2,2005/2006
"Walton,Luke",135,328,.412,18,55,.327,117,273,.429,57,76,.750,88,159,247,156,41,78,15,119,345,2005/2006
"Warrick,Hakim",101,228,.443,0,0,,101,228,.443,76,115,.661,43,101,144,30,14,56,21,113,278,2005/2006
"Watson,Earl",219,509,.430,110,272,.404,109,237,.460,75,111,.676,24,134,158,289,68,136,10,159,623,2005/2006
"Watson,Earl",121,282,.429,68,172,.395,53,110,.482,37,59,.627,17,69,86,160,37,75,7,95,347,2005/2006
"Watson,Earl",98,227,.432,42,100,.420,56,127,.441,38,52,.731,7,65,72,129,31,61,3,64,276,2005/2006
"Webber,Chris",617,1422,.434,21,77,.273,596,1345,.443,263,348,.756,184,557,741,256,103,182,62,219,1518,2005/2006
"Webster,Martell",139,348,.399,65,182,.357,74,166,.446,61,71,.859,29,101,130,34,21,43,14,90,404,2005/2006
"Wells,Bonzi",284,613,.463,10,45,.222,274,568,.482,129,190,.679,142,259,401,144,94,126,25,156,707,2005/2006
"Welsch,Jiří",86,222,.387,14,49,.286,72,173,.416,65,87,.747,22,89,111,62,34,41,1,65,251,2005/2006
"Wesley,David",226,561,.403,99,271,.365,127,290,.438,151,187,.807,24,154,178,204,59,120,6,212,702,2005/2006
"West,David",530,1036,.512,3,11,.273,527,1025,.514,199,236,.843,168,380,548,92,61,105,64,214,1262,2005/2006
"West,Delonte",333,684,.487,84,218,.385,249,466,.534,86,101,.851,57,232,289,329,84,133,46,197,836,2005/2006
"Whaley,Robert",23,57,.404,0,0,,23,57,.404,3,6,.500,16,27,43,17,7,14,8,41,49,2005/2006
"Wilcox,Chris",257,450,.571,0,2,.000,257,448,.574,112,153,.732,118,292,410,52,33,72,34,183,626,2005/2006
"Wilcox,Chris",90,168,.536,0,2,.000,90,166,.542,38,59,.644,46,127,173,18,15,32,21,103,218,2005/2006
"Wilcox,Chris",167,282,.592,0,0,,167,282,.592,74,94,.787,72,165,237,34,18,40,13,80,408,2005/2006
"Wilkins,Damien",193,435,.444,14,56,.250,179,379,.472,136,162,.840,79,113,192,107,72,85,12,144,536,2005/2006
"Wilks,Mike",29,90,.322,3,19,.158,26,71,.366,25,41,.610,9,30,39,32,14,24,1,34,86,2005/2006
"Wilks,Mike",17,59,.288,2,14,.143,15,45,.333,6,12,.500,6,21,27,18,8,15,1,27,42,2005/2006
"Wilks,Mike",12,31,.387,1,5,.200,11,26,.423,19,29,.655,3,9,12,14,6,9,0,7,44,2005/2006
"Williams,Aaron",91,176,.517,0,0,,91,176,.517,40,58,.690,64,117,181,17,17,30,21,138,222,2005/2006
"Williams,Aaron",10,19,.526,0,0,,10,19,.526,5,6,.833,5,10,15,1,4,5,3,28,25,2005/2006
"Williams,Aaron",81,157,.516,0,0,,81,157,.516,35,52,.673,59,107,166,16,13,25,18,110,197,2005/2006
"Williams,Alvin",0,3,.000,0,2,.000,0,1,.000,1,2,.500,0,3,3,0,0,0,0,0,1,2005/2006
"Williams,Deron",339,805,.421,91,219,.416,248,586,.423,95,135,.704,35,159,194,359,60,145,17,233,864,2005/2006
"Williams,Eric",29,75,.387,5,18,.278,24,57,.421,28,38,.737,10,40,50,15,7,15,2,55,91,2005/2006
"Williams,Jason",268,606,.442,107,288,.372,161,318,.506,85,98,.867,6,133,139,287,53,100,5,101,728,2005/2006
"Williams,Lou",23,52,.442,2,9,.222,21,43,.488,8,13,.615,3,16,19,10,5,13,0,13,56,2005/2006
"Williams,Marvin",235,531,.443,13,53,.245,222,478,.464,189,253,.747,122,261,383,63,48,83,24,227,672,2005/2006
"Williams,Mo",267,629,.424,73,191,.382,194,438,.443,96,113,.850,30,113,143,230,52,105,7,146,703,2005/2006
"Williamson,Corliss",43,103,.417,2,2,1.000,41,101,.406,38,49,.776,21,46,67,14,7,30,4,56,126,2005/2006
"Woods,Loren",28,59,.475,0,1,.000,28,58,.483,6,14,.429,44,66,110,4,9,16,23,49,62,2005/2006
"Woods,Qyntel",129,254,.508,22,60,.367,107,194,.552,49,76,.645,44,146,190,47,32,61,13,96,329,2005/2006
"World Peace,Metta",350,867,.404,78,253,.308,272,614,.443,206,305,.675,75,211,286,203,122,131,41,164,984,2005/2006
"World Peace,Metta",109,237,.460,18,54,.333,91,183,.497,74,121,.612,26,52,78,35,42,43,11,45,310,2005/2006
"World Peace,Metta",241,630,.383,60,199,.302,181,431,.420,132,184,.717,49,159,208,168,80,88,30,119,674,2005/2006
"Wright,Antoine",29,81,.358,1,15,.067,28,66,.424,11,22,.500,8,22,30,12,4,21,3,42,70,2005/2006
"Wright,Bracey",21,51,.412,6,17,.353,15,34,.441,14,16,.875,3,15,18,5,1,8,0,8,62,2005/2006
"Wright,Dorell",20,43,.465,3,6,.500,17,37,.459,15,17,.882,2,30,32,8,3,14,1,12,58,2005/2006
"Wright,Lorenzen",194,406,.478,0,2,.000,194,404,.480,66,117,.564,142,253,395,48,52,67,46,201,454,2005/2006
"Zimmerman,Derrick",2,3,.667,0,0,,2,3,.667,0,0,,1,3,4,7,0,4,0,4,4,2005/2006
"Abdur-Rahim,Shareef",310,654,.474,3,20,.150,307,634,.484,170,234,.726,122,276,398,109,53,116,40,243,793,2006/2007
"Adams,Hassan",75,135,.556,0,1,.000,75,134,.560,24,36,.667,35,42,77,13,17,22,4,47,174,2006/2007
"Ager,Maurice",22,70,.314,5,15,.333,17,55,.309,20,33,.606,1,20,21,7,4,15,3,27,69,2006/2007
"Aldridge,LaMarcus",241,479,.503,0,2,.000,241,477,.505,83,115,.722,144,168,312,24,22,43,73,186,565,2006/2007
"Allen,Malik",107,258,.415,0,1,.000,107,257,.416,28,34,.824,42,77,119,16,17,21,16,85,242,2006/2007
"Allen,Ray",505,1153,.438,165,443,.372,340,710,.479,279,309,.903,57,190,247,228,82,154,11,113,1454,2006/2007
"Allen,Tony",133,259,.514,8,33,.242,125,226,.553,105,134,.784,35,89,124,56,49,75,12,87,379,2006/2007
"Alston,Rafer",383,1020,.375,192,529,.363,191,491,.389,130,177,.734,29,253,282,444,129,170,10,195,1088,2006/2007
"Amundson,Lou",6,15,.400,0,0,,6,15,.400,4,10,.400,13,15,28,1,1,5,8,15,16,2006/2007
"Amundson,Lou",0,0,,0,0,,0,0,,0,0,,0,0,0,0,0,0,0,0,0,2006/2007
"Amundson,Lou",6,15,.400,0,0,,6,15,.400,4,10,.400,13,15,28,1,1,5,8,15,16,2006/2007
"Anderson,Alan",37,81,.457,5,20,.250,32,61,.525,19,23,.826,11,21,32,21,7,22,0,33,98,2006/2007
"Anderson,Derek",126,294,.429,54,152,.355,72,142,.507,93,106,.877,29,84,113,133,52,56,7,115,399,2006/2007
"Anthony,Carmelo",691,1453,.476,40,149,.268,651,1304,.499,459,568,.808,143,248,391,249,77,234,23,203,1881,2006/2007
"Araújo,Rafael",27,65,.415,0,0,,27,65,.415,18,29,.621,22,44,66,10,6,17,2,39,72,2006/2007
"Arenas,Gilbert",647,1548,.418,205,584,.351,442,964,.459,606,718,.844,61,277,338,443,139,236,13,249,2105,2006/2007
"Ariza,Trevor",200,371,.539,0,7,.000,200,364,.549,106,171,.620,98,151,249,65,59,84,19,134,506,2006/2007
"Armstrong,Darrell",156,377,.414,72,214,.336,84,163,.515,73,93,.785,34,101,135,191,70,76,6,102,457,2006/2007
"Armstrong,Hilton",68,125,.544,0,0,,68,125,.544,40,67,.597,58,91,149,10,12,35,26,79,176,2006/2007
"Arroyo,Carlos",203,478,.425,14,51,.275,189,427,.443,132,166,.795,31,103,134,202,39,90,2,131,552,2006/2007
"Atkins,Chucky",310,715,.434,116,306,.379,194,409,.474,252,311,.810,18,121,139,346,50,127,4,136,988,2006/2007
"Augustine,James",1,3,.333,0,0,,1,3,.333,0,0,,1,2,3,2,0,0,0,2,2,2006/2007
"Azubuike,Kelenna",98,220,.445,34,79,.430,64,141,.454,61,78,.782,26,68,94,28,22,39,10,49,291,2006/2007
"Balkman,Renaldo",139,275,.505,5,27,.185,134,248,.540,51,90,.567,97,197,294,44,57,49,44,146,334,2006/2007
"Banks,Marcus",84,196,.429,5,29,.172,79,167,.473,48,60,.800,10,28,38,60,23,40,3,70,221,2006/2007
"Barbosa,Leandro",529,1111,.476,190,438,.434,339,673,.504,196,232,.845,22,192,214,317,96,146,15,210,1444,2006/2007
"Barea,J.J.",28,78,.359,6,21,.286,22,57,.386,16,24,.667,7,18,25,24,1,14,1,19,78,2006/2007
"Bargnani,Andrea",267,625,.427,100,268,.373,167,357,.468,117,142,.824,52,203,255,50,32,107,53,180,751,2006/2007
"Barnes,Matt",275,628,.438,106,290,.366,169,338,.500,90,123,.732,91,259,350,156,73,105,41,188,746,2006/2007
"Barrett,Andre",4,8,.500,0,0,,4,8,.500,0,0,,1,4,5,7,0,4,0,4,8,2006/2007
"Barron,Earl",24,83,.289,0,1,.000,24,82,.293,17,18,.944,19,22,41,5,6,11,4,21,65,2006/2007
"Barry,Brent",202,425,.475,128,287,.446,74,138,.536,103,117,.880,17,143,160,138,56,61,12,88,635,2006/2007
"Bass,Brandon",15,44,.341,0,1,.000,15,43,.349,12,16,.750,13,30,43,3,2,10,3,16,42,2006/2007
"Baston,Maceo",49,76,.645,3,7,.429,46,69,.667,37,47,.787,21,53,74,16,12,32,18,65,138,2006/2007
"Batista,Esteban",8,16,.500,0,0,,8,16,.500,4,7,.571,7,23,30,4,3,4,0,13,20,2006/2007
"Battie,Tony",176,360,.489,0,1,.000,176,359,.490,52,77,.675,92,252,344,35,29,61,30,185,404,2006/2007
"Battier,Shane",292,654,.446,157,373,.421,135,281,.480,88,113,.779,67,271,338,175,79,72,60,190,829,2006/2007
"Bell,Charlie",426,974,.437,127,361,.352,299,613,.488,131,168,.780,57,181,238,247,97,104,4,213,1110,2006/2007
"Bell,Raja",410,950,.432,205,496,.413,205,454,.452,118,152,.776,48,203,251,196,50,83,22,233,1143,2006/2007
"Bibby,Mike",471,1166,.404,173,481,.360,298,685,.435,288,347,.830,39,224,263,388,88,197,6,139,1403,2006/2007
"Biedriņš,Andris",348,581,.599,0,0,,348,581,.599,87,167,.521,251,511,762,88,67,119,136,304,783,2006/2007
"Billups,Chauncey",348,815,.427,109,316,.345,239,499,.479,386,437,.883,23,214,237,502,84,140,17,161,1191,2006/2007
"Blake,Steve",209,509,.411,67,208,.322,142,301,.472,43,64,.672,21,148,169,408,61,129,8,121,528,2006/2007
"Blake,Steve",45,129,.349,19,68,.279,26,61,.426,11,20,.550,7,38,45,84,10,28,3,49,120,2006/2007
"Blake,Steve",164,380,.432,48,140,.343,116,240,.483,32,44,.727,14,110,124,324,51,101,5,72,408,2006/2007
"Blalock,Will",9,30,.300,1,5,.200,8,25,.320,6,6,1.000,6,9,15,17,5,12,0,9,25,2006/2007
"Blatche,Andray",86,197,.437,4,27,.148,82,170,.482,30,49,.612,77,114,191,39,17,49,32,94,206,2006/2007
"Blount,Mark",427,839,.509,9,31,.290,418,808,.517,147,195,.754,136,369,505,67,43,159,58,239,1010,2006/2007
"Bogans,Keith",99,245,.404,53,137,.387,46,108,.426,47,63,.746,16,77,93,59,28,46,2,98,298,2006/2007
"Bogut,Andrew",348,629,.553,1,5,.200,347,624,.556,112,194,.577,168,416,584,198,49,150,35,216,809,2006/2007
"Bonner,Matt",106,237,.447,36,94,.383,70,143,.490,27,38,.711,64,92,156,22,17,25,11,67,275,2006/2007
"Boone,Josh",99,171,.579,0,0,,99,171,.579,56,103,.544,64,112,176,10,11,33,21,94,254,2006/2007
"Booth,Calvin",31,66,.470,1,2,.500,30,64,.469,6,10,.600,27,54,81,18,4,9,29,71,69,2006/2007
"Boozer,Carlos",647,1154,.561,0,0,,647,1154,.561,255,372,.685,235,632,867,221,70,194,21,217,1549,2006/2007
"Bosh,Chris",543,1094,.496,12,35,.343,531,1059,.501,463,590,.785,186,555,741,175,39,179,90,163,1561,2006/2007
"Bowen,Bruce",189,467,.405,89,232,.384,100,235,.426,43,73,.589,23,200,223,117,62,65,25,175,510,2006/2007
"Boykins,Earl",323,769,.420,95,239,.397,228,530,.430,220,245,.898,49,90,139,291,56,120,2,92,961,2006/2007
"Boykins,Earl",156,378,.413,41,110,.373,115,268,.429,119,131,.908,23,40,63,132,25,52,2,31,472,2006/2007
"Boykins,Earl",167,391,.427,54,129,.419,113,262,.431,101,114,.886,26,50,76,159,31,68,0,61,489,2006/2007
"Bozeman,Cedric",11,39,.282,2,13,.154,9,26,.346,2,6,.333,3,20,23,9,5,9,2,32,26,2006/2007
"Brand,Elton",645,1211,.533,1,1,1.000,644,1210,.532,351,461,.761,268,476,744,235,77,202,179,238,1642,2006/2007
"Brewer,Ronnie",102,193,.528,0,9,.000,102,184,.554,56,83,.675,37,38,75,24,37,24,6,44,260,2006/2007
"Brezec,Primož",122,274,.445,1,3,.333,121,271,.446,43,68,.632,80,104,184,23,11,38,23,161,288,2006/2007
"Brown,Andre",42,74,.568,0,1,.000,42,73,.575,9,15,.600,26,48,74,2,6,29,4,26,93,2006/2007
"Brown,Dee",32,98,.327,6,28,.214,26,70,.371,24,37,.649,8,32,40,83,22,31,7,51,94,2006/2007
"Brown,Devin",233,555,.420,81,227,.357,152,328,.463,123,155,.794,55,196,251,149,44,91,9,139,670,2006/2007
"Brown,Kwame",143,242,.591,0,1,.000,143,241,.593,59,134,.440,81,163,244,75,39,76,49,124,345,2006/2007
"Brown,P.J.",170,418,.407,0,2,.000,170,416,.409,96,122,.787,129,218,347,48,24,85,52,187,436,2006/2007
"Brown,Shannon",28,74,.378,7,25,.280,21,49,.429,10,14,.714,6,15,21,10,7,14,3,24,73,2006/2007
"Bryant,Kobe",813,1757,.463,137,398,.344,676,1359,.497,667,768,.868,75,364,439,413,111,255,36,205,2430,2006/2007
"Buckner,Greg",123,299,.411,32,103,.311,91,196,.464,27,34,.794,35,123,158,70,47,40,7,152,305,2006/2007
"Burke,Pat",23,65,.354,6,22,.273,17,43,.395,8,13,.615,12,35,47,5,3,7,2,19,60,2006/2007
"Butler,Caron",451,975,.463,18,72,.250,433,903,.480,283,328,.863,147,320,467,233,134,181,17,188,1203,2006/2007
"Butler,Jackie",16,35,.457,0,0,,16,35,.457,9,10,.900,6,16,22,5,2,10,0,16,41,2006/2007
"Butler,Rasual",314,788,.398,134,363,.369,180,425,.424,56,87,.644,42,214,256,63,40,67,54,148,818,2006/2007
"Bynum,Andrew",247,443,.558,0,3,.000,247,440,.561,143,214,.668,139,345,484,94,12,115,128,249,637,2006/2007
"Calderón,José",263,505,.521,25,75,.333,238,430,.553,117,143,.818,21,113,134,387,63,110,5,136,668,2006/2007
"Camby,Marcus",312,659,.473,0,2,.000,312,657,.475,161,221,.729,164,652,816,223,87,122,231,183,785,2006/2007
"Cardinal,Brian",42,85,.494,18,44,.409,24,41,.585,25,27,.926,13,46,59,31,22,23,1,42,127,2006/2007
"Carney,Rodney",182,392,.464,25,72,.347,157,320,.491,53,87,.609,39,89,128,26,38,43,23,118,442,2006/2007
"Carroll,Matt",285,658,.433,111,267,.416,174,391,.445,188,208,.904,35,172,207,91,53,73,9,176,869,2006/2007
"Carter,Anthony",3,8,.375,0,2,.000,3,6,.500,0,0,,0,3,3,11,0,6,1,4,6,2006/2007
"Carter,Vince",726,1598,.454,156,437,.357,570,1161,.491,462,576,.802,114,378,492,393,82,217,30,266,2070,2006/2007
"Cassell,Sam",261,625,.418,32,109,.294,229,516,.444,160,182,.879,27,140,167,270,28,101,8,126,714,2006/2007
"Cato,Kelvin",7,22,.318,0,0,,7,22,.318,8,12,.667,12,19,31,0,3,6,10,10,22,2006/2007
"Chandler,Tyson",292,468,.624,0,1,.000,292,467,.625,106,201,.527,320,584,904,66,37,126,129,244,690,2006/2007
"Childress,Josh",261,518,.504,26,77,.338,235,441,.533,167,210,.795,123,217,340,127,58,80,36,118,715,2006/2007
"Christie,Doug",5,17,.294,1,6,.167,4,11,.364,2,3,.667,3,8,11,8,3,5,1,11,13,2006/2007
"Claxton,Speedy",91,278,.327,6,28,.214,85,250,.340,33,60,.550,12,69,81,185,72,75,4,131,221,2006/2007
"Collins,Jarron",75,170,.441,0,0,,75,170,.441,54,83,.651,71,100,171,60,13,37,8,147,204,2006/2007
"Collins,Jason",55,151,.364,0,2,.000,55,149,.369,59,127,.465,90,226,316,46,40,73,38,273,169,2006/2007
"Collins,Mardy",87,228,.382,13,47,.277,74,181,.409,48,82,.585,28,76,104,83,32,57,3,75,235,2006/2007
"Collison,Nick",318,636,.500,0,2,.000,318,634,.502,154,199,.774,229,437,666,82,48,123,66,289,790,2006/2007
"Conroy,Will",0,3,.000,0,0,,0,3,.000,0,4,.000,3,4,7,9,0,2,0,7,0,2006/2007
"Conroy,Will",0,0,,0,0,,0,0,,0,0,,1,1,2,1,0,0,0,1,0,2006/2007
"Conroy,Will",0,3,.000,0,0,,0,3,.000,0,4,.000,2,3,5,8,0,2,0,6,0,2006/2007
"Cook,Brian",185,408,.453,46,115,.400,139,293,.474,34,47,.723,61,154,215,65,25,51,27,134,450,2006/2007
"Crawford,Jamal",354,886,.400,103,322,.320,251,564,.445,228,272,.838,44,145,189,259,57,162,8,114,1039,2006/2007
"Croshere,Austin",78,222,.351,26,91,.286,52,131,.397,45,52,.865,33,153,186,44,14,33,6,68,227,2006/2007
"Curry,Eddy",585,1016,.576,1,1,1.000,584,1015,.575,405,659,.615,195,376,571,68,34,295,40,265,1576,2006/2007
"Dalembert,Samuel",356,658,.541,0,2,.000,356,656,.543,167,224,.746,239,494,733,64,47,161,159,287,879,2006/2007
"Dampier,Erick",209,334,.626,0,0,,209,334,.626,119,191,.623,217,349,566,44,24,107,82,239,537,2006/2007
"Daniels,Antonio",172,389,.442,19,63,.302,153,326,.469,208,250,.832,18,133,151,290,39,69,9,79,571,2006/2007
"Daniels,Marquis",129,281,.459,6,26,.231,123,255,.482,56,80,.700,26,56,82,57,27,55,7,56,320,2006/2007
"Davis,Baron",452,1030,.439,85,280,.304,367,750,.489,275,369,.745,51,225,276,509,135,193,29,181,1264,2006/2007
"Davis,Dale",33,74,.446,0,0,,33,74,.446,17,26,.654,59,78,137,12,10,15,34,59,83,2006/2007
"Davis,Paul",22,52,.423,0,0,,22,52,.423,7,10,.700,21,23,44,7,6,8,5,28,51,2006/2007
"Davis,Ricky",506,1089,.465,123,310,.397,383,779,.492,239,285,.839,54,261,315,385,80,210,23,189,1374,2006/2007
"Delfino,Carlos",156,376,.415,46,138,.333,110,238,.462,70,89,.787,67,199,266,88,46,61,8,97,428,2006/2007
"Deng,Luol",630,1218,.517,1,7,.143,629,1211,.519,279,359,.777,148,431,579,204,97,153,48,167,1540,2006/2007
"Diaw,Boris",306,569,.538,15,45,.333,291,524,.555,82,120,.683,91,226,317,352,28,154,38,177,709,2006/2007
"Diawara,Yakhouba",100,292,.342,49,170,.288,51,122,.418,35,53,.660,27,83,110,55,30,37,7,132,284,2006/2007
"Dickau,Dan",54,151,.358,16,61,.262,38,90,.422,42,53,.792,7,36,43,70,14,27,1,55,166,2006/2007
"Diener,Travis",34,80,.425,18,50,.360,16,30,.533,12,15,.800,3,15,18,35,4,13,0,27,98,2006/2007
"Diogu,Ike",127,266,.477,0,0,,127,266,.477,112,140,.800,75,128,203,25,8,67,26,122,366,2006/2007
"Diogu,Ike",44,83,.530,0,0,,44,83,.530,35,44,.795,21,42,63,5,3,18,11,35,123,2006/2007
"Diogu,Ike",83,183,.454,0,0,,83,183,.454,77,96,.802,54,86,140,20,5,49,15,87,243,2006/2007
"Diop,DeSagana",71,151,.470,0,1,.000,71,150,.473,48,86,.558,166,272,438,30,40,63,113,244,190,2006/2007
"Dixon,Juan",299,703,.425,79,226,.350,220,477,.461,101,116,.871,27,131,158,123,76,101,9,177,778,2006/2007
"Dixon,Juan",189,444,.426,52,143,.364,137,301,.455,60,72,.833,16,69,85,82,49,77,7,112,490,2006/2007
"Dixon,Juan",110,259,.425,27,83,.325,83,176,.472,41,44,.932,11,62,73,41,27,24,2,65,288,2006/2007
"Doleac,Michael",82,175,.469,0,1,.000,82,174,.471,36,41,.878,44,111,155,22,18,30,15,96,200,2006/2007
"Dooling,Keyon",188,458,.410,31,96,.323,157,362,.434,114,141,.809,22,64,86,112,52,72,15,125,521,2006/2007
"Douby,Quincy",48,126,.381,12,50,.240,36,76,.474,11,15,.733,11,26,37,15,15,15,4,21,119,2006/2007
"Duhon,Chris",197,483,.408,88,245,.359,109,238,.458,76,101,.752,23,146,169,310,69,105,6,150,558,2006/2007
"Duncan,Tim",618,1131,.546,1,9,.111,617,1122,.550,362,568,.637,213,633,846,273,66,224,190,203,1599,2006/2007
"Dunleavy,Mike",384,850,.452,70,224,.313,314,626,.502,211,269,.784,84,347,431,228,84,149,22,203,1049,2006/2007
"Dunleavy,Mike",166,370,.449,36,104,.346,130,266,.489,78,101,.772,40,147,187,117,38,71,12,83,446,2006/2007
"Dunleavy,Mike",218,480,.454,34,120,.283,184,360,.511,133,168,.792,44,200,244,111,46,78,10,120,603,2006/2007
"Dupree,Ronald",11,31,.355,0,0,,11,31,.355,3,9,.333,5,12,17,5,5,3,1,12,25,2006/2007
"Ellis,Monta",480,1010,.475,39,143,.273,441,867,.509,273,358,.763,62,181,243,319,132,221,21,210,1272,2006/2007
"Elson,Francisco",144,282,.511,0,2,.000,144,280,.514,62,80,.775,81,255,336,55,31,86,59,184,350,2006/2007
"Ely,Melvin",29,80,.363,0,0,,29,80,.363,31,47,.660,15,38,53,18,6,28,8,51,89,2006/2007
"Ely,Melvin",23,60,.383,0,0,,23,60,.383,24,35,.686,12,27,39,14,2,23,6,39,70,2006/2007
"Ely,Melvin",6,20,.300,0,0,,6,20,.300,7,12,.583,3,11,14,4,4,5,2,12,19,2006/2007
"Evans,Maurice",234,542,.432,48,133,.361,186,409,.455,122,155,.787,93,128,221,74,38,57,14,126,638,2006/2007
"Evans,Reggie",117,215,.544,0,0,,117,215,.544,91,183,.497,156,304,460,45,42,95,16,144,325,2006/2007
"Ewing,Daniel",65,161,.404,14,44,.318,51,117,.436,35,45,.778,9,64,73,90,32,50,4,62,179,2006/2007
"Farmar,Jordan",124,294,.422,45,137,.328,79,157,.503,27,38,.711,22,97,119,137,44,73,7,77,320,2006/2007
"Farmer,Desmon",5,15,.333,2,8,.250,3,7,.429,1,1,1.000,0,1,1,9,1,1,0,2,13,2006/2007
"Felton,Raymond",393,1024,.384,103,312,.330,290,712,.407,204,256,.797,51,216,267,545,118,230,10,180,1093,2006/2007
"Finley,Michael",273,663,.412,104,286,.364,169,377,.448,90,98,.918,34,189,223,108,32,46,16,76,740,2006/2007
"Fisher,Derek",258,675,.382,48,156,.308,210,519,.405,262,307,.853,30,119,149,274,83,120,6,234,826,2006/2007
"Ford,T.J.",393,902,.436,21,69,.304,372,833,.447,240,293,.819,53,183,236,595,101,231,8,186,1047,2006/2007
"Fortson,Danny",15,30,.500,0,1,.000,15,29,.517,10,13,.769,13,30,43,1,1,15,0,38,40,2006/2007
"Foster,Jeff",122,260,.469,0,1,.000,122,259,.471,78,122,.639,253,356,609,57,62,70,37,202,322,2006/2007
"Foye,Randy",300,691,.434,68,185,.368,232,506,.458,164,192,.854,49,169,218,232,53,152,21,184,832,2006/2007
"Foyle,Adonal",48,85,.565,0,0,,48,85,.565,11,25,.440,51,75,126,19,11,23,50,61,107,2006/2007
"Francis,Steve",140,343,.408,42,111,.378,98,232,.422,175,211,.829,33,124,157,170,41,100,12,126,497,2006/2007
"Freije,Matt",16,54,.296,3,22,.136,13,32,.406,5,6,.833,8,16,24,7,3,3,1,13,40,2006/2007
"Frye,Channing",298,689,.433,3,18,.167,295,671,.440,85,108,.787,91,304,395,67,36,100,42,216,684,2006/2007
"Gadzuric,Dan",108,228,.474,0,1,.000,108,227,.476,42,90,.467,94,152,246,29,22,49,32,141,258,2006/2007
"Garbajosa,Jorge",222,529,.420,66,193,.342,156,336,.464,57,78,.731,48,282,330,125,78,64,15,90,567,2006/2007
"García,Francisco",163,380,.429,53,149,.356,110,231,.476,95,114,.833,53,152,205,87,45,70,43,190,474,2006/2007
"Garnett,Kevin",638,1341,.476,12,56,.214,626,1285,.487,416,498,.835,183,792,975,313,89,205,126,184,1704,2006/2007
"Garrity,Pat",22,70,.314,11,32,.344,11,38,.289,16,18,.889,12,30,42,14,7,14,0,37,71,2006/2007
"Gasol,Pau",462,858,.538,3,11,.273,459,847,.542,299,400,.748,149,432,581,201,29,162,126,137,1226,2006/2007
"Gay,Rudy",321,760,.422,52,143,.364,269,617,.436,152,209,.727,93,255,348,100,71,140,74,192,846,2006/2007
"Gelabale,Mickaël",122,264,.462,11,47,.234,111,217,.512,66,82,.805,59,114,173,56,24,49,22,108,321,2006/2007
"George,Devean",146,370,.395,53,150,.353,93,220,.423,36,48,.750,57,156,213,33,46,51,23,143,381,2006/2007
"Gibson,Daniel",98,231,.424,52,124,.419,46,107,.430,28,39,.718,28,64,92,69,23,44,8,94,276,2006/2007
"Ginóbili,Manu",396,854,.464,128,323,.396,268,531,.505,320,372,.860,59,268,327,263,109,157,27,155,1240,2006/2007
"Giriček,Gordan",176,381,.462,52,122,.426,124,259,.479,71,87,.816,24,105,129,63,28,64,5,122,475,2006/2007
"Glyniadakis,Andreas",8,17,.471,0,0,,8,17,.471,1,2,.500,2,6,8,1,0,9,0,19,17,2006/2007
"Gomes,Ryan",338,723,.467,16,42,.381,322,681,.473,189,233,.811,125,282,407,119,48,105,13,169,881,2006/2007
"Gooden,Drew",371,784,.473,1,6,.167,370,778,.476,142,199,.714,263,418,681,88,70,115,28,210,885,2006/2007
"Gordon,Ben",609,1338,.455,155,375,.413,454,963,.471,380,440,.864,35,223,258,296,64,249,17,252,1753,2006/2007
"Graham,Joey",192,388,.495,9,31,.290,183,357,.513,110,131,.840,55,193,248,44,30,49,4,161,503,2006/2007
"Graham,Stephen",17,40,.425,3,11,.273,14,29,.483,8,9,.889,6,15,21,5,4,13,1,25,45,2006/2007
"Granger,Danny",398,868,.459,110,288,.382,288,580,.497,236,294,.803,114,267,381,114,67,135,61,245,1142,2006/2007
"Green,Gerald",310,739,.419,95,258,.368,215,481,.447,128,159,.805,68,140,208,83,41,120,24,198,843,2006/2007
"Green,Willie",357,868,.411,51,157,.325,306,711,.430,74,111,.667,42,116,158,112,56,106,4,144,839,2006/2007
"Greene,Orien",23,62,.371,2,11,.182,21,51,.412,15,25,.600,12,32,44,22,17,28,4,38,63,2006/2007
"Greer,Lynn",61,141,.433,18,52,.346,43,89,.483,27,32,.844,2,25,27,53,17,18,1,32,167,2006/2007
"Griffin,Adrian",61,129,.473,0,6,.000,61,123,.496,15,19,.789,40,69,109,59,32,38,4,78,137,2006/2007
"Griffin,Eddie",7,27,.259,0,1,.000,7,26,.269,4,5,.800,7,18,25,4,0,6,7,8,18,2006/2007
"Hall,Mike",1,4,.250,0,0,,1,4,.250,0,0,,1,1,2,1,0,0,0,1,2,2006/2007
"Hamilton,Richard",547,1170,.468,44,129,.341,503,1041,.483,347,403,.861,75,207,282,285,59,159,15,232,1485,2006/2007
"Harpring,Matt",322,656,.491,13,39,.333,309,617,.501,237,309,.767,117,236,353,99,52,118,11,232,894,2006/2007
"Harrington,Al",495,1083,.457,127,293,.433,368,790,.466,168,242,.694,151,345,496,149,65,169,24,269,1285,2006/2007
"Harrington,Al",223,487,.458,54,118,.458,169,369,.458,72,101,.713,71,155,226,51,25,91,10,116,572,2006/2007
"Harrington,Al",272,596,.456,73,175,.417,199,421,.473,96,141,.681,80,190,270,98,40,78,14,153,713,2006/2007
"Harrington,Junior",57,137,.416,7,26,.269,50,111,.450,31,46,.674,12,56,68,89,21,52,5,79,152,2006/2007
"Harrington,Othella",25,56,.446,0,0,,25,56,.446,17,22,.773,13,25,38,6,1,15,1,49,67,2006/2007
"Harris,Devin",292,593,.492,14,50,.280,278,543,.512,215,261,.824,45,151,196,296,96,146,21,242,813,2006/2007
"Harrison,David",30,58,.517,0,0,,30,58,.517,11,22,.500,9,33,42,6,5,26,12,47,71,2006/2007
"Hart,Jason",100,224,.446,7,29,.241,93,195,.477,42,47,.894,14,84,98,103,44,38,1,83,249,2006/2007
"Hart,Jason",15,30,.500,3,6,.500,12,24,.500,10,11,.909,2,13,15,10,3,4,0,23,43,2006/2007
"Hart,Jason",85,194,.438,4,23,.174,81,171,.474,32,36,.889,12,71,83,93,41,34,1,60,206,2006/2007
"Haslem,Udonis",353,717,.492,0,4,.000,353,713,.495,138,203,.680,188,466,654,97,49,110,26,236,844,2006/2007
"Hassell,Trenton",217,443,.490,6,25,.240,211,418,.505,72,92,.783,83,160,243,203,22,80,26,144,512,2006/2007
"Hayes,Chuck",192,335,.573,0,0,,192,335,.573,55,89,.618,204,317,521,47,70,64,18,281,439,2006/2007
"Hayes,Jarvis",224,546,.410,66,183,.361,158,363,.435,71,84,.845,42,168,210,80,48,56,13,160,585,2006/2007
"Haywood,Brendan",198,355,.558,0,0,,198,355,.558,115,210,.548,195,282,477,47,34,90,88,208,511,2006/2007
"Head,Luther",306,700,.437,177,401,.441,129,299,.431,83,105,.790,31,221,252,194,76,137,5,133,872,2006/2007
"Henderson,Alan",43,67,.642,0,0,,43,67,.642,33,47,.702,48,59,107,10,9,12,12,62,119,2006/2007
"Herrmann,Walter",174,330,.527,53,115,.461,121,215,.563,41,53,.774,28,111,139,26,17,32,7,76,442,2006/2007
"Hilário,Nenê",294,516,.570,0,1,.000,294,515,.571,195,283,.689,150,299,449,77,62,127,59,209,783,2006/2007
"Hill,Grant",342,660,.518,2,12,.167,340,648,.525,248,324,.765,53,184,237,138,61,144,25,146,934,2006/2007
"Hinrich,Kirk",475,1061,.448,140,337,.415,335,724,.463,237,284,.835,32,242,274,500,100,191,23,274,1327,2006/2007
"Hite,Robert",19,60,.317,5,23,.217,14,37,.378,8,12,.667,4,12,16,8,3,6,2,8,51,2006/2007
"Hodge,Julius",6,12,.500,0,0,,6,12,.500,3,4,.750,2,6,8,12,4,3,0,6,15,2006/2007
"Hodge,Julius",2,5,.400,0,0,,2,5,.400,2,2,1.000,1,2,3,10,3,1,0,3,6,2006/2007
"Hodge,Julius",4,7,.571,0,0,,4,7,.571,1,2,.500,1,4,5,2,1,2,0,3,9,2006/2007
"Hollins,Ryan",20,36,.556,0,0,,20,36,.556,24,40,.600,11,20,31,1,4,16,7,40,64,2006/2007
"Horry,Robert",90,251,.359,50,149,.336,40,102,.392,38,64,.594,73,156,229,77,45,44,41,105,268,2006/2007
"House,Eddie",180,421,.428,75,175,.429,105,246,.427,33,36,.917,14,78,92,67,27,27,3,69,468,2006/2007
"Howard,Dwight",526,873,.603,1,2,.500,525,871,.603,390,666,.586,283,725,1008,158,70,317,156,245,1443,2006/2007
"Howard,Josh",493,1075,.459,92,239,.385,401,836,.480,243,294,.827,130,345,475,127,82,123,56,180,1321,2006/2007
"Howard,Juwan",309,665,.465,0,0,,309,665,.465,155,188,.824,138,332,470,131,29,112,8,205,773,2006/2007
"Hudson,Troy",74,195,.379,28,80,.350,46,115,.400,26,32,.813,8,40,48,73,14,40,2,23,202,2006/2007
"Hughes,Larry",381,953,.400,74,222,.333,307,731,.420,209,309,.676,41,226,267,256,89,154,26,164,1045,2006/2007
"Humphries,Kris",87,185,.470,0,0,,87,185,.470,53,79,.671,78,109,187,18,14,32,21,98,227,2006/2007
"Hunter,Lindsey",94,244,.385,38,119,.319,56,125,.448,30,33,.909,9,38,47,93,34,35,7,56,256,2006/2007
"Hunter,Steven",188,326,.577,0,0,,188,326,.577,74,151,.490,114,221,335,26,13,65,76,137,450,2006/2007
"Iguodala,Andre",443,991,.447,48,155,.310,395,836,.472,452,551,.820,77,357,434,432,152,261,33,200,1386,2006/2007
"Ilgauskas,Zydrunas",385,793,.485,0,1,.000,385,792,.486,155,192,.807,242,357,599,123,48,141,98,257,925,2006/2007
"Ilić,Mile",0,3,.000,0,0,,0,3,.000,0,0,,0,1,1,0,0,3,0,1,0,2006/2007
"Ilunga-Mbenga,Didier",5,16,.313,0,0,,5,16,.313,7,8,.875,3,8,11,6,3,5,5,17,17,2006/2007
"İlyasova,Ersan",139,363,.383,54,148,.365,85,215,.395,70,89,.787,58,131,189,49,27,51,17,147,402,2006/2007
"Iverson,Allen",581,1313,.442,62,197,.315,519,1116,.465,485,610,.795,23,170,193,468,123,268,13,95,1709,2006/2007
"Iverson,Allen",151,366,.413,12,53,.226,139,313,.444,154,174,.885,7,34,41,109,33,66,1,21,468,2006/2007
"Iverson,Allen",430,947,.454,50,144,.347,380,803,.473,331,436,.759,16,136,152,359,90,202,12,74,1241,2006/2007
"Ivey,Royal",64,143,.448,5,16,.313,59,127,.465,24,35,.686,15,36,51,45,24,31,4,62,157,2006/2007
"Jack,Jarrett",320,705,.454,63,180,.350,257,525,.490,243,279,.871,18,190,208,417,86,187,9,202,946,2006/2007
"Jackson,Bobby",204,518,.394,54,165,.327,150,353,.425,130,168,.774,42,136,178,141,50,78,6,98,592,2006/2007
"Jackson,Luke",19,43,.442,5,17,.294,14,26,.538,5,9,.556,2,8,10,13,5,7,1,15,48,2006/2007
"Jackson,Luke",1,8,.125,1,4,.250,0,4,.000,0,0,,0,1,1,4,0,1,0,3,3,2006/2007
"Jackson,Luke",18,35,.514,4,13,.308,14,22,.636,5,9,.556,2,7,9,9,5,6,1,12,45,2006/2007
"Jackson,Marc",159,388,.410,0,1,.000,159,387,.411,90,103,.874,62,130,192,58,21,65,7,89,408,2006/2007
"Jackson,Stephen",409,944,.433,100,311,.322,309,633,.488,243,299,.813,61,161,222,287,84,183,34,200,1161,2006/2007
"Jackson,Stephen",180,430,.419,41,138,.297,139,292,.476,120,146,.822,17,78,95,114,33,81,20,87,521,2006/2007
"Jackson,Stephen",229,514,.446,59,173,.341,170,341,.499,123,153,.804,44,83,127,173,51,102,14,113,640,2006/2007
"James,Jerome",33,79,.418,0,0,,33,79,.418,10,18,.556,21,45,66,3,6,23,15,73,76,2006/2007
"James,LeBron",772,1621,.476,99,310,.319,673,1311,.513,489,701,.698,83,443,526,470,125,250,55,171,2132,2006/2007
"James,Mike",297,703,.422,80,215,.372,217,488,.445,154,184,.837,25,138,163,297,55,129,7,171,828,2006/2007
"Jamison,Antawn",512,1139,.450,138,379,.364,374,760,.492,226,307,.736,134,428,562,136,80,104,36,194,1388,2006/2007
"Jarić,Marko",136,325,.418,32,85,.376,104,240,.433,67,88,.761,54,130,184,145,75,88,16,172,371,2006/2007
"Jasikevičius,Šarūnas",128,322,.398,44,130,.338,84,192,.438,86,95,.905,15,54,69,172,26,90,1,75,386,2006/2007
"Jasikevičius,Šarūnas",91,221,.412,32,86,.372,59,135,.437,59,64,.922,10,38,48,111,13,59,0,53,273,2006/2007
"Jasikevičius,Šarūnas",37,101,.366,12,44,.273,25,57,.439,27,31,.871,5,16,21,61,13,31,1,22,113,2006/2007
"Jefferson,Al",453,882,.514,0,1,.000,453,881,.514,201,295,.681,237,519,756,88,48,136,106,232,1107,2006/2007
"Jefferson,Richard",303,665,.456,52,145,.359,251,520,.483,239,326,.733,48,192,240,148,34,120,8,123,897,2006/2007
"Jeffries,Jared",95,206,.461,2,20,.100,93,186,.500,31,68,.456,111,127,238,67,44,61,30,150,223,2006/2007
"Johnson,Alexander",91,169,.538,0,0,,91,169,.538,78,118,.661,50,131,181,17,25,47,35,137,260,2006/2007
"Johnson,Amir",18,33,.545,0,3,.000,18,30,.600,11,14,.786,15,22,37,3,5,9,13,19,47,2006/2007
"Johnson,Anthony",142,343,.414,25,73,.342,117,270,.433,46,61,.754,22,79,101,201,33,76,3,119,355,2006/2007
"Johnson,Anthony",60,146,.411,11,29,.379,49,117,.419,21,29,.724,13,35,48,78,16,31,1,68,152,2006/2007
"Johnson,Anthony",82,197,.416,14,44,.318,68,153,.444,25,32,.781,9,44,53,123,17,45,2,51,203,2006/2007
"Johnson,DerMarr",50,154,.325,19,88,.216,31,66,.470,16,21,.762,10,47,57,17,16,27,12,39,135,2006/2007
"Johnson,Joe",536,1139,.471,119,312,.381,417,827,.504,235,314,.748,53,186,239,249,60,176,11,115,1426,2006/2007
"Johnson,Linton",93,190,.489,10,30,.333,83,160,.519,30,37,.811,52,111,163,18,33,27,18,101,226,2006/2007
"Jones,Bobby",43,93,.462,1,9,.111,42,84,.500,23,41,.561,22,35,57,16,11,18,1,59,110,2006/2007
"Jones,Dahntay",220,461,.477,5,12,.417,215,449,.479,138,174,.793,47,106,153,68,39,92,22,192,583,2006/2007
"Jones,Damon",137,355,.386,89,231,.385,48,124,.387,30,44,.682,9,57,66,94,16,36,2,53,393,2006/2007
"Jones,Dwayne",0,1,.000,0,0,,0,1,.000,3,6,.500,1,5,6,0,0,2,0,3,3,2006/2007
"Jones,Eddie",178,422,.422,78,222,.351,100,200,.500,59,75,.787,31,159,190,109,68,47,10,124,493,2006/2007
"Jones,Eddie",57,151,.377,22,74,.297,35,77,.455,25,34,.735,14,47,61,33,22,23,2,54,161,2006/2007
"Jones,Eddie",121,271,.446,56,148,.378,65,123,.528,34,41,.829,17,112,129,76,46,24,8,70,332,2006/2007
"Jones,Fred",139,361,.385,39,128,.305,100,233,.429,95,114,.833,23,92,115,108,48,67,16,121,412,2006/2007
"Jones,Fred",96,249,.386,32,101,.317,64,148,.432,73,88,.830,16,66,82,55,30,50,12,80,297,2006/2007
"Jones,Fred",43,112,.384,7,27,.259,36,85,.424,22,26,.846,7,26,33,53,18,17,4,41,115,2006/2007
"Jones,James",162,440,.368,90,238,.378,72,202,.356,71,81,.877,33,143,176,45,28,28,42,115,485,2006/2007
"Jones,Jumaine",14,51,.275,10,32,.313,4,19,.211,2,2,1.000,6,17,23,1,5,7,1,19,40,2006/2007
"Jones,Solomon",65,128,.508,0,1,.000,65,127,.512,59,75,.787,49,87,136,11,11,25,42,124,189,2006/2007
"Kaman,Chris",294,652,.451,0,1,.000,294,651,.452,166,224,.741,160,428,588,79,41,147,116,251,754,2006/2007
"Kapono,Jason",278,563,.494,108,210,.514,170,353,.482,66,74,.892,26,154,180,81,38,70,2,135,730,2006/2007
"Khryapa,Viktor",27,70,.386,0,6,.000,27,64,.422,19,26,.731,20,37,57,21,10,16,1,53,73,2006/2007
"Kidd,Jason",369,908,.406,124,361,.343,245,547,.448,179,230,.778,135,520,655,736,127,213,23,146,1041,2006/2007
"Kinsey,Tarence",139,304,.457,13,46,.283,126,258,.488,78,98,.796,29,68,97,41,53,46,1,57,369,2006/2007
"Kirilenko,Andrei",197,418,.471,16,75,.213,181,343,.528,174,239,.728,88,241,329,202,74,135,144,172,584,2006/2007
"Kleiza,Linas",200,474,.422,83,221,.376,117,253,.462,115,135,.852,77,189,266,45,28,79,14,200,598,2006/2007
"Knight,Brevin",152,363,.419,1,18,.056,151,345,.438,103,128,.805,14,101,115,296,67,95,3,113,408,2006/2007
"Korolev,Yaroslav",4,16,.250,1,5,.200,3,11,.273,3,6,.500,1,2,3,4,3,1,0,0,12,2006/2007
"Korver,Kyle",372,845,.440,132,307,.430,240,538,.446,191,209,.914,30,229,259,105,57,117,20,188,1067,2006/2007
"Krstić,Nenad",170,323,.526,0,1,.000,170,322,.528,86,121,.711,51,125,176,46,10,52,24,88,426,2006/2007
"LaFrentz,Raef",39,102,.382,2,23,.087,37,79,.468,20,26,.769,25,45,70,8,7,13,11,57,100,2006/2007
"Lang,James",4,9,.444,0,0,,4,9,.444,3,5,.600,5,6,11,2,0,2,3,14,11,2006/2007
"Lee,David",240,400,.600,0,0,,240,400,.600,141,173,.815,196,406,602,104,48,92,23,155,621,2006/2007
"Lewis,Rashard",463,1005,.461,151,387,.390,312,618,.505,265,315,.841,91,305,396,145,68,118,39,143,1342,2006/2007
"Livingston,Randy",0,3,.000,0,0,,0,3,.000,0,0,,1,0,1,4,0,1,0,2,0,2006/2007
"Livingston,Shaun",208,449,.463,5,16,.313,203,433,.469,82,116,.707,56,128,184,274,59,108,29,135,503,2006/2007
"Lowry,Kyle",14,38,.368,3,8,.375,11,30,.367,25,28,.893,12,19,31,32,14,12,1,20,56,2006/2007
"Lucas III,John",62,156,.397,15,59,.254,47,97,.485,15,19,.789,9,27,36,33,17,15,0,38,154,2006/2007
"Lue,Tyronn",218,524,.416,56,161,.348,162,363,.446,144,163,.883,19,85,104,201,24,85,0,101,636,2006/2007
"Madsen,Mark",23,43,.535,0,0,,23,43,.535,15,29,.517,35,52,87,10,10,21,10,100,61,2006/2007
"Maggette,Corey",367,808,.454,13,65,.200,354,743,.476,519,633,.820,90,352,442,208,65,201,14,244,1266,2006/2007
"Magloire,Jamaal",199,395,.504,0,0,,199,395,.504,131,242,.541,151,341,492,30,21,129,66,226,529,2006/2007
"Major,Renaldo",2,10,.200,0,0,,2,10,.200,1,2,.500,0,2,2,0,2,1,0,4,5,2006/2007
"Marbury,Stephon",395,952,.415,123,345,.357,272,607,.448,297,386,.769,36,177,213,403,71,179,10,185,1210,2006/2007
"Marion,Shawn",561,1071,.524,80,252,.317,481,819,.587,201,248,.810,172,613,785,134,156,114,122,216,1403,2006/2007
"Markota,Damir",19,52,.365,6,16,.375,13,36,.361,7,11,.636,11,20,31,6,3,15,1,22,51,2006/2007
"Marks,Sean",2,6,.333,0,1,.000,2,5,.400,2,2,1.000,0,3,3,0,0,0,1,4,6,2006/2007
"Marshall,Donyell",209,493,.424,95,271,.351,114,222,.514,53,80,.663,86,237,323,46,39,67,43,130,566,2006/2007
"Marshall,Rawle",32,89,.360,4,18,.222,28,71,.394,31,45,.689,8,21,29,13,12,19,5,22,99,2006/2007
"Martin,Darrick",33,94,.351,13,37,.351,20,57,.351,15,21,.714,2,10,12,43,3,12,0,22,94,2006/2007
"Martin,Kenyon",8,16,.500,0,1,.000,8,15,.533,3,12,.250,6,14,20,1,0,5,0,10,19,2006/2007
"Martin,Kevin",505,1067,.473,127,333,.381,378,734,.515,481,570,.844,69,273,342,173,98,135,11,181,1618,2006/2007
"Mason,Desmond",407,900,.452,0,0,,407,900,.452,214,323,.663,124,221,345,115,52,192,22,174,1028,2006/2007
"Mason,Roger",59,179,.330,33,102,.324,26,77,.338,14,16,.875,7,38,45,35,13,19,6,66,165,2006/2007
"Maxiell,Jason",131,262,.500,0,0,,131,262,.500,72,137,.526,88,98,186,14,30,53,60,110,334,2006/2007
"May,Sean",164,328,.500,2,3,.667,162,325,.498,86,112,.768,73,160,233,66,19,56,24,100,416,2006/2007
"McCants,Rashad",62,177,.350,20,75,.267,42,102,.412,40,58,.690,14,33,47,38,26,40,7,71,184,2006/2007
"McCray,Chris",0,3,.000,0,0,,0,3,.000,0,0,,0,0,0,0,0,2,0,1,0,2006/2007
"McDyess,Antonio",284,540,.526,0,0,,284,540,.526,96,139,.691,165,331,496,72,61,75,65,240,664,2006/2007
"McFarlin,Ivan",5,13,.385,0,1,.000,5,12,.417,5,7,.714,7,4,11,1,0,1,0,8,15,2006/2007
"McGrady,Tracy",638,1480,.431,126,381,.331,512,1099,.466,345,488,.707,56,322,378,458,92,213,36,136,1747,2006/2007
"McInnis,Jeff",71,181,.392,1,8,.125,70,173,.405,22,32,.688,14,48,62,124,14,42,0,72,165,2006/2007
"McKie,Aaron",11,17,.647,0,0,,11,17,.647,0,0,,1,17,18,13,4,8,0,14,22,2006/2007
"McLeod,Keith",73,188,.388,16,45,.356,57,143,.399,69,78,.885,4,39,43,90,24,46,5,51,231,2006/2007
"McLeod,Keith",41,105,.390,9,23,.391,32,82,.390,47,53,.887,3,18,21,45,17,23,3,21,138,2006/2007
"McLeod,Keith",32,83,.386,7,22,.318,25,61,.410,22,25,.880,1,21,22,45,7,23,2,30,93,2006/2007
"Medvedenko,Stanislav",12,29,.414,1,2,.500,11,27,.407,17,20,.850,4,10,14,2,0,5,2,16,42,2006/2007
"Mensah-Bonsu,Pops",11,17,.647,0,0,,11,17,.647,7,18,.389,9,12,21,0,1,9,0,8,29,2006/2007
"Miles,C.J.",40,116,.345,7,32,.219,33,84,.393,14,23,.609,11,24,35,25,11,28,4,60,101,2006/2007
"Miličić,Darko",249,548,.454,0,1,.000,249,547,.455,141,230,.613,145,292,437,90,44,124,140,219,639,2006/2007
"Miller,Andre",424,909,.466,5,35,.143,419,874,.479,222,283,.784,97,255,352,625,110,222,10,184,1075,2006/2007
"Miller,Andre",117,248,.472,4,16,.250,113,232,.487,62,85,.729,25,79,104,209,37,70,4,58,300,2006/2007
"Miller,Andre",307,661,.464,1,19,.053,306,642,.477,160,198,.808,72,176,248,416,73,152,6,126,775,2006/2007
"Miller,Brad",224,494,.453,5,33,.152,219,461,.475,115,149,.772,79,322,401,224,38,108,39,155,568,2006/2007
"Miller,Mike",465,1010,.460,202,498,.406,263,512,.514,161,203,.793,52,326,378,298,54,179,18,138,1293,2006/2007
"Millsap,Paul",209,398,.525,1,3,.333,208,395,.527,140,208,.673,183,240,423,62,67,94,74,236,559,2006/2007
"Ming,Yao",423,819,.516,0,2,.000,423,817,.518,356,413,.862,101,351,452,94,17,167,94,159,1202,2006/2007
"Mobley,Cuttino",388,882,.440,101,246,.411,287,636,.451,200,239,.837,52,215,267,198,92,145,24,186,1077,2006/2007
"Mohammed,Nazr",118,222,.532,0,0,,118,222,.532,50,82,.610,89,140,229,9,27,43,40,133,286,2006/2007
"Moore,Mikki",308,506,.609,0,1,.000,308,505,.610,160,235,.681,145,258,403,74,46,113,60,261,776,2006/2007
"Morris,Randolph",1,6,.167,0,0,,1,6,.167,2,6,.333,1,8,9,1,2,2,1,4,4,2006/2007
"Morrison,Adam",355,944,.376,87,258,.337,268,686,.391,120,169,.710,54,176,230,163,28,130,6,179,917,2006/2007
"Mourning,Alonzo",238,425,.560,0,0,,238,425,.560,185,308,.601,126,224,350,18,13,129,178,219,661,2006/2007
"Murphy,Troy",266,581,.458,58,147,.395,208,434,.479,108,145,.745,100,314,414,126,46,78,42,196,698,2006/2007
"Murphy,Troy",81,180,.450,22,59,.373,59,121,.488,47,66,.712,37,120,157,60,21,29,17,63,231,2006/2007
"Murphy,Troy",185,401,.461,36,88,.409,149,313,.476,61,79,.772,63,194,257,66,25,49,25,133,467,2006/2007
"Murray,Ronald",177,438,.404,24,83,.289,153,355,.431,87,120,.725,26,87,113,187,49,90,13,96,465,2006/2007
"Mutombo,Dikembe",85,153,.556,0,0,,85,153,.556,60,87,.690,164,324,488,13,22,38,76,156,230,2006/2007
"Nachbar,Boštjan",226,495,.457,112,265,.423,114,230,.496,132,164,.805,27,226,253,61,30,69,26,183,696,2006/2007
"Nájera,Eduardo",204,354,.576,1,12,.083,203,342,.594,88,123,.715,131,179,310,64,73,56,26,207,497,2006/2007
"Nash,Steve",517,971,.532,156,343,.455,361,628,.575,222,247,.899,30,239,269,884,57,287,6,117,1412,2006/2007
"Nelson,Jameer",376,875,.430,65,194,.335,311,681,.457,183,221,.828,50,186,236,330,73,184,5,225,1000,2006/2007
"Nesterović,Rasho",230,421,.546,0,1,.000,230,420,.548,34,50,.680,115,245,360,74,37,56,84,193,494,2006/2007
"Newble,Ira",16,37,.432,8,15,.533,8,22,.364,6,10,.600,13,17,30,2,6,3,0,17,46,2006/2007
"Nocioni,Andrés",273,584,.467,80,209,.383,193,375,.515,123,145,.848,42,259,301,57,27,104,24,164,749,2006/2007
"Noel,David",65,177,.367,17,53,.321,48,124,.387,37,43,.860,42,81,123,65,25,40,9,77,184,2006/2007
"Novak,Steve",18,50,.360,13,39,.333,5,11,.455,2,2,1.000,4,22,26,6,5,4,0,21,51,2006/2007
"Nowitzki,Dirk",673,1341,.502,72,173,.416,601,1168,.515,498,551,.904,122,571,693,263,52,167,62,171,1916,2006/2007
"O'Bryant,Patrick",10,32,.313,0,0,,10,32,.313,11,17,.647,7,14,21,9,6,8,8,26,31,2006/2007
"O'Neal,Jermaine",498,1141,.436,0,7,.000,498,1134,.439,343,447,.767,153,508,661,167,50,203,182,232,1339,2006/2007
"O'Neal,Shaquille",283,479,.591,0,0,,283,479,.591,124,294,.422,97,200,297,79,8,95,55,139,690,2006/2007
"Oberto,Fabricio",158,281,.562,0,0,,158,281,.562,33,51,.647,131,237,368,68,25,69,24,213,349,2006/2007
"Odom,Lamar",319,681,.468,54,182,.297,265,499,.531,198,283,.700,102,445,547,270,53,163,32,182,890,2006/2007
"Okafor,Emeka",394,740,.532,0,0,,394,740,.532,175,295,.593,258,499,757,80,57,111,172,210,963,2006/2007
"Okur,Mehmet",490,1061,.462,129,336,.384,361,725,.498,296,387,.765,160,419,579,156,36,125,38,257,1405,2006/2007
"Ollie,Kevin",81,187,.433,0,2,.000,81,185,.438,37,45,.822,8,66,74,130,21,47,1,76,199,2006/2007
"Olowokandi,Michael",19,46,.413,0,0,,19,46,.413,2,3,.667,14,34,48,5,8,17,13,48,40,2006/2007
"Outlaw,Bo",34,51,.667,0,0,,34,51,.667,13,22,.591,47,59,106,16,17,21,6,57,81,2006/2007
"Outlaw,Travis",246,567,.434,10,37,.270,236,530,.445,143,181,.790,65,152,217,52,61,66,74,150,645,2006/2007
"Pachulia,Zaza",291,614,.474,0,1,.000,291,613,.475,293,373,.786,199,301,500,106,77,162,36,267,875,2006/2007
"Padgett,Scott",16,56,.286,8,33,.242,8,23,.348,6,13,.462,16,38,54,8,5,9,3,35,46,2006/2007
"Padgett,Scott",15,49,.306,8,29,.276,7,20,.350,6,11,.545,11,34,45,8,4,8,3,33,44,2006/2007
"Padgett,Scott",1,7,.143,0,4,.000,1,3,.333,0,2,.000,5,4,9,0,1,1,0,2,2,2006/2007
"Pargo,Jannero",283,692,.409,81,209,.388,202,483,.418,104,122,.852,20,160,180,203,53,122,4,121,751,2006/2007
"Parker,Anthony",328,687,.477,115,261,.441,213,426,.500,132,158,.835,60,223,283,153,73,71,11,135,903,2006/2007
"Parker,Smush",342,785,.436,110,301,.365,232,484,.479,113,175,.646,45,161,206,228,119,153,10,211,907,2006/2007
"Parker,Tony",570,1096,.520,15,38,.395,555,1058,.525,274,350,.783,34,216,250,420,82,191,6,137,1429,2006/2007
"Patterson,Ruben",475,867,.548,3,19,.158,472,848,.557,241,376,.641,190,250,440,232,110,199,25,232,1194,2006/2007
"Paul,Chris",381,871,.437,50,143,.350,331,728,.455,292,357,.818,54,226,280,569,118,161,3,154,1104,2006/2007
"Pavlović,Sasha",222,490,.453,60,148,.405,162,342,.474,100,126,.794,23,135,158,105,55,102,17,145,604,2006/2007
"Payton,Gary",144,366,.393,32,123,.260,112,243,.461,38,57,.667,18,114,132,201,43,66,3,117,358,2006/2007
"Perkins,Kendrick",132,269,.491,0,3,.000,132,266,.496,60,100,.600,113,259,372,94,23,113,96,214,324,2006/2007
"Peterson,Morris",222,517,.429,106,295,.359,116,222,.523,84,123,.683,32,205,237,47,45,53,12,126,634,2006/2007
"Petro,Johan",226,438,.516,0,0,,226,438,.516,50,77,.649,92,243,335,45,39,82,47,237,502,2006/2007
"Piatkowski,Eric",9,25,.360,7,18,.389,2,7,.286,2,2,1.000,2,7,9,4,0,5,1,6,27,2006/2007
"Pierce,Paul",373,850,.439,107,275,.389,266,575,.463,320,402,.796,39,238,277,194,48,152,13,122,1173,2006/2007
"Piétrus,Mickaël",286,586,.488,93,240,.388,193,346,.558,136,210,.648,81,246,327,62,48,105,55,220,801,2006/2007
"Pinkney,Kevinn",12,27,.444,1,2,.500,11,25,.440,6,9,.667,7,8,15,5,3,4,3,12,31,2006/2007
"Pollard,Scot",11,26,.423,0,0,,11,26,.423,2,4,.500,15,16,31,3,4,4,1,27,24,2006/2007
"Posey,James",186,432,.431,97,259,.375,89,173,.514,81,98,.827,66,291,357,94,71,55,23,193,550,2006/2007
"Potapenko,Vitaly",0,4,.000,0,0,,0,4,.000,0,0,,0,2,2,0,0,2,0,3,0,2006/2007
"Powe,Leon",79,177,.446,0,2,.000,79,175,.451,106,144,.736,97,118,215,10,14,47,22,104,264,2006/2007
"Powell,Josh",43,93,.462,0,0,,43,93,.462,30,42,.714,24,64,88,21,5,29,12,61,116,2006/2007
"Powell,Josh",2,15,.133,0,0,,2,15,.133,8,12,.667,7,12,19,3,0,5,0,18,12,2006/2007
"Powell,Josh",41,78,.526,0,0,,41,78,.526,22,30,.733,17,52,69,18,5,24,12,43,104,2006/2007
"Powell,Roger",0,3,.000,0,1,.000,0,2,.000,2,2,1.000,3,0,3,0,0,3,0,2,2,2006/2007
"Price,Ronnie",67,172,.390,21,65,.323,46,107,.430,37,55,.673,15,56,71,48,28,33,4,64,192,2006/2007
"Prince,Tayshaun",459,997,.460,81,210,.386,378,787,.480,172,224,.768,144,285,429,227,51,98,55,116,1171,2006/2007
"Przybilla,Joel",37,78,.474,0,0,,37,78,.474,10,27,.370,59,109,168,12,10,40,67,124,84,2006/2007
"Quinn,Chris",48,131,.366,20,57,.351,28,74,.378,25,37,.676,6,24,30,65,15,21,0,32,141,2006/2007
"Radmanović,Vladimir",134,316,.424,40,118,.339,94,198,.475,53,73,.726,53,127,180,66,25,69,18,125,361,2006/2007
"Randolph,Shavlik",23,48,.479,0,0,,23,48,.479,12,22,.545,19,35,54,4,7,9,10,23,58,2006/2007
"Randolph,Zach",600,1286,.467,14,48,.292,586,1238,.473,394,481,.819,199,489,688,147,53,215,15,184,1608,2006/2007
"Ratliff,Theo",1,3,.333,0,0,,1,3,.333,3,4,.750,2,5,7,0,1,1,3,6,5,2006/2007
"Ray,Allan",100,259,.386,48,116,.414,52,143,.364,42,55,.764,18,51,69,43,20,42,3,85,290,2006/2007
"Redd,Michael",477,1025,.465,117,306,.382,360,719,.501,345,416,.829,42,154,196,124,63,122,9,78,1416,2006/2007
"Redick,J.J.",80,195,.410,38,98,.388,42,97,.433,54,60,.900,10,42,52,36,12,21,0,52,252,2006/2007
"Reed,Justin",40,107,.374,0,0,,40,107,.374,26,30,.867,15,31,46,17,5,22,3,44,106,2006/2007
"Reiner,Jared",15,43,.349,0,0,,15,43,.349,3,10,.300,21,50,71,13,5,14,6,45,33,2006/2007
"Richardson,Jason",306,734,.417,110,301,.365,196,433,.453,92,140,.657,71,188,259,172,54,82,32,129,814,2006/2007
"Richardson,Jeremy",3,6,.500,2,3,.667,1,3,.333,0,0,,1,1,2,0,1,1,0,2,8,2006/2007
"Richardson,Jeremy",3,6,.500,2,3,.667,1,3,.333,0,0,,1,1,2,0,1,1,0,2,8,2006/2007
"Richardson,Jeremy",0,0,,0,0,,0,0,,0,0,,0,0,0,0,0,0,0,0,0,2006/2007
"Richardson,Quentin",228,545,.418,97,258,.376,131,287,.456,83,120,.692,65,287,352,108,36,70,7,133,636,2006/2007
"Ridnour,Luke",301,695,.433,49,139,.353,252,556,.453,128,159,.805,28,136,164,368,83,156,19,181,779,2006/2007
"Roberson,Anthony",44,104,.423,21,55,.382,23,49,.469,2,3,.667,2,19,21,10,12,13,0,27,111,2006/2007
"Roberts,Lawrence",94,208,.452,0,2,.000,94,206,.456,95,131,.725,101,160,261,30,36,36,13,133,283,2006/2007
"Robinson,Bernard",19,62,.306,0,2,.000,19,60,.317,23,27,.852,10,38,48,19,17,16,2,32,61,2006/2007
"Robinson,Bernard",16,54,.296,0,2,.000,16,52,.308,19,22,.864,9,33,42,17,13,16,1,28,51,2006/2007
"Robinson,Bernard",3,8,.375,0,0,,3,8,.375,4,5,.800,1,5,6,2,4,0,1,4,10,2006/2007
"Robinson,Clifford",81,218,.372,25,66,.379,56,152,.368,16,36,.444,31,91,122,51,12,30,23,98,203,2006/2007
"Robinson,Nate",227,523,.434,83,213,.390,144,310,.465,108,139,.777,55,97,152,90,50,72,6,160,645,2006/2007
"Rodríguez,Sergio",101,239,.423,24,85,.282,77,154,.500,21,26,.808,20,71,91,218,35,77,2,72,247,2006/2007
"Rondo,Rajon",188,450,.418,6,29,.207,182,421,.432,119,184,.647,74,218,292,297,128,137,8,181,501,2006/2007
"Rose,Jalen",38,86,.442,21,47,.447,17,39,.436,11,12,.917,3,20,23,16,5,9,2,22,108,2006/2007
"Rose,Malik",74,186,.398,2,8,.250,72,178,.404,42,52,.808,47,128,175,65,26,65,9,120,192,2006/2007
"Ross,Quinton",177,379,.467,2,10,.200,175,369,.474,68,87,.782,60,130,190,86,70,33,32,179,424,2006/2007
"Roy,Brandon",349,765,.456,55,146,.377,294,619,.475,202,241,.838,58,192,250,230,67,116,10,139,955,2006/2007
"Ruffin,Michael",5,18,.278,0,0,,5,18,.278,7,19,.368,35,27,62,6,6,12,8,43,17,2006/2007
"Salmons,John",236,517,.456,40,112,.357,196,405,.484,159,204,.779,47,217,264,254,73,119,27,177,671,2006/2007
"Sampson,Jamal",9,14,.643,0,1,.000,9,13,.692,6,14,.429,15,33,48,5,2,10,7,17,24,2006/2007
"Scalabrine,Brian",77,191,.403,44,110,.400,33,81,.407,18,23,.783,24,81,105,59,23,44,18,130,216,2006/2007
"Schenscher,Luke",7,23,.304,0,0,,7,23,.304,5,7,.714,10,15,25,1,2,4,4,25,19,2006/2007
"Sefolosha,Thabo",109,256,.426,15,42,.357,94,214,.439,23,45,.511,35,118,153,60,33,60,11,100,256,2006/2007
"Sene,Mouhamed",18,49,.367,0,0,,18,49,.367,17,29,.586,16,29,45,0,3,11,12,33,53,2006/2007
"Simien,Wayne",9,23,.391,0,0,,9,23,.391,5,7,.714,5,6,11,4,2,3,0,13,23,2006/2007
"Simmons,Cedric",55,132,.417,0,0,,55,132,.417,16,33,.485,44,63,107,12,8,22,23,75,126,2006/2007
"Singleton,James",30,82,.366,3,14,.214,27,68,.397,22,29,.759,36,70,106,17,15,17,17,45,85,2006/2007
"Skinner,Brian",124,253,.490,0,0,,124,253,.490,46,79,.582,106,279,385,58,18,75,64,195,294,2006/2007
"Slokar,Uroš",14,26,.538,1,2,.500,13,24,.542,9,13,.692,7,7,14,1,1,9,2,11,38,2006/2007
"Smith,Craig",246,463,.531,0,6,.000,246,457,.538,116,186,.624,149,267,416,49,51,74,18,223,608,2006/2007
"Smith,J.R.",284,644,.441,149,382,.390,135,262,.515,102,126,.810,30,113,143,91,49,85,9,147,819,2006/2007
"Smith,Joe",214,477,.449,0,5,.000,214,472,.453,125,148,.845,120,280,400,49,37,76,27,148,553,2006/2007
"Smith,Joe",23,48,.479,0,1,.000,23,47,.489,10,12,.833,13,27,40,3,6,13,7,23,56,2006/2007
"Smith,Joe",191,429,.445,0,4,.000,191,425,.449,115,136,.846,107,253,360,46,31,63,20,125,497,2006/2007
"Smith,Josh",436,993,.439,38,152,.250,398,841,.473,268,387,.693,165,456,621,236,101,227,207,241,1178,2006/2007
"Smith,Steven",2,8,.250,0,0,,2,8,.250,1,2,.500,1,5,6,0,1,2,0,4,5,2006/2007
"Snow,Eric",135,324,.417,0,4,.000,135,320,.422,72,113,.637,35,153,188,330,55,111,16,185,342,2006/2007
"Snyder,Kirk",66,146,.452,11,44,.250,55,102,.539,49,75,.653,17,66,83,39,11,26,12,51,192,2006/2007
"Songaila,Darius",118,225,.524,0,2,.000,118,223,.529,46,54,.852,44,90,134,38,17,43,10,105,282,2006/2007
"Sow,Pape",3,9,.333,0,0,,3,9,.333,4,6,.667,6,5,11,2,1,1,1,2,10,2006/2007
"Spanoulis,Vassilis",23,72,.319,5,29,.172,18,43,.419,34,42,.810,5,17,22,28,7,29,1,33,85,2006/2007
"Stackhouse,Jerry",280,654,.428,62,162,.383,218,492,.443,182,215,.847,39,106,145,187,51,117,10,78,804,2006/2007
"Stevenson,DeShawn",347,753,.461,74,183,.404,273,570,.479,152,216,.704,55,161,216,218,65,119,19,155,920,2006/2007
"Stojaković,Peja",83,196,.423,34,84,.405,49,112,.438,31,38,.816,11,43,54,11,8,19,4,29,231,2006/2007
"Stoudamire,Damon",171,437,.391,59,175,.337,112,262,.427,66,83,.795,31,108,139,299,47,101,2,95,467,2006/2007
"Stoudamire,Salim",177,425,.416,56,155,.361,121,270,.448,61,68,.897,6,68,74,61,21,55,2,88,471,2006/2007
"Stoudemire,Amar'e",607,1055,.575,0,3,.000,607,1052,.577,457,585,.781,222,564,786,84,78,232,110,295,1671,2006/2007
"Sweetney,Mike",58,134,.433,0,0,,58,134,.433,37,66,.561,45,75,120,28,9,42,11,79,153,2006/2007
"Swift,Stromile",161,346,.465,0,5,.000,161,341,.472,97,134,.724,85,165,250,17,30,69,62,146,419,2006/2007
"Szczerbiak,Wally",161,388,.415,44,106,.415,117,282,.415,113,126,.897,16,82,98,55,18,54,3,65,479,2006/2007
"Taylor,Donell",56,140,.400,3,17,.176,53,123,.431,11,21,.524,14,39,53,45,17,25,3,34,126,2006/2007
"Taylor,Maurice",8,28,.286,0,0,,8,28,.286,8,13,.615,10,18,28,5,4,6,1,16,24,2006/2007
"Telfair,Sebastian",176,474,.371,37,128,.289,139,346,.402,90,110,.818,17,91,108,218,43,98,11,166,479,2006/2007
"Terry,Jason",514,1063,.484,162,370,.438,352,693,.508,160,199,.804,41,190,231,422,81,152,17,170,1350,2006/2007
"Thomas,Etan",159,277,.574,0,0,,159,277,.574,77,138,.558,136,241,377,29,22,71,89,162,395,2006/2007
"Thomas,Kenny",146,303,.482,0,1,.000,146,302,.483,39,76,.513,134,243,377,76,43,90,16,141,331,2006/2007
"Thomas,Kurt",126,259,.486,0,1,.000,126,258,.488,56,71,.789,86,293,379,24,24,35,29,156,308,2006/2007
"Thomas,Tim",299,723,.414,136,356,.382,163,367,.444,102,144,.708,63,315,378,171,55,106,28,228,836,2006/2007
"Thomas,Tyrus",134,282,.475,0,2,.000,134,280,.479,106,175,.606,89,180,269,40,46,94,76,162,374,2006/2007
"Thompson,Dijon",6,15,.400,0,2,.000,6,13,.462,5,6,.833,3,5,8,2,0,1,0,2,17,2006/2007
"Tinsley,Jamaal",346,889,.389,61,193,.316,285,696,.409,172,239,.720,60,180,240,494,117,200,25,190,925,2006/2007
"Tsakalidis,Jake",29,72,.403,0,0,,29,72,.403,26,39,.667,42,62,104,5,8,24,12,51,84,2006/2007
"Tsakalidis,Jake",20,50,.400,0,0,,20,50,.400,14,24,.583,24,40,64,2,7,21,11,34,54,2006/2007
"Tsakalidis,Jake",9,22,.409,0,0,,9,22,.409,12,15,.800,18,22,40,3,1,3,1,17,30,2006/2007
"Tucker,P.J.",11,22,.500,0,0,,11,22,.500,8,14,.571,11,12,23,3,2,6,0,12,30,2006/2007
"Turiaf,Ronny",147,268,.549,0,1,.000,147,267,.551,89,134,.664,88,171,259,63,17,52,78,202,383,2006/2007
"Türkoğlu,Hedo",345,823,.419,109,281,.388,236,542,.435,171,219,.781,57,236,293,233,70,143,16,221,970,2006/2007
"Udoka,Ime",237,514,.461,89,219,.406,148,295,.502,66,89,.742,95,184,279,112,71,73,17,207,629,2006/2007
"Udrih,Beno",127,344,.369,33,115,.287,94,229,.410,53,60,.883,11,71,82,122,27,56,1,70,340,2006/2007
"Varejão,Anderson",191,401,.476,0,9,.000,191,392,.487,165,268,.616,191,354,545,75,76,67,52,269,547,2006/2007
"Vaughn,Jacque",71,167,.425,1,2,.500,70,165,.424,49,65,.754,8,60,68,131,24,40,2,74,192,2006/2007
"Villanueva,Charlie",180,383,.470,29,86,.337,151,297,.508,73,89,.820,62,166,228,36,24,54,12,108,462,2006/2007
"Vinicius,Marcus",7,15,.467,3,7,.429,4,8,.500,5,7,.714,2,9,11,5,2,6,1,10,22,2006/2007
"Voskuhl,Jake",121,255,.475,0,0,,121,255,.475,77,113,.681,84,172,256,44,30,56,24,199,319,2006/2007
"Vujačić,Sasha",105,268,.392,60,161,.373,45,107,.421,43,49,.878,28,79,107,64,41,30,1,103,313,2006/2007
"Wade,Dwyane",472,962,.491,21,79,.266,451,883,.511,432,535,.807,51,188,239,384,107,216,62,117,1397,2006/2007
"Wafer,Von",0,1,.000,0,1,.000,0,0,,0,0,,0,0,0,0,0,0,0,0,0,2006/2007
"Wagner,Dajuan",1,1,1.000,1,1,1.000,0,0,,1,2,.500,0,0,0,1,0,1,0,1,4,2006/2007
"Walker,Antoine",265,668,.397,84,305,.275,181,363,.499,46,105,.438,92,247,339,130,48,141,17,173,660,2006/2007
"Wallace,Ben",192,424,.453,1,5,.200,191,419,.456,109,267,.408,303,518,821,186,111,101,156,153,494,2006/2007
"Wallace,Gerald",478,952,.502,39,120,.325,439,832,.528,309,447,.691,142,376,518,185,144,160,69,209,1304,2006/2007
"Wallace,Rasheed",357,843,.423,104,296,.351,253,547,.463,108,137,.788,90,453,543,127,75,94,118,225,926,2006/2007
"Walton,Luke",264,557,.474,48,124,.387,216,433,.499,108,145,.745,87,215,302,257,60,118,21,117,684,2006/2007
"Warrick,Hakim",373,712,.524,0,8,.000,373,704,.530,299,388,.771,130,290,420,75,43,161,30,232,1045,2006/2007
"Watson,Earl",263,687,.383,92,280,.329,171,407,.420,108,147,.735,34,151,185,437,99,167,23,152,726,2006/2007
"Webber,Chris",289,639,.452,4,11,.364,285,628,.454,102,160,.638,124,313,437,188,60,107,41,143,684,2006/2007
"Webber,Chris",89,230,.387,2,5,.400,87,225,.387,18,28,.643,37,112,149,61,18,33,15,36,198,2006/2007
"Webber,Chris",200,409,.489,2,6,.333,198,403,.491,84,132,.636,87,201,288,127,42,74,26,107,486,2006/2007
"Webster,Martell",195,492,.396,91,250,.364,104,242,.430,93,132,.705,43,197,240,52,35,76,19,126,574,2006/2007
"Wells,Bonzi",85,207,.411,1,7,.143,84,200,.420,46,82,.561,26,94,120,31,24,57,13,62,217,2006/2007
"Wesley,David",22,75,.293,9,38,.237,13,37,.351,20,28,.714,3,32,35,37,12,17,4,32,73,2006/2007
"West,David",377,792,.476,8,25,.320,369,767,.481,187,227,.824,126,298,424,114,42,98,38,143,949,2006/2007
"West,Delonte",306,717,.427,65,178,.365,241,539,.447,168,197,.853,32,176,208,304,74,140,34,152,845,2006/2007
"White,James",18,41,.439,2,7,.286,16,34,.471,12,15,.800,3,17,20,5,3,5,1,7,50,2006/2007
"Wilcox,Chris",433,819,.529,0,6,.000,433,813,.533,240,351,.684,178,451,629,82,70,127,38,248,1106,2006/2007
"Wilkins,Damien",262,602,.435,50,122,.410,212,480,.442,150,170,.882,87,142,229,156,92,116,16,157,724,2006/2007
"Wilks,Mike",66,141,.468,5,15,.333,61,126,.484,33,42,.786,15,39,54,79,15,31,4,53,170,2006/2007
"Williams,Aaron",29,53,.547,0,1,.000,29,52,.558,18,22,.818,27,58,85,7,7,18,14,56,76,2006/2007
"Williams,Alvin",0,2,.000,0,1,.000,0,1,.000,2,4,.500,1,0,1,3,2,3,0,0,2,2006/2007
"Williams,Deron",494,1083,.456,82,255,.322,412,828,.498,227,296,.767,41,226,267,745,78,246,13,254,1297,2006/2007
"Williams,Eric",19,47,.404,8,19,.421,11,28,.393,8,14,.571,3,14,17,7,3,7,0,12,54,2006/2007
"Williams,Eric",15,34,.441,8,17,.471,7,17,.412,4,7,.571,1,13,14,6,2,5,0,6,42,2006/2007
"Williams,Eric",4,13,.308,0,2,.000,4,11,.364,4,7,.571,2,1,3,1,1,2,0,6,12,2006/2007
"Williams,Jason",235,569,.413,100,295,.339,135,274,.493,94,103,.913,18,123,141,322,58,100,1,68,664,2006/2007
"Williams,Justin",54,88,.614,0,1,.000,54,87,.621,23,63,.365,51,64,115,2,5,15,16,51,131,2006/2007
"Williams,Lou",93,211,.441,12,37,.324,81,174,.466,64,92,.696,17,53,70,110,22,46,1,42,262,2006/2007
"Williams,Marcus",208,526,.395,46,163,.282,162,363,.446,72,85,.847,29,134,163,260,29,142,2,96,534,2006/2007
"Williams,Marvin",306,706,.433,11,45,.244,295,661,.446,216,265,.815,84,253,337,121,52,127,30,191,839,2006/2007
"Williams,Mo",468,1049,.446,79,228,.346,389,821,.474,159,186,.855,54,275,329,416,85,203,6,201,1174,2006/2007
"Williams,Shammond",35,86,.407,20,50,.400,15,36,.417,4,6,.667,11,29,40,31,12,13,0,20,94,2006/2007
"Williams,Shawne",75,160,.469,19,52,.365,56,108,.519,11,20,.550,33,50,83,22,6,24,8,69,180,2006/2007
"Williams,Shelden",166,365,.455,2,4,.500,164,361,.454,110,144,.764,131,304,435,44,52,96,39,199,444,2006/2007
"Williamson,Corliss",236,463,.510,0,2,.000,236,461,.512,148,207,.715,63,158,221,39,29,97,15,183,620,2006/2007
"Willis,Kevin",5,13,.385,0,0,,5,13,.385,2,2,1.000,2,6,8,1,2,2,1,11,12,2006/2007
"World Peace,Metta",458,1040,.440,93,260,.358,365,780,.468,307,415,.740,102,352,454,235,149,146,43,205,1316,2006/2007
"Wright,Antoine",110,251,.438,19,59,.322,91,192,.474,44,73,.603,38,137,175,55,30,43,10,120,283,2006/2007
"Wright,Bracey",24,60,.400,6,20,.300,18,40,.450,13,18,.722,7,14,21,15,9,6,1,6,67,2006/2007
"Wright,Dorell",162,364,.445,5,34,.147,157,330,.476,64,86,.744,40,232,272,95,41,65,46,112,393,2006/2007
"Wright,Lorenzen",82,183,.448,0,0,,82,183,.448,9,32,.281,85,131,216,40,28,39,28,204,173,2006/2007
"Abdur-Rahim,Shareef",3,14,.214,0,0,,3,14,.214,4,4,1.000,6,4,10,4,1,1,0,9,10,2007/2008
"Afflalo,Arron",99,241,.411,10,48,.208,89,193,.461,68,87,.782,36,101,137,52,31,34,8,83,276,2007/2008
"Ager,Maurice",21,65,.323,3,19,.158,18,46,.391,6,12,.500,4,9,13,8,0,6,1,17,51,2007/2008
"Ager,Maurice",5,27,.185,0,8,.000,5,19,.263,5,6,.833,1,3,4,4,0,3,1,11,15,2007/2008
"Ager,Maurice",16,38,.421,3,11,.273,13,27,.481,1,6,.167,3,6,9,4,0,3,0,6,36,2007/2008
"Ahearn,Blake",15,57,.263,10,34,.294,5,23,.217,30,31,.968,1,18,19,19,6,16,0,20,70,2007/2008
"Aldridge,LaMarcus",561,1160,.484,1,7,.143,560,1153,.486,227,298,.762,220,358,578,122,55,126,94,240,1350,2007/2008
"Allen,Malik",157,327,.480,1,2,.500,156,325,.480,23,25,.920,66,130,196,44,19,45,31,149,338,2007/2008
"Allen,Malik",124,261,.475,1,2,.500,123,259,.475,12,13,.923,42,86,128,29,15,32,21,89,261,2007/2008
"Allen,Malik",33,66,.500,0,0,,33,66,.500,11,12,.917,24,44,68,15,4,13,10,60,77,2007/2008
"Allen,Ray",439,986,.445,180,452,.398,259,534,.485,215,237,.907,75,193,268,225,65,127,16,147,1273,2007/2008
"Allen,Tony",169,389,.434,18,57,.316,151,332,.455,138,181,.762,34,134,168,114,62,109,21,168,494,2007/2008
"Allred,Lance",1,4,.250,0,0,,1,4,.250,1,2,.500,0,1,1,0,0,0,0,1,3,2007/2008
"Almond,Morris",4,15,.267,1,4,.250,3,11,.273,4,6,.667,0,2,2,3,1,2,0,5,13,2007/2008
"Alston,Rafer",364,924,.394,143,407,.351,221,517,.427,98,137,.715,28,232,260,392,98,160,18,139,969,2007/2008
"Amundson,Lou",8,16,.500,0,0,,8,16,.500,2,7,.286,7,5,12,0,1,2,1,13,18,2007/2008
"Andersen,Chris",2,7,.286,0,0,,2,7,.286,2,4,.500,2,7,9,0,0,1,4,6,6,2007/2008
"Anderson,Derek",47,125,.376,19,52,.365,28,73,.384,28,38,.737,9,43,52,44,12,25,1,49,141,2007/2008
"Anthony,Carmelo",728,1481,.492,58,164,.354,670,1317,.509,464,590,.786,178,393,571,259,98,253,39,253,1978,2007/2008
"Anthony,Joel",28,60,.467,0,0,,28,60,.467,29,49,.592,38,55,93,3,9,17,31,55,85,2007/2008
"Arenas,Gilbert",78,196,.398,22,78,.282,56,118,.475,74,96,.771,6,45,51,66,23,49,1,30,252,2007/2008
"Ariza,Trevor",69,136,.507,5,18,.278,64,118,.542,49,75,.653,30,78,108,44,31,23,11,45,192,2007/2008
"Ariza,Trevor",14,31,.452,0,3,.000,14,28,.500,8,15,.533,5,19,24,8,5,5,3,9,36,2007/2008
"Ariza,Trevor",55,105,.524,5,15,.333,50,90,.556,41,60,.683,25,59,84,36,26,18,8,36,156,2007/2008
"Armstrong,Darrell",40,110,.364,23,69,.333,17,41,.415,20,30,.667,17,50,67,73,28,41,2,53,123,2007/2008
"Armstrong,Hilton",67,148,.453,0,0,,67,148,.453,44,70,.629,65,98,163,23,15,59,34,130,178,2007/2008
"Arroyo,Carlos",157,348,.451,29,84,.345,128,264,.485,87,102,.853,10,103,113,219,26,77,2,85,430,2007/2008
"Atkins,Chucky",42,122,.344,25,79,.316,17,43,.395,4,9,.444,3,28,31,47,9,10,1,27,113,2007/2008
"Augustine,James",18,34,.529,0,0,,18,34,.529,4,8,.500,16,14,30,2,5,6,2,18,40,2007/2008
"Azubuike,Kelenna",261,587,.445,71,195,.364,190,392,.485,99,138,.717,107,217,324,75,45,58,34,159,692,2007/2008
"Balkman,Renaldo",91,186,.489,1,12,.083,90,174,.517,41,95,.432,83,133,216,40,44,37,30,132,224,2007/2008
"Banks,Marcus",86,191,.450,40,102,.392,46,89,.517,27,35,.771,4,41,45,61,14,37,13,65,239,2007/2008
"Banks,Marcus",44,109,.404,25,65,.385,19,44,.432,12,16,.750,3,17,20,25,8,16,8,38,125,2007/2008
"Banks,Marcus",42,82,.512,15,37,.405,27,45,.600,15,19,.789,1,24,25,36,6,21,5,27,114,2007/2008
"Barbosa,Leandro",472,1021,.462,164,422,.389,308,599,.514,175,213,.822,40,191,231,216,75,117,18,195,1283,2007/2008
"Barea,J.J.",71,170,.418,21,54,.389,50,116,.431,28,35,.800,4,43,47,58,14,35,1,48,191,2007/2008
"Bargnani,Andrea",280,725,.386,90,261,.345,190,464,.409,142,169,.840,50,238,288,89,23,88,37,211,792,2007/2008
"Barnes,Matt",187,442,.423,53,181,.293,134,261,.513,59,79,.747,94,230,324,139,48,85,36,159,486,2007/2008
"Barrett,Andre",2,5,.400,1,3,.333,1,2,.500,1,2,.500,0,1,1,7,0,1,0,1,6,2007/2008
"Barron,Earl",132,327,.404,1,13,.077,131,314,.417,61,87,.701,67,131,198,29,19,48,8,114,326,2007/2008
"Barry,Brent",77,160,.481,48,112,.429,29,48,.604,19,20,.950,12,43,55,54,17,18,3,43,221,2007/2008
"Bass,Brandon",246,493,.499,0,4,.000,246,489,.503,162,197,.822,120,227,347,58,22,82,48,150,654,2007/2008
"Baston,Maceo",17,25,.680,0,0,,17,25,.680,7,10,.700,9,17,26,3,2,4,4,20,41,2007/2008
"Battier,Shane",265,619,.428,139,369,.377,126,250,.504,75,101,.743,131,276,407,155,77,78,90,196,744,2007/2008
"Belinelli,Marco",36,93,.387,16,41,.390,20,52,.385,7,9,.778,3,11,14,15,5,12,0,15,95,2007/2008
"Bell,Charlie",185,486,.381,74,217,.341,111,269,.413,70,87,.805,31,136,167,210,52,76,2,121,514,2007/2008
"Bell,Raja",317,753,.421,176,439,.401,141,314,.449,79,91,.868,47,227,274,168,54,65,27,220,889,2007/2008
"Bibby,Mike",248,603,.411,93,248,.375,155,355,.437,78,100,.780,16,144,160,290,54,119,4,97,667,2007/2008
"Bibby,Mike",78,192,.406,24,61,.393,54,131,.412,23,31,.742,11,45,56,75,19,38,2,34,203,2007/2008
"Bibby,Mike",170,411,.414,69,187,.369,101,224,.451,55,69,.797,5,99,104,215,35,81,2,63,464,2007/2008
"Biedriņš,Andris",340,543,.626,0,0,,340,543,.626,116,187,.620,256,488,744,75,56,85,94,262,796,2007/2008
"Billups,Chauncey",393,877,.448,137,342,.401,256,535,.479,401,437,.918,42,170,212,529,101,160,17,130,1324,2007/2008
"Blake,Steve",261,640,.408,121,298,.406,140,342,.409,49,64,.766,31,164,195,413,55,113,4,133,692,2007/2008
"Blatche,Andray",254,536,.474,3,13,.231,251,523,.480,107,154,.695,164,261,425,92,53,112,114,258,618,2007/2008
"Blount,Mark",238,515,.462,17,44,.386,221,471,.469,88,138,.638,69,194,263,41,33,70,34,133,581,2007/2008
"Bogans,Keith",241,588,.410,148,409,.362,93,179,.520,81,110,.736,42,224,266,104,59,53,10,164,711,2007/2008
"Bogut,Andrew",465,910,.511,0,7,.000,465,903,.515,189,322,.587,245,518,763,199,64,172,135,254,1119,2007/2008
"Bonner,Matt",121,291,.416,46,137,.336,75,154,.487,38,44,.864,53,139,192,32,14,39,17,111,326,2007/2008
"Boone,Josh",238,434,.548,0,0,,238,434,.548,99,217,.456,192,317,509,55,36,68,61,155,575,2007/2008
"Booth,Calvin",9,27,.333,0,0,,9,27,.333,6,10,.600,6,32,38,8,6,4,18,35,24,2007/2008
"Boozer,Carlos",709,1297,.547,0,1,.000,709,1296,.547,290,393,.738,197,647,844,233,100,210,41,293,1708,2007/2008
"Bosh,Chris",507,1027,.494,10,25,.400,497,1002,.496,472,559,.844,174,409,583,171,63,153,67,157,1496,2007/2008
"Bowen,Bruce",174,428,.407,90,215,.419,84,213,.394,45,69,.652,33,201,234,91,54,46,22,177,483,2007/2008
"Bowen,Ryan",49,100,.490,0,1,.000,49,99,.495,16,29,.552,55,45,100,25,32,15,11,77,114,2007/2008
"Boykins,Earl",61,172,.355,14,44,.318,47,128,.367,49,59,.831,9,25,34,96,13,41,0,21,185,2007/2008
"Brand,Elton",52,114,.456,0,0,,52,114,.456,37,47,.787,21,43,64,16,3,17,15,21,141,2007/2008
"Brewer,Corey",182,486,.374,7,36,.194,175,450,.389,88,110,.800,82,210,292,111,76,89,25,188,459,2007/2008
"Brewer,Ronnie",354,634,.558,11,50,.220,343,584,.587,195,257,.759,97,121,218,134,129,69,19,110,914,2007/2008
"Brezec,Primož",44,94,.468,0,0,,44,94,.468,24,40,.600,30,51,81,11,3,24,7,83,112,2007/2008
"Brezec,Primož",17,43,.395,0,0,,17,43,.395,3,5,.600,14,30,44,6,0,15,3,35,37,2007/2008
"Brezec,Primož",10,13,.769,0,0,,10,13,.769,7,14,.500,7,12,19,4,2,5,2,23,27,2007/2008
"Brezec,Primož",17,38,.447,0,0,,17,38,.447,14,21,.667,9,9,18,1,1,4,2,25,48,2007/2008
"Brooks,Aaron",93,225,.413,36,109,.330,57,116,.491,42,49,.857,13,43,56,87,13,44,5,69,264,2007/2008
"Brown,Andre",39,78,.500,0,0,,39,78,.500,22,49,.449,37,55,92,8,7,14,4,38,100,2007/2008
"Brown,Devin",217,531,.409,45,146,.308,172,385,.447,107,142,.754,65,198,263,175,52,99,7,144,586,2007/2008
"Brown,Kwame",72,142,.507,0,0,,72,142,.507,40,98,.408,51,137,188,45,22,51,23,82,184,2007/2008
"Brown,Kwame",53,103,.515,0,0,,53,103,.515,26,64,.406,31,100,131,28,16,37,19,58,132,2007/2008
"Brown,Kwame",19,39,.487,0,0,,19,39,.487,14,34,.412,20,37,57,17,6,14,4,24,52,2007/2008
"Brown,P.J.",14,41,.341,0,1,.000,14,40,.350,11,16,.688,29,39,68,10,5,10,8,29,39,2007/2008
"Brown,Shannon",44,126,.349,9,30,.300,35,96,.365,17,29,.586,6,14,20,17,11,24,3,29,114,2007/2008
"Brown,Shannon",41,111,.369,9,29,.310,32,82,.390,14,23,.609,5,13,18,17,10,19,1,27,105,2007/2008
"Brown,Shannon",3,15,.200,0,1,.000,3,14,.214,3,6,.500,1,1,2,0,1,5,2,2,9,2007/2008
"Bryant,Kobe",775,1690,.459,150,415,.361,625,1275,.490,623,742,.840,94,423,517,441,151,257,40,227,2323,2007/2008
"Buckner,Greg",45,117,.385,15,50,.300,30,67,.448,19,22,.864,10,55,65,39,21,29,2,63,124,2007/2008
"Butler,Caron",439,943,.466,66,185,.357,373,758,.492,236,262,.901,93,295,388,284,128,150,20,160,1180,2007/2008
"Butler,Rasual",91,260,.350,44,133,.331,47,127,.370,26,31,.839,16,84,100,36,15,10,21,66,252,2007/2008
"Bynum,Andrew",189,297,.636,0,0,,189,297,.636,82,118,.695,105,251,356,61,12,52,72,98,460,2007/2008
"Calderón,José",367,707,.519,79,184,.429,288,523,.551,109,120,.908,34,202,236,678,87,126,6,134,922,2007/2008
"Camby,Marcus",286,635,.450,6,20,.300,280,615,.455,143,202,.708,230,807,1037,259,85,118,285,216,721,2007/2008
"Cardinal,Brian",43,126,.341,25,81,.309,18,45,.400,13,19,.684,26,70,96,22,10,23,2,62,124,2007/2008
"Carney,Rodney",158,392,.403,38,120,.317,120,272,.441,55,81,.679,50,99,149,32,39,34,23,96,409,2007/2008
"Carroll,Matt",252,589,.428,105,241,.436,147,348,.422,111,138,.804,33,193,226,73,46,58,19,187,720,2007/2008
"Carter,Anthony",218,476,.458,45,129,.349,173,347,.499,64,85,.753,27,173,200,388,107,124,28,172,545,2007/2008
"Carter,Vince",587,1287,.456,98,273,.359,489,1014,.482,350,429,.816,112,341,453,389,93,181,33,241,1622,2007/2008
"Cassell,Sam",233,532,.438,23,76,.303,210,456,.461,127,144,.882,17,119,136,214,37,97,6,98,616,2007/2008
"Cassell,Sam",183,402,.455,14,54,.259,169,348,.486,106,119,.891,12,93,105,179,28,78,3,69,486,2007/2008
"Cassell,Sam",50,130,.385,9,22,.409,41,108,.380,21,25,.840,5,26,31,35,9,19,3,29,130,2007/2008
"Chandler,Tyson",377,605,.623,0,1,.000,377,604,.624,175,295,.593,322,606,928,81,45,136,84,243,929,2007/2008
"Chandler,Wilson",106,242,.438,9,30,.300,97,212,.458,34,54,.630,38,89,127,33,15,27,16,83,255,2007/2008
"Childress,Josh",327,573,.571,22,60,.367,305,513,.595,222,275,.807,174,199,373,117,71,98,43,129,898,2007/2008
"Collins,Jarron",36,82,.439,0,1,.000,36,81,.444,46,74,.622,40,76,116,37,10,22,6,106,118,2007/2008
"Collins,Jason",53,113,.469,0,1,.000,53,112,.473,34,74,.459,64,114,178,25,23,48,25,194,140,2007/2008
"Collins,Jason",23,54,.426,0,0,,23,54,.426,14,36,.389,35,54,89,19,11,23,8,110,60,2007/2008
"Collins,Jason",30,59,.508,0,1,.000,30,58,.517,20,38,.526,29,60,89,6,12,25,17,84,80,2007/2008
"Collins,Mardy",57,175,.326,8,32,.250,49,143,.343,23,38,.605,19,56,75,89,24,56,8,56,145,2007/2008
"Collison,Nick",322,641,.502,0,2,.000,322,639,.504,123,167,.737,254,476,730,113,47,118,60,250,767,2007/2008
"Conley,Mike",189,442,.428,30,91,.330,159,351,.453,90,123,.732,21,118,139,222,44,89,2,85,498,2007/2008
"Cook,Brian",88,234,.376,43,115,.374,45,119,.378,19,21,.905,28,81,109,27,13,39,12,93,238,2007/2008
"Cook,Brian",4,21,.190,2,10,.200,2,11,.182,4,4,1.000,4,6,10,3,2,4,0,6,14,2007/2008
"Cook,Brian",84,213,.394,41,105,.390,43,108,.398,15,17,.882,24,75,99,24,11,35,12,87,224,2007/2008
"Cook,Daequan",196,514,.381,79,238,.332,117,276,.424,47,57,.825,20,157,177,75,23,63,9,157,518,2007/2008
"Crawford,Jamal",570,1391,.410,176,494,.356,394,897,.439,329,381,.864,37,170,207,398,81,192,17,144,1645,2007/2008
"Crittenton,Javaris",98,233,.421,10,37,.270,88,196,.449,72,104,.692,27,83,110,51,19,55,2,47,278,2007/2008
"Crittenton,Javaris",26,53,.491,1,3,.333,25,50,.500,19,28,.679,7,14,21,18,7,22,0,12,72,2007/2008
"Crittenton,Javaris",72,180,.400,9,34,.265,63,146,.432,53,76,.697,20,69,89,33,12,33,2,35,206,2007/2008
"Croshere,Austin",61,137,.445,22,61,.361,39,76,.513,29,32,.906,33,71,104,30,8,22,6,60,173,2007/2008
"Curry,Eddy",297,544,.546,0,0,,297,544,.546,187,300,.623,111,164,275,32,14,126,29,157,781,2007/2008
"Dalembert,Samuel",339,661,.513,0,1,.000,339,660,.514,186,263,.707,304,545,849,45,40,155,192,269,864,2007/2008
"Dampier,Erick",178,277,.643,0,0,,178,277,.643,84,146,.575,207,332,539,63,24,80,106,226,440,2007/2008
"Daniels,Antonio",205,447,.459,17,74,.230,188,373,.504,170,219,.776,23,180,203,340,69,91,2,78,597,2007/2008
"Daniels,Marquis",241,561,.430,27,102,.265,214,459,.466,97,139,.698,66,146,212,137,79,112,18,121,606,2007/2008
"Davidson,Jermareo",51,125,.408,0,0,,51,125,.408,18,28,.643,21,41,62,13,7,17,15,46,120,2007/2008
"Davis,Baron",650,1526,.426,173,525,.330,477,1001,.477,318,424,.750,96,289,385,623,191,232,43,247,1791,2007/2008
"Davis,Glen",107,221,.484,0,0,,107,221,.484,99,150,.660,95,113,208,28,31,65,20,160,313,2007/2008
"Davis,Paul",24,65,.369,0,0,,24,65,.369,6,10,.600,25,22,47,10,6,9,6,33,54,2007/2008
"Davis,Ricky",420,971,.433,135,333,.405,285,638,.447,155,197,.787,55,298,353,276,87,191,14,187,1130,2007/2008
"Delfino,Carlos",251,632,.397,120,314,.382,131,318,.412,116,156,.744,66,293,359,145,69,75,11,177,738,2007/2008
"Deng,Luol",429,896,.479,8,22,.364,421,874,.482,204,265,.770,136,258,394,155,57,120,29,117,1070,2007/2008
"Diaw,Boris",308,646,.477,13,41,.317,295,605,.488,96,129,.744,97,281,378,317,61,155,39,166,725,2007/2008
"Diawara,Yakhouba",55,134,.410,21,66,.318,34,68,.500,22,31,.710,23,39,62,37,8,16,3,61,153,2007/2008
"Díaz,Guillermo",1,4,.250,0,1,.000,1,3,.333,3,5,.600,2,0,2,1,0,0,0,0,5,2007/2008
"Dickau,Dan",124,296,.419,36,108,.333,88,188,.468,68,82,.829,13,84,97,172,32,55,3,108,352,2007/2008
"Dickens,Kaniel",1,3,.333,0,0,,1,3,.333,0,0,,0,1,1,1,0,0,1,1,2,2007/2008
"Diener,Travis",159,430,.370,74,233,.318,85,197,.431,64,71,.901,26,89,115,251,35,55,4,107,456,2007/2008
"Diogu,Ike",64,134,.478,0,0,,64,134,.478,40,47,.851,38,47,85,10,7,20,3,43,168,2007/2008
"Diop,DeSagana",94,180,.522,0,0,,94,180,.522,38,70,.543,160,232,392,40,26,58,88,146,226,2007/2008
"Diop,DeSagana",67,115,.583,0,0,,67,115,.583,24,40,.600,111,159,270,26,20,42,63,100,158,2007/2008
"Diop,DeSagana",27,65,.415,0,0,,27,65,.415,14,30,.467,49,73,122,14,6,16,25,46,68,2007/2008
"Dixon,Juan",106,258,.411,30,72,.417,76,186,.409,21,26,.808,15,60,75,97,21,54,2,62,263,2007/2008
"Dixon,Juan",59,160,.369,17,39,.436,42,121,.347,18,19,.947,9,38,47,65,21,35,2,38,153,2007/2008
"Dixon,Juan",47,98,.480,13,33,.394,34,65,.523,3,7,.429,6,22,28,32,0,19,0,24,110,2007/2008
"Doleac,Michael",28,63,.444,0,0,,28,63,.444,1,2,.500,16,33,49,7,10,12,10,44,57,2007/2008
"Dooling,Keyon",198,423,.468,22,65,.338,176,358,.492,163,193,.845,7,94,101,133,36,61,5,131,581,2007/2008
"Douby,Quincy",132,335,.394,42,122,.344,90,213,.423,48,52,.923,17,66,83,53,30,59,12,80,354,2007/2008
"Dudley,Jared",163,348,.468,9,41,.220,154,307,.502,87,118,.737,121,165,286,81,55,50,10,128,422,2007/2008
"Duhon,Chris",133,344,.387,54,155,.348,79,189,.418,65,80,.813,19,97,116,263,48,71,2,92,385,2007/2008
"Duncan,Tim",585,1178,.497,0,4,.000,585,1174,.498,338,463,.730,237,644,881,218,56,178,152,185,1508,2007/2008
"Dunleavy,Mike",532,1117,.476,165,389,.424,367,728,.504,336,403,.834,59,365,424,288,86,190,31,208,1565,2007/2008
"Dupree,Ronald",1,3,.333,0,0,,1,3,.333,2,2,1.000,1,7,8,1,1,0,0,0,4,2007/2008
"Dupree,Ronald",0,0,,0,0,,0,0,,0,0,,0,0,0,0,0,0,0,0,0,2007/2008
"Dupree,Ronald",1,3,.333,0,0,,1,3,.333,2,2,1.000,1,7,8,1,1,0,0,0,4,2007/2008
"Durant,Kevin",587,1366,.430,59,205,.288,528,1161,.455,391,448,.873,70,278,348,192,78,232,75,122,1624,2007/2008
"Ellis,Monta",652,1227,.531,12,52,.231,640,1175,.545,320,417,.767,133,271,404,315,124,173,27,195,1636,2007/2008
"Elson,Francisco",92,236,.390,0,1,.000,92,235,.391,26,37,.703,50,150,200,24,15,47,20,96,210,2007/2008
"Elson,Francisco",62,148,.419,0,0,,62,148,.419,20,24,.833,33,102,135,16,9,30,14,62,144,2007/2008
"Elson,Francisco",30,88,.341,0,1,.000,30,87,.345,6,13,.462,17,48,65,8,6,17,6,34,66,2007/2008
"Ely,Melvin",85,180,.472,0,0,,85,180,.472,32,58,.552,28,117,145,22,7,42,18,79,202,2007/2008
"Evans,Maurice",262,545,.481,81,209,.388,181,336,.539,59,83,.711,92,126,218,81,46,40,10,142,664,2007/2008
"Evans,Maurice",9,28,.321,1,7,.143,8,21,.381,12,15,.800,4,5,9,12,5,0,1,10,31,2007/2008
"Evans,Maurice",253,517,.489,80,202,.396,173,315,.549,47,68,.691,88,121,209,69,41,40,9,132,633,2007/2008
"Evans,Reggie",152,346,.439,1,1,1.000,151,345,.438,120,257,.467,224,387,611,65,86,108,8,213,425,2007/2008
"Farmar,Jordan",291,631,.461,114,307,.371,177,324,.546,53,78,.679,39,144,183,225,77,108,5,105,749,2007/2008
"Fazekas,Nick",46,82,.561,0,2,.000,46,80,.575,15,22,.682,34,55,89,11,8,13,11,25,107,2007/2008
"Fazekas,Nick",2,5,.400,0,0,,2,5,.400,0,0,,1,2,3,0,0,0,0,0,4,2007/2008
"Fazekas,Nick",44,77,.571,0,2,.000,44,75,.587,15,22,.682,33,53,86,11,8,13,11,25,103,2007/2008
"Felton,Raymond",412,997,.413,56,200,.280,356,797,.447,260,325,.800,37,199,236,583,96,213,12,184,1140,2007/2008
"Fesenko,Kyrylo",6,16,.375,0,0,,6,16,.375,2,4,.500,14,11,25,2,0,8,3,19,14,2007/2008
"Finley,Michael",315,761,.414,132,357,.370,183,404,.453,64,80,.800,27,227,254,114,29,56,10,93,826,2007/2008
"Fisher,Derek",339,777,.436,112,276,.406,227,501,.453,166,188,.883,24,146,170,239,86,90,3,188,956,2007/2008
"Ford,T.J.",246,524,.469,15,51,.294,231,473,.488,110,125,.880,23,77,100,313,54,102,0,93,617,2007/2008
"Foster,Jeff",205,373,.550,0,3,.000,205,370,.554,86,145,.593,264,404,668,129,56,62,32,221,496,2007/2008
"Foye,Randy",198,462,.429,61,148,.412,137,314,.436,53,65,.815,13,115,128,164,36,79,3,102,510,2007/2008
"Foyle,Adonal",70,153,.458,0,0,,70,153,.458,16,34,.471,71,137,208,18,16,32,45,94,156,2007/2008
"Frahm,Richie",20,54,.370,7,25,.280,13,29,.448,0,2,.000,4,10,14,8,2,6,0,7,47,2007/2008
"Francis,Steve",19,57,.333,4,17,.235,15,40,.375,13,23,.565,8,15,23,30,9,14,5,25,55,2007/2008
"Frye,Channing",221,453,.488,3,10,.300,218,443,.492,85,109,.780,107,247,354,57,29,55,27,208,530,2007/2008
"Gadzuric,Dan",64,154,.416,0,1,.000,64,153,.418,33,63,.524,67,77,144,11,20,34,24,83,161,2007/2008
"Garbajosa,Jorge",8,25,.320,6,16,.375,2,9,.222,0,0,,2,13,15,3,3,1,0,2,22,2007/2008
"García,Francisco",348,752,.463,113,289,.391,235,463,.508,162,208,.779,52,212,264,128,96,128,50,232,971,2007/2008
"Gardner,Thomas",9,23,.391,3,12,.250,6,11,.545,0,2,.000,3,1,4,1,0,4,0,4,21,2007/2008
"Garnett,Kevin",534,990,.539,0,11,.000,534,979,.545,269,336,.801,135,520,655,244,100,138,89,163,1337,2007/2008
"Garrity,Pat",27,80,.338,8,37,.216,19,43,.442,4,5,.800,9,35,44,13,6,17,1,35,66,2007/2008
"Gasol,Pau",475,890,.534,4,16,.250,471,874,.539,292,362,.807,155,398,553,211,30,124,98,139,1246,2007/2008
"Gasol,Pau",279,557,.501,4,15,.267,275,542,.507,176,215,.819,94,248,342,116,16,80,56,85,738,2007/2008
"Gasol,Pau",196,333,.589,0,1,.000,196,332,.590,116,147,.789,61,150,211,95,14,44,42,54,508,2007/2008
"Gay,Rudy",625,1355,.461,134,387,.346,491,968,.507,248,316,.785,140,359,499,158,111,190,79,230,1632,2007/2008
"Gelabale,Mickaël",69,157,.439,16,37,.432,53,120,.442,14,18,.778,16,42,58,33,10,27,9,31,168,2007/2008
"George,Devean",74,207,.357,22,68,.324,52,139,.374,24,34,.706,28,109,137,35,19,24,13,90,194,2007/2008
"Gibson,Daniel",201,465,.432,118,268,.440,83,197,.421,85,105,.810,30,104,134,145,47,76,14,163,605,2007/2008
"Gill,Eddie",12,31,.387,5,15,.333,7,16,.438,9,9,1.000,1,21,22,22,7,9,2,18,38,2007/2008
"Gill,Eddie",12,29,.414,5,14,.357,7,15,.467,9,9,1.000,1,21,22,21,7,8,2,18,38,2007/2008
"Gill,Eddie",0,2,.000,0,1,.000,0,1,.000,0,0,,0,0,0,1,0,1,0,0,0,2007/2008
"Ginóbili,Manu",453,984,.460,156,389,.401,297,595,.499,380,442,.860,63,291,354,332,109,200,33,173,1442,2007/2008
"Giriček,Gordan",133,302,.440,36,99,.364,97,203,.478,23,26,.885,16,80,96,62,24,52,4,82,325,2007/2008
"Giriček,Gordan",41,102,.402,12,34,.353,29,68,.426,1,1,1.000,6,25,31,16,13,21,1,24,95,2007/2008
"Giriček,Gordan",13,41,.317,5,15,.333,8,26,.308,6,8,.750,1,13,14,11,3,8,1,9,37,2007/2008
"Giriček,Gordan",79,159,.497,19,50,.380,60,109,.550,16,17,.941,9,42,51,35,8,23,2,49,193,2007/2008
"Gomes,Ryan",392,857,.457,59,179,.330,333,678,.491,190,229,.830,133,342,475,145,65,96,10,154,1033,2007/2008
"Gooden,Drew",332,740,.449,0,6,.000,332,734,.452,162,215,.753,175,415,590,81,48,122,53,203,826,2007/2008
"Gooden,Drew",232,523,.444,0,3,.000,232,520,.446,110,151,.728,117,306,423,50,35,91,30,144,574,2007/2008
"Gooden,Drew",100,217,.461,0,3,.000,100,214,.467,52,64,.813,58,109,167,31,13,31,23,59,252,2007/2008
"Gordon,Ben",464,1069,.434,142,346,.410,322,723,.445,266,293,.908,40,181,221,213,55,150,8,171,1336,2007/2008
"Gortat,Marcin",8,17,.471,0,0,,8,17,.471,2,3,.667,8,8,16,2,1,2,1,4,18,2007/2008
"Graham,Joey",49,113,.434,2,3,.667,47,110,.427,38,45,.844,18,49,67,15,3,23,0,47,138,2007/2008
"Graham,Stephen",34,58,.586,7,14,.500,27,44,.614,12,16,.750,4,18,22,9,4,10,1,14,87,2007/2008
"Granger,Danny",537,1205,.446,171,423,.404,366,782,.468,322,378,.852,93,393,486,166,95,171,84,290,1567,2007/2008
"Gray,Aaron",103,204,.505,0,1,.000,103,203,.507,56,99,.566,70,98,168,41,21,57,16,117,262,2007/2008
"Green,Gerald",52,151,.344,15,39,.385,37,112,.330,34,41,.829,13,51,64,29,8,32,4,45,153,2007/2008
"Green,Gerald",49,148,.331,15,39,.385,34,109,.312,34,41,.829,11,51,62,29,8,32,4,43,147,2007/2008
"Green,Gerald",3,3,1.000,0,0,,3,3,1.000,0,0,,2,0,2,0,0,0,0,2,6,2007/2008
"Green,Jeff",320,749,.427,21,76,.276,299,673,.444,177,238,.744,101,278,379,119,46,158,49,198,838,2007/2008
"Green,Taurean",7,25,.280,2,11,.182,5,14,.357,11,12,.917,0,10,10,11,2,9,0,5,27,2007/2008
"Green,Taurean",4,16,.250,1,8,.125,3,8,.375,8,8,1.000,0,4,4,8,1,7,0,3,17,2007/2008
"Green,Taurean",3,9,.333,1,3,.333,2,6,.333,3,4,.750,0,6,6,3,1,2,0,2,10,2007/2008
"Green,Willie",379,870,.436,51,179,.285,328,691,.475,112,148,.757,32,150,182,151,54,109,22,119,921,2007/2008
"Greene,Orien",3,11,.273,0,1,.000,3,10,.300,0,0,,0,6,6,3,3,7,1,9,6,2007/2008
"Griffin,Adrian",30,76,.395,0,0,,30,76,.395,5,9,.556,28,31,59,27,17,21,2,27,65,2007/2008
"Griffin,Adrian",24,60,.400,0,0,,24,60,.400,3,7,.429,19,18,37,22,12,16,1,19,51,2007/2008
"Griffin,Adrian",6,16,.375,0,0,,6,16,.375,2,2,1.000,9,13,22,5,5,5,1,8,14,2007/2008
"Hamilton,Richard",499,1030,.484,62,141,.440,437,889,.492,184,221,.833,75,160,235,299,73,132,10,171,1244,2007/2008
"Hardaway,Anfernee",22,60,.367,8,19,.421,14,41,.341,8,9,.889,3,32,35,35,19,13,1,24,60,2007/2008
"Harpring,Matt",237,474,.500,2,10,.200,235,464,.506,146,205,.712,96,144,240,82,45,95,14,162,622,2007/2008
"Harrington,Al",401,923,.434,153,408,.375,248,515,.482,147,190,.774,107,332,439,132,74,90,16,266,1102,2007/2008
"Harrington,Othella",18,42,.429,0,0,,18,42,.429,10,16,.625,11,31,42,4,1,11,4,34,46,2007/2008
"Harris,Devin",321,693,.463,56,167,.335,265,526,.504,248,301,.824,28,145,173,369,90,161,10,190,946,2007/2008
"Harris,Devin",187,387,.483,25,70,.357,162,317,.511,161,196,.821,17,74,91,206,56,93,2,127,560,2007/2008
"Harris,Devin",134,306,.438,31,97,.320,103,209,.493,87,105,.829,11,71,82,163,34,68,8,63,386,2007/2008
"Harris,Mike",27,54,.500,0,2,.000,27,52,.519,8,13,.615,24,30,54,3,6,9,3,16,62,2007/2008
"Harrison,David",90,170,.529,0,0,,90,170,.529,49,96,.510,43,75,118,14,20,58,59,164,229,2007/2008
"Hart,Jason",58,180,.322,11,31,.355,47,149,.315,38,45,.844,5,50,55,86,30,28,3,75,165,2007/2008
"Haslem,Udonis",237,507,.467,0,0,,237,507,.467,115,142,.810,107,336,443,68,39,67,18,145,589,2007/2008
"Hassell,Trenton",57,135,.422,2,9,.222,55,126,.437,7,10,.700,20,63,83,41,13,22,3,90,123,2007/2008
"Hassell,Trenton",37,80,.463,1,4,.250,36,76,.474,1,2,.500,11,33,44,26,9,14,1,55,76,2007/2008
"Hassell,Trenton",20,55,.364,1,5,.200,19,50,.380,6,8,.750,9,30,39,15,4,8,2,35,47,2007/2008
"Hawes,Spencer",146,318,.459,4,21,.190,142,297,.478,38,58,.655,68,162,230,44,14,56,40,128,334,2007/2008
"Hayes,Chuck",113,221,.511,0,3,.000,113,218,.518,11,24,.458,132,295,427,91,85,62,43,212,237,2007/2008
"Hayes,Jarvis",217,504,.431,73,194,.376,144,310,.465,45,60,.750,35,143,178,62,47,47,6,137,552,2007/2008
"Haywood,Brendan",316,599,.528,0,0,,316,599,.528,216,294,.735,273,303,576,71,31,108,133,216,848,2007/2008
"Head,Luther",206,477,.432,79,225,.351,127,252,.504,66,81,.815,18,117,135,138,44,70,9,75,557,2007/2008
"Herrmann,Walter",56,144,.389,20,64,.313,36,80,.450,21,25,.840,22,51,73,18,7,12,1,24,153,2007/2008
"Herrmann,Walter",25,65,.385,9,26,.346,16,39,.410,9,10,.900,10,26,36,4,4,4,0,12,68,2007/2008
"Herrmann,Walter",31,79,.392,11,38,.289,20,41,.488,12,15,.800,12,25,37,14,3,8,1,12,85,2007/2008
"Hilário,Nenê",29,71,.408,0,1,.000,29,70,.414,27,49,.551,30,57,87,15,9,21,14,46,85,2007/2008
"Hill,Grant",358,712,.503,33,104,.317,325,608,.535,170,196,.867,74,279,353,203,65,96,56,153,919,2007/2008
"Hinrich,Kirk",330,797,.414,84,240,.350,246,557,.442,118,142,.831,28,216,244,452,87,157,19,224,862,2007/2008
"Hollins,Ryan",46,94,.489,0,0,,46,94,.489,55,82,.671,53,54,107,14,10,25,30,96,147,2007/2008
"Horford,Al",333,668,.499,0,5,.000,333,663,.502,155,212,.731,248,537,785,124,60,137,76,267,821,2007/2008
"Horry,Robert",38,119,.319,18,70,.257,20,49,.408,18,28,.643,35,74,109,47,21,22,19,55,112,2007/2008
"House,Eddie",217,531,.409,117,298,.393,100,233,.429,33,36,.917,19,148,167,152,59,76,10,114,584,2007/2008
"Howard,Dwight",583,974,.599,0,4,.000,583,970,.601,529,897,.590,279,882,1161,110,74,263,176,274,1695,2007/2008
"Howard,Josh",567,1247,.455,67,210,.319,500,1037,.482,312,384,.813,120,412,532,164,59,114,32,202,1513,2007/2008
"Howard,Juwan",23,64,.359,0,0,,23,64,.359,11,14,.786,21,60,81,17,5,17,2,62,57,2007/2008
"Hudson,Troy",9,31,.290,4,12,.333,5,19,.263,6,6,1.000,0,7,7,9,3,7,0,4,28,2007/2008
"Hughes,Larry",305,801,.381,67,194,.345,238,607,.392,150,188,.798,39,191,230,181,99,116,17,139,827,2007/2008
"Hughes,Larry",180,478,.377,43,126,.341,137,352,.389,88,108,.815,27,116,143,94,60,72,11,91,491,2007/2008
"Hughes,Larry",125,323,.387,24,68,.353,101,255,.396,62,80,.775,12,75,87,87,39,44,6,48,336,2007/2008
"Humphries,Kris",161,333,.483,0,2,.000,161,331,.486,75,124,.605,90,169,259,28,25,47,28,107,397,2007/2008
"Hunter,Lindsey",22,64,.344,7,26,.269,15,38,.395,7,9,.778,4,9,13,33,13,13,2,30,58,2007/2008
"Hunter,Steven",15,28,.536,0,0,,15,28,.536,9,20,.450,10,19,29,0,0,7,6,20,39,2007/2008
"Iguodala,Andre",582,1277,.456,101,307,.329,481,970,.496,365,506,.721,85,361,446,391,171,214,49,187,1630,2007/2008
"Ilgauskas,Zydrunas",417,879,.474,0,1,.000,417,878,.475,195,243,.802,263,419,682,104,34,135,120,247,1029,2007/2008
"Ilunga-Mbenga,Didier",39,84,.464,0,0,,39,84,.464,5,12,.417,28,44,72,10,7,12,26,70,83,2007/2008
"Ilunga-Mbenga,Didier",9,23,.391,0,0,,9,23,.391,1,2,.500,13,18,31,4,3,4,10,32,19,2007/2008
"Ilunga-Mbenga,Didier",30,61,.492,0,0,,30,61,.492,4,10,.400,15,26,41,6,4,8,16,38,64,2007/2008
"Iverson,Allen",712,1556,.458,95,275,.345,617,1281,.482,645,797,.809,47,196,243,586,160,245,12,109,2164,2007/2008
"Ivey,Royal",149,378,.394,35,107,.327,114,271,.421,85,117,.726,38,80,118,160,45,75,7,166,418,2007/2008
"Jack,Jarrett",267,620,.431,65,190,.342,202,430,.470,215,248,.867,31,203,234,313,61,178,1,129,814,2007/2008
"Jackson,Bobby",204,506,.403,81,226,.358,123,280,.439,64,81,.790,33,148,181,139,45,59,5,96,553,2007/2008
"Jackson,Bobby",116,296,.392,53,144,.368,63,152,.414,40,49,.816,23,87,110,76,32,31,3,59,325,2007/2008
"Jackson,Bobby",88,210,.419,28,82,.341,60,128,.469,24,32,.750,10,61,71,63,13,28,2,37,228,2007/2008
"Jackson,Luke",26,80,.325,11,30,.367,15,50,.300,16,23,.696,7,26,33,17,8,9,0,22,79,2007/2008
"Jackson,Stephen",488,1204,.405,182,501,.363,306,703,.435,308,370,.832,67,251,318,300,92,197,29,171,1466,2007/2008
"Jacobsen,Casey",39,115,.339,16,72,.222,23,43,.535,13,17,.765,12,53,65,20,5,16,1,34,107,2007/2008
"James,Jerome",1,1,1.000,0,0,,1,1,1.000,2,2,1.000,0,3,3,0,0,0,0,0,4,2007/2008
"James,LeBron",794,1642,.484,113,359,.315,681,1283,.531,549,771,.712,133,459,592,539,138,255,81,165,2250,2007/2008
"James,Mike",101,290,.348,31,97,.320,70,193,.363,39,48,.813,14,55,69,60,21,36,2,56,272,2007/2008
"James,Mike",79,226,.350,24,74,.324,55,152,.362,33,42,.786,11,41,52,54,17,29,2,44,215,2007/2008
"James,Mike",22,64,.344,7,23,.304,15,41,.366,6,6,1.000,3,14,17,6,4,7,0,12,57,2007/2008
"Jamison,Antawn",618,1417,.436,120,354,.339,498,1063,.468,333,438,.760,215,591,806,120,106,113,34,195,1689,2007/2008
"Jarić,Marko",227,528,.430,46,127,.362,181,401,.451,121,163,.742,38,184,222,311,97,128,32,180,621,2007/2008
"Jefferson,Al",721,1441,.500,0,5,.000,721,1436,.502,284,394,.721,308,603,911,117,74,167,119,222,1726,2007/2008
"Jefferson,Richard",619,1328,.466,77,213,.362,542,1115,.486,542,679,.798,93,249,342,252,76,199,21,225,1857,2007/2008
"Jeffries,Jared",108,270,.400,4,25,.160,104,245,.424,49,93,.527,118,125,243,66,36,64,23,132,269,2007/2008
"Jianlian,Yi",219,520,.421,6,21,.286,213,499,.427,122,145,.841,106,238,344,55,36,90,56,153,566,2007/2008
"Johnson,Alexander",61,125,.488,0,0,,61,125,.488,57,83,.687,32,62,94,13,13,42,10,80,179,2007/2008
"Johnson,Amir",92,165,.558,0,0,,92,165,.558,37,55,.673,87,148,235,29,24,39,82,141,221,2007/2008
"Johnson,Anthony",155,355,.437,42,93,.452,113,262,.431,35,43,.814,22,115,137,262,52,84,9,115,387,2007/2008
"Johnson,Anthony",115,267,.431,27,63,.429,88,204,.431,26,32,.813,17,81,98,202,42,50,8,86,283,2007/2008
"Johnson,Anthony",40,88,.455,15,30,.500,25,58,.431,9,11,.818,5,34,39,60,10,34,1,29,104,2007/2008
"Johnson,DerMarr",7,14,.500,3,9,.333,4,5,.800,0,2,.000,0,1,1,1,1,0,0,4,17,2007/2008
"Johnson,Joe",647,1497,.432,169,444,.381,478,1053,.454,316,379,.834,83,284,367,474,84,223,18,168,1779,2007/2008
"Johnson,Linton",9,19,.474,1,3,.333,8,16,.500,2,2,1.000,5,9,14,4,0,5,1,11,21,2007/2008
"Johnson,Linton",7,14,.500,1,2,.500,6,12,.500,0,0,,5,8,13,3,0,2,1,10,15,2007/2008
"Johnson,Linton",2,5,.400,0,1,.000,2,4,.500,2,2,1.000,0,1,1,1,0,3,0,1,6,2007/2008
"Jones,Bobby",60,140,.429,18,53,.340,42,87,.483,40,51,.784,29,63,92,28,15,28,3,85,178,2007/2008
"Jones,Bobby",26,64,.406,9,23,.391,17,41,.415,23,28,.821,11,27,38,11,5,14,1,46,84,2007/2008
"Jones,Bobby",14,36,.389,3,13,.231,11,23,.478,9,10,.900,10,17,27,11,5,5,2,17,40,2007/2008
"Jones,Bobby",2,4,.500,0,0,,2,4,.500,0,0,,0,1,1,0,1,1,0,3,4,2007/2008
"Jones,Bobby",17,32,.531,6,15,.400,11,17,.647,8,13,.615,8,16,24,5,2,7,0,18,48,2007/2008
"Jones,Bobby",1,4,.250,0,2,.000,1,2,.500,0,0,,0,2,2,1,2,1,0,1,2,2007/2008
"Jones,Dahntay",23,53,.434,1,6,.167,22,47,.468,34,51,.667,7,28,35,12,8,10,6,28,81,2007/2008
"Jones,Damon",151,363,.416,115,276,.417,36,87,.414,20,28,.714,5,67,72,126,19,36,1,66,437,2007/2008
"Jones,Dwayne",25,47,.532,0,1,.000,25,46,.543,28,58,.483,69,71,140,10,10,17,25,88,78,2007/2008
"Jones,Eddie",66,180,.367,34,116,.293,32,64,.500,10,14,.714,18,114,132,69,26,29,8,72,176,2007/2008
"Jones,Fred",182,432,.421,74,192,.385,108,240,.450,94,126,.746,30,140,170,166,48,78,18,140,532,2007/2008
"Jones,James",143,327,.437,91,205,.444,52,122,.426,86,98,.878,43,118,161,34,24,28,15,96,463,2007/2008
"Jones,Solomon",12,30,.400,0,2,.000,12,28,.429,11,20,.550,19,23,42,0,3,11,5,28,35,2007/2008
"Kaman,Chris",338,700,.483,0,4,.000,338,696,.486,202,265,.762,173,538,711,107,33,164,155,179,878,2007/2008
"Kapono,Jason",243,498,.488,57,118,.483,186,380,.489,37,43,.860,31,89,120,65,34,58,2,131,580,2007/2008
"Karl,Coby",9,26,.346,4,13,.308,5,13,.385,8,10,.800,3,11,14,9,4,5,2,4,30,2007/2008
"Khryapa,Viktor",12,31,.387,0,1,.000,12,30,.400,8,14,.571,6,14,20,8,6,6,0,11,32,2007/2008
"Kidd,Jason",305,793,.385,119,312,.381,186,481,.387,135,165,.818,94,506,600,806,136,266,26,165,864,2007/2008
"Kidd,Jason",201,549,.366,84,236,.356,117,313,.374,91,111,.820,58,354,412,530,74,185,15,90,577,2007/2008
"Kidd,Jason",104,244,.426,35,76,.461,69,168,.411,44,54,.815,36,152,188,276,62,81,11,75,287,2007/2008
"Kinsey,Tarence",16,38,.421,3,7,.429,13,31,.419,5,6,.833,3,9,12,2,3,3,0,11,40,2007/2008
"Kirilenko,Andrei",275,544,.506,44,116,.379,231,428,.540,198,257,.770,121,218,339,285,86,140,109,165,792,2007/2008
"Kleiza,Linas",311,659,.472,94,277,.339,217,382,.568,164,213,.770,92,241,333,95,44,89,19,181,880,2007/2008
"Knight,Brevin",138,342,.404,0,6,.000,138,336,.411,62,71,.873,15,127,142,328,100,71,11,160,338,2007/2008
"Korver,Kyle",255,575,.443,111,296,.375,144,279,.516,119,130,.915,21,151,172,101,42,75,29,192,740,2007/2008
"Korver,Kyle",90,227,.396,38,108,.352,52,119,.437,31,34,.912,12,61,73,33,20,28,6,67,249,2007/2008
"Korver,Kyle",165,348,.474,73,188,.388,92,160,.575,88,96,.917,9,90,99,68,22,47,23,125,491,2007/2008
"Krstić,Nenad",123,300,.410,0,2,.000,123,298,.413,52,69,.754,35,165,200,27,9,41,17,111,298,2007/2008
"LaFrentz,Raef",27,61,.443,0,4,.000,27,57,.474,11,19,.579,28,39,67,6,12,10,17,59,65,2007/2008
"Landry,Carl",135,219,.616,0,1,.000,135,218,.619,72,109,.661,96,111,207,21,17,26,7,98,342,2007/2008
"Langford,Keith",1,4,.250,0,0,,1,4,.250,0,0,,0,2,2,0,0,0,0,1,2,2007/2008
"Lasme,Stéphane",32,71,.451,0,0,,32,71,.451,19,32,.594,26,27,53,3,13,15,22,35,83,2007/2008
"Lasme,Stéphane",0,0,,0,0,,0,0,,0,0,,0,0,0,0,0,0,0,0,0,2007/2008
"Lasme,Stéphane",32,71,.451,0,0,,32,71,.451,19,32,.594,26,27,53,3,13,15,22,35,83,2007/2008
"Law,Acie",95,237,.401,7,34,.206,88,203,.433,38,48,.792,12,45,57,113,29,56,0,73,235,2007/2008
"Lee,David",341,618,.552,0,2,.000,341,616,.554,194,237,.819,242,482,724,95,55,97,29,210,876,2007/2008
"Lewis,Rashard",516,1135,.455,226,553,.409,290,582,.498,218,260,.838,97,340,437,196,99,140,38,214,1476,2007/2008
"Lowry,Kyle",256,592,.432,36,140,.257,220,452,.487,243,348,.698,41,209,250,296,92,127,22,185,791,2007/2008
"Lue,Tyronn",113,253,.447,39,86,.453,74,167,.443,25,32,.781,9,45,54,74,11,27,1,66,290,2007/2008
"Lue,Tyronn",86,196,.439,30,69,.435,56,127,.441,24,28,.857,9,32,41,59,11,22,0,38,226,2007/2008
"Lue,Tyronn",27,57,.474,9,17,.529,18,40,.450,1,4,.250,0,13,13,15,0,5,1,28,64,2007/2008
"Madsen,Mark",3,19,.158,0,0,,3,19,.158,3,12,.250,18,20,38,4,3,9,2,25,9,2007/2008
"Maggette,Corey",458,1000,.458,78,203,.384,380,797,.477,553,681,.812,78,316,394,189,71,195,7,210,1547,2007/2008
"Magloire,Jamaal",18,55,.327,0,0,,18,55,.327,20,44,.455,19,70,89,7,1,30,10,50,56,2007/2008
"Magloire,Jamaal",15,49,.306,0,0,,15,49,.306,14,31,.452,18,63,81,7,0,23,10,42,44,2007/2008
"Magloire,Jamaal",3,6,.500,0,0,,3,6,.500,6,13,.462,1,7,8,0,1,7,0,8,12,2007/2008
"Mahinmi,Ian",6,12,.500,0,0,,6,12,.500,9,9,1.000,0,5,5,1,0,2,4,4,21,2007/2008
"Marbury,Stephon",111,265,.419,28,74,.378,83,191,.435,83,116,.716,17,42,59,113,21,48,2,57,333,2007/2008
"Marion,Shawn",400,787,.508,66,198,.333,334,589,.567,106,150,.707,136,507,643,138,125,86,85,150,972,2007/2008
"Marion,Shawn",304,578,.526,58,167,.347,246,411,.599,77,108,.713,86,378,464,98,95,49,70,117,743,2007/2008
"Marion,Shawn",96,209,.459,8,31,.258,88,178,.494,29,42,.690,50,129,179,40,30,37,15,33,229,2007/2008
"Marks,Sean",23,43,.535,1,4,.250,22,39,.564,12,19,.632,9,27,36,4,3,8,10,23,59,2007/2008
"Marshall,Donyell",32,98,.327,15,53,.283,17,45,.378,19,22,.864,24,52,76,10,6,15,16,31,98,2007/2008
"Marshall,Donyell",13,44,.295,8,23,.348,5,21,.238,7,9,.778,9,21,30,5,2,6,9,16,41,2007/2008
"Marshall,Donyell",19,54,.352,7,30,.233,12,24,.500,12,13,.923,15,31,46,5,4,9,7,15,57,2007/2008
"Martin,Darrick",10,43,.233,2,16,.125,8,27,.296,5,6,.833,3,4,7,21,6,1,0,12,27,2007/2008
"Martin,Kenyon",376,699,.538,2,11,.182,374,688,.544,123,212,.580,105,356,461,90,88,91,85,235,877,2007/2008
"Martin,Kevin",417,914,.456,107,266,.402,310,648,.478,502,578,.869,48,225,273,129,62,131,5,150,1443,2007/2008
"Mason,Desmond",230,477,.482,0,0,,230,477,.482,114,173,.659,75,181,256,121,40,83,30,106,574,2007/2008
"Mason,Roger",266,600,.443,130,327,.398,136,273,.498,62,71,.873,17,113,130,134,40,69,18,140,724,2007/2008
"Maxiell,Jason",240,446,.538,0,1,.000,240,445,.539,171,270,.633,177,256,433,46,21,71,94,183,651,2007/2008
"McCants,Rashad",428,944,.453,142,349,.407,286,595,.481,116,155,.748,50,156,206,162,66,172,18,234,1114,2007/2008
"McCoy,Jelani",1,1,1.000,0,0,,1,1,1.000,1,2,.500,1,6,7,0,0,4,5,7,3,2007/2008
"McDyess,Antonio",293,600,.488,0,2,.000,293,598,.490,97,156,.622,204,462,666,89,61,75,53,246,683,2007/2008
"McGrady,Tracy",548,1307,.419,86,295,.292,462,1012,.457,245,358,.684,42,297,339,387,68,160,30,91,1427,2007/2008
"McGuire,Dominic",39,103,.379,1,6,.167,38,97,.392,14,32,.438,53,86,139,40,20,40,26,76,93,2007/2008
"McInnis,Jeff",108,249,.434,3,19,.158,105,230,.457,23,30,.767,16,80,96,220,23,76,3,120,242,2007/2008
"McRoberts,Josh",6,10,.600,0,1,.000,6,9,.667,0,0,,2,8,10,2,1,2,0,1,12,2007/2008
"Mihm,Chris",32,95,.337,0,0,,32,95,.337,18,27,.667,28,49,77,13,4,17,14,42,82,2007/2008
"Miles,C.J.",113,236,.479,30,77,.390,83,159,.522,41,52,.788,16,62,78,53,32,27,8,98,297,2007/2008
"Miličić,Darko",219,500,.438,0,1,.000,219,499,.439,67,121,.554,127,297,424,58,32,101,114,185,505,2007/2008
"Miller,Andre",569,1156,.492,3,34,.088,566,1122,.504,257,333,.772,95,229,324,565,105,206,6,181,1398,2007/2008
"Miller,Brad",337,728,.463,28,90,.311,309,638,.484,262,309,.848,167,514,681,264,69,164,74,247,964,2007/2008
"Miller,Mike",414,824,.502,155,359,.432,259,465,.557,164,212,.774,51,416,467,240,35,182,16,145,1147,2007/2008
"Millsap,Paul",253,502,.504,0,4,.000,253,498,.508,155,229,.677,167,293,460,81,72,87,73,269,661,2007/2008
"Ming,Yao",432,852,.507,0,2,.000,432,850,.508,345,406,.850,172,422,594,129,25,183,111,171,1209,2007/2008
"Mobley,Cuttino",377,870,.433,67,192,.349,310,678,.457,163,199,.819,50,225,275,202,78,123,34,152,984,2007/2008
"Mohammed,Nazr",272,528,.515,0,1,.000,272,527,.516,95,163,.583,194,300,494,72,45,101,60,230,639,2007/2008
"Mohammed,Nazr",28,59,.475,0,1,.000,28,58,.483,13,30,.433,29,44,73,6,7,11,8,36,69,2007/2008
"Mohammed,Nazr",244,469,.520,0,0,,244,469,.520,82,133,.617,165,256,421,66,38,90,52,194,570,2007/2008
"Moon,Jamario",279,575,.485,40,122,.328,239,453,.528,63,85,.741,92,392,484,90,80,51,108,152,661,2007/2008
"Moore,Mikki",282,489,.577,0,2,.000,282,487,.579,134,182,.736,160,334,494,84,35,110,46,310,698,2007/2008
"Morris,Randolph",21,58,.362,0,0,,21,58,.362,14,29,.483,12,25,37,2,4,9,2,37,56,2007/2008
"Mourning,Alonzo",52,95,.547,0,0,,52,95,.547,45,76,.592,34,59,93,7,4,25,42,56,149,2007/2008
"Murphy,Troy",315,693,.455,94,236,.398,221,457,.484,192,241,.797,108,435,543,165,49,96,32,217,916,2007/2008
"Murray,Ronald",154,367,.420,20,63,.317,134,304,.441,68,98,.694,23,60,83,144,38,84,4,50,396,2007/2008
"Murray,Ronald",57,139,.410,6,27,.222,51,112,.455,22,37,.595,13,23,36,64,13,31,1,19,142,2007/2008
"Murray,Ronald",97,228,.425,14,36,.389,83,192,.432,46,61,.754,10,37,47,80,25,53,3,31,254,2007/2008
"Mutombo,Dikembe",43,80,.538,0,0,,43,80,.538,32,45,.711,68,131,199,5,11,17,48,55,118,2007/2008
"Nachbar,Boštjan",245,609,.402,94,262,.359,151,347,.435,154,196,.786,56,204,260,88,44,85,21,182,738,2007/2008
"Nájera,Eduardo",174,368,.473,53,147,.361,121,221,.548,63,89,.708,113,224,337,95,69,59,40,199,464,2007/2008
"Nash,Steve",485,962,.504,179,381,.470,306,581,.527,222,245,.906,28,254,282,898,53,295,5,113,1371,2007/2008
"Navarro,Juan Carlos",308,766,.402,156,432,.361,152,334,.455,124,146,.849,34,176,210,177,48,134,1,94,896,2007/2008
"Nelson,Jameer",283,603,.469,64,154,.416,219,449,.488,125,151,.828,28,215,243,383,63,141,4,167,755,2007/2008
"Nesterović,Rasho",257,467,.550,1,3,.333,256,464,.552,37,49,.755,130,212,342,82,20,60,52,132,552,2007/2008
"Newble,Ira",76,174,.437,16,49,.327,60,125,.480,20,26,.769,47,78,125,18,28,34,8,69,188,2007/2008
"Newble,Ira",71,158,.449,15,45,.333,56,113,.496,20,26,.769,41,73,114,14,27,31,7,64,177,2007/2008
"Newble,Ira",2,7,.286,0,2,.000,2,5,.400,0,0,,0,0,0,1,0,0,0,0,4,2007/2008
"Newble,Ira",3,9,.333,1,2,.500,2,7,.286,0,0,,6,5,11,3,1,3,1,5,7,2007/2008
"Nichols,Demetris",6,23,.261,3,13,.231,3,10,.300,0,0,,0,5,5,1,0,4,3,4,15,2007/2008
"Nichols,Demetris",1,8,.125,0,3,.000,1,5,.200,0,0,,0,1,1,0,0,2,0,0,2,2007/2008
"Nichols,Demetris",5,15,.333,3,10,.300,2,5,.400,0,0,,0,4,4,1,0,2,3,4,13,2007/2008
"Noah,Joakim",177,367,.482,0,1,.000,177,366,.484,134,194,.691,174,242,416,84,68,89,64,173,488,2007/2008
"Nocioni,Andrés",379,877,.432,126,346,.364,253,531,.476,196,243,.807,48,294,342,95,25,133,43,245,1080,2007/2008
"Novak,Steve",49,102,.480,34,71,.479,15,31,.484,3,4,.750,4,31,35,6,2,4,3,17,135,2007/2008
"Nowitzki,Dirk",630,1314,.479,79,220,.359,551,1094,.504,478,544,.879,95,564,659,266,51,160,71,198,1817,2007/2008
"O'Bryant,Patrick",16,29,.552,0,0,,16,29,.552,3,5,.600,10,19,29,4,4,7,9,27,35,2007/2008
"O'Neal,Jermaine",225,512,.439,0,5,.000,225,507,.444,121,163,.742,82,201,283,93,20,106,87,129,571,2007/2008
"O'Neal,Shaquille",331,558,.593,0,0,,331,558,.593,170,338,.503,166,388,554,93,32,181,88,228,832,2007/2008
"O'Neal,Shaquille",191,329,.581,0,0,,191,329,.581,88,178,.494,99,159,258,45,19,98,54,134,470,2007/2008
"O'Neal,Shaquille",140,229,.611,0,0,,140,229,.611,82,160,.513,67,229,296,48,13,83,34,94,362,2007/2008
"Oberto,Fabricio",180,296,.608,0,1,.000,180,295,.610,37,61,.607,153,277,430,95,37,51,20,203,397,2007/2008
"Odom,Lamar",417,795,.525,31,113,.274,386,682,.566,229,328,.698,197,622,819,273,75,156,72,222,1094,2007/2008
"Okafor,Emeka",460,860,.535,0,0,,460,860,.535,213,374,.570,255,621,876,70,62,164,138,241,1133,2007/2008
"Okur,Mehmet",374,841,.445,114,294,.388,260,547,.475,185,230,.804,132,424,556,145,55,104,29,236,1047,2007/2008
"Ollie,Kevin",29,69,.420,0,1,.000,29,68,.426,12,15,.800,4,15,19,38,10,5,0,28,70,2007/2008
"Outlaw,Bo",2,3,.667,0,0,,2,3,.667,0,0,,0,0,0,0,0,1,0,1,4,2007/2008
"Outlaw,Travis",417,964,.433,40,101,.396,377,863,.437,218,294,.741,96,280,376,106,59,107,63,173,1092,2007/2008
"Owens,Andre",40,107,.374,18,40,.450,22,67,.328,25,34,.735,13,34,47,47,13,24,3,37,123,2007/2008
"Pachulia,Zaza",107,245,.437,0,3,.000,107,242,.442,108,153,.706,89,159,248,36,24,69,13,140,322,2007/2008
"Pargo,Jannero",254,652,.390,65,186,.349,189,466,.406,71,81,.877,26,104,130,192,50,93,5,123,644,2007/2008
"Parker,Anthony",395,829,.476,133,304,.438,262,525,.499,102,125,.816,50,284,334,183,79,87,17,157,1025,2007/2008
"Parker,Smush",64,184,.348,18,78,.231,46,106,.434,19,28,.679,4,47,51,84,24,44,6,60,165,2007/2008
"Parker,Smush",17,54,.315,6,24,.250,11,30,.367,3,4,.750,2,17,19,15,5,8,3,13,43,2007/2008
"Parker,Smush",47,130,.362,12,54,.222,35,76,.461,16,24,.667,2,30,32,69,19,36,3,47,122,2007/2008
"Parker,Tony",515,1043,.494,17,66,.258,498,977,.510,248,347,.715,30,191,221,411,55,164,8,93,1295,2007/2008
"Patterson,Ruben",39,86,.453,0,2,.000,39,84,.464,24,43,.558,24,40,64,17,21,27,7,37,102,2007/2008
"Paul,Chris",630,1291,.488,92,249,.369,538,1042,.516,332,390,.851,62,259,321,925,217,201,4,185,1684,2007/2008
"Pavlović,Sasha",146,403,.362,34,114,.298,112,289,.388,53,77,.688,35,93,128,82,29,55,6,117,379,2007/2008
"Pecherov,Oleksiy",44,125,.352,17,60,.283,27,65,.415,20,31,.645,21,45,66,7,6,17,5,30,125,2007/2008
"Perkins,Kendrick",214,348,.615,0,1,.000,214,347,.617,114,183,.623,145,329,474,84,31,125,114,242,542,2007/2008
"Perović,Kosta",3,10,.300,0,0,,3,10,.300,4,6,.667,6,7,13,1,0,1,2,6,10,2007/2008
"Peterson,Morris",215,516,.417,113,287,.394,102,229,.445,65,85,.765,36,170,206,67,47,41,7,125,608,2007/2008
"Petro,Johan",184,439,.419,0,1,.000,184,438,.420,64,87,.736,98,272,370,32,35,73,42,173,432,2007/2008
"Piatkowski,Eric",12,33,.364,11,26,.423,1,7,.143,4,4,1.000,1,11,12,10,0,6,1,11,39,2007/2008
"Pierce,Paul",509,1098,.464,143,365,.392,366,733,.499,409,485,.843,53,358,411,363,101,221,36,200,1570,2007/2008
"Piétrus,Mickaël",170,387,.439,66,183,.361,104,204,.510,66,98,.673,67,175,242,49,66,48,43,200,472,2007/2008
"Pollard,Scot",12,23,.522,0,0,,12,23,.522,15,22,.682,14,23,37,3,3,5,6,43,39,2007/2008
"Posey,James",173,414,.418,106,279,.380,67,135,.496,93,115,.809,30,292,322,114,72,65,19,182,545,2007/2008
"Powe,Leon",154,269,.572,0,1,.000,154,268,.575,137,193,.710,95,132,227,15,15,43,16,127,445,2007/2008
"Powell,Josh",145,315,.460,0,3,.000,145,312,.465,63,87,.724,115,216,331,47,14,65,23,130,353,2007/2008
"Powell,Kasib",35,95,.368,8,33,.242,27,62,.435,6,9,.667,8,36,44,18,9,5,2,18,84,2007/2008
"Price,Ronnie",88,204,.431,26,75,.347,62,129,.481,26,38,.684,8,38,46,78,32,30,3,83,228,2007/2008
"Prince,Tayshaun",421,940,.448,53,146,.363,368,794,.463,185,241,.768,109,289,398,268,42,91,33,90,1080,2007/2008
"Pruitt,Gabe",14,39,.359,3,12,.250,11,27,.407,1,2,.500,1,7,8,13,5,5,0,10,32,2007/2008
"Przybilla,Joel",144,250,.576,0,1,.000,144,249,.578,83,122,.680,195,454,649,27,13,95,93,234,371,2007/2008
"Quinn,Chris",158,373,.424,64,159,.403,94,214,.439,85,98,.867,11,107,118,178,46,55,4,90,465,2007/2008
"Radmanović,Vladimir",198,437,.453,95,234,.406,103,203,.507,52,65,.800,56,159,215,123,46,73,12,147,543,2007/2008
"Randolph,Shavlik",4,14,.286,0,0,,4,14,.286,0,0,,9,2,11,3,1,2,3,5,8,2007/2008
"Randolph,Zach",486,1058,.459,22,80,.275,464,978,.474,223,289,.772,184,526,710,140,59,186,16,194,1217,2007/2008
"Ratliff,Theo",41,85,.482,0,1,.000,41,84,.488,29,43,.674,32,57,89,14,7,21,37,59,111,2007/2008
"Ratliff,Theo",23,45,.511,0,1,.000,23,44,.523,17,25,.680,13,26,39,7,3,12,19,30,63,2007/2008
"Ratliff,Theo",18,40,.450,0,0,,18,40,.450,12,18,.667,19,31,50,7,4,9,18,29,48,2007/2008
"Redd,Michael",550,1243,.442,130,359,.362,420,884,.475,402,490,.820,85,224,309,247,65,181,13,120,1632,2007/2008
"Redick,J.J.",48,108,.444,17,43,.395,31,65,.477,27,34,.794,1,22,23,16,4,15,0,29,140,2007/2008
"Richard,Chris",41,87,.471,0,0,,41,87,.471,16,27,.593,52,83,135,18,10,24,12,83,98,2007/2008
"Richardson,Jason",648,1468,.441,243,599,.406,405,869,.466,249,331,.752,80,361,441,258,116,166,57,241,1788,2007/2008
"Richardson,Jeremy",16,44,.364,7,19,.368,9,25,.360,2,2,1.000,1,8,9,2,3,6,0,13,41,2007/2008
"Richardson,Jeremy",0,6,.000,0,2,.000,0,4,.000,0,0,,0,1,1,1,0,1,0,2,0,2007/2008
"Richardson,Jeremy",3,7,.429,2,5,.400,1,2,.500,2,2,1.000,0,1,1,1,1,0,0,5,10,2007/2008
"Richardson,Jeremy",13,31,.419,5,12,.417,8,19,.421,0,0,,1,6,7,0,2,5,0,6,31,2007/2008
"Richardson,Quentin",199,555,.359,69,214,.322,130,341,.381,60,88,.682,56,259,315,116,44,69,15,153,527,2007/2008
"Ridnour,Luke",147,368,.399,21,71,.296,126,297,.424,78,91,.857,13,81,94,241,37,80,14,120,393,2007/2008
"Robinson,Nate",331,782,.423,97,292,.332,234,490,.478,154,196,.786,51,171,222,212,60,103,1,186,913,2007/2008
"Rodríguez,Sergio",69,196,.352,17,58,.293,52,138,.377,25,38,.658,13,45,58,123,24,53,0,57,180,2007/2008
"Rondo,Rajon",351,713,.492,5,19,.263,346,694,.499,107,175,.611,78,244,322,393,129,147,13,187,814,2007/2008
"Rose,Malik",66,180,.367,2,7,.286,64,173,.370,37,51,.725,31,72,103,28,16,40,7,80,171,2007/2008
"Ross,Quinton",131,335,.391,9,21,.429,122,314,.389,40,60,.667,54,118,172,88,43,29,33,132,311,2007/2008
"Roy,Brandon",531,1170,.454,73,215,.340,458,955,.480,281,373,.753,81,267,348,430,79,136,16,147,1416,2007/2008
"Ruffin,Michael",33,62,.532,0,0,,33,62,.532,25,63,.397,90,96,186,24,31,19,19,93,91,2007/2008
"Rush,Kareem",228,569,.401,102,262,.389,126,307,.410,30,42,.714,19,149,168,89,42,62,19,108,588,2007/2008
"Salmons,John",381,799,.477,39,120,.325,342,679,.504,214,260,.823,76,273,349,208,93,170,31,171,1015,2007/2008
"Samb,Cheikh",3,4,.750,0,0,,3,4,.750,1,2,.500,3,4,7,0,1,1,2,8,7,2007/2008
"Scalabrine,Brian",29,94,.309,15,46,.326,14,48,.292,15,20,.750,22,57,79,40,9,26,8,63,88,2007/2008
"Scola,Luis",345,670,.515,0,3,.000,345,667,.517,157,235,.668,174,351,525,106,60,105,19,235,847,2007/2008
"Sefolosha,Thabo",180,421,.428,29,88,.330,151,333,.453,75,104,.721,50,205,255,129,61,93,30,128,464,2007/2008
"Sene,Mouhamed",11,24,.458,0,0,,11,24,.458,8,17,.471,7,9,16,1,0,0,7,9,30,2007/2008
"Sessions,Ramon",51,117,.436,3,7,.429,48,110,.436,32,41,.780,8,50,58,127,17,36,3,26,137,2007/2008
"Simmons,Bobby",209,496,.421,60,171,.351,149,325,.458,53,70,.757,67,159,226,80,50,78,5,140,531,2007/2008
"Simmons,Cedric",4,14,.286,0,0,,4,14,.286,0,10,.000,6,12,18,0,2,6,5,8,8,2007/2008
"Simmons,Cedric",2,6,.333,0,0,,2,6,.333,0,8,.000,5,10,15,0,2,4,5,7,4,2007/2008
"Simmons,Cedric",2,8,.250,0,0,,2,8,.250,0,2,.000,1,2,3,0,0,2,0,1,4,2007/2008
"Sims,Courtney",0,1,.000,0,0,,0,1,.000,0,0,,1,1,2,1,0,0,0,2,0,2007/2008
"Skinner,Brian",92,198,.465,2,3,.667,90,195,.462,33,63,.524,63,175,238,15,21,39,77,112,219,2007/2008
"Smith,Craig",297,528,.563,0,9,.000,297,519,.572,133,200,.665,123,230,353,60,36,89,17,217,727,2007/2008
"Smith,J.R.",311,674,.461,157,390,.403,154,284,.542,128,178,.719,43,109,152,128,62,112,12,144,907,2007/2008
"Smith,Jason",141,310,.455,4,14,.286,137,296,.463,54,82,.659,77,153,230,20,22,48,50,142,340,2007/2008
"Smith,Joe",312,653,.478,0,3,.000,312,650,.480,154,204,.755,163,238,401,66,34,71,47,186,778,2007/2008
"Smith,Joe",225,483,.466,0,1,.000,225,482,.467,109,135,.807,108,157,265,47,25,49,31,113,559,2007/2008
"Smith,Joe",87,170,.512,0,2,.000,87,168,.518,45,69,.652,55,81,136,19,9,22,16,73,219,2007/2008
"Smith,Josh",518,1133,.457,25,99,.253,493,1034,.477,333,469,.710,161,506,667,272,123,245,227,269,1394,2007/2008
"Snow,Eric",6,38,.158,0,2,.000,6,36,.167,10,22,.455,4,16,20,42,10,10,4,30,22,2007/2008
"Snyder,Kirk",96,189,.508,5,23,.217,91,166,.548,64,88,.727,30,96,126,64,20,52,15,55,261,2007/2008
"Snyder,Kirk",13,28,.464,2,9,.222,11,19,.579,6,11,.545,5,7,12,8,1,4,1,6,34,2007/2008
"Snyder,Kirk",83,161,.516,3,14,.214,80,147,.544,58,77,.753,25,89,114,56,19,48,14,49,227,2007/2008
"Songaila,Darius",214,467,.458,0,2,.000,214,465,.460,67,73,.918,81,190,271,135,53,86,16,181,495,2007/2008
"Stackhouse,Jerry",213,526,.405,60,184,.326,153,342,.447,132,148,.892,33,100,133,145,28,86,10,82,618,2007/2008
"Stevenson,DeShawn",301,780,.386,158,413,.383,143,367,.390,157,197,.797,37,198,235,252,65,102,15,110,917,2007/2008
"Stojaković,Peja",451,1026,.440,231,524,.441,220,502,.438,130,140,.929,64,267,331,96,57,61,10,127,1263,2007/2008
"Storey,Awvee",39,89,.438,0,7,.000,39,82,.476,14,29,.483,31,23,54,16,7,10,1,41,92,2007/2008
"Stoudamire,Damon",120,337,.356,50,149,.336,70,188,.372,27,34,.794,20,98,118,165,30,80,2,76,317,2007/2008
"Stoudamire,Damon",77,194,.397,36,94,.383,41,100,.410,21,26,.808,14,57,71,112,19,50,0,46,211,2007/2008
"Stoudamire,Damon",43,143,.301,14,55,.255,29,88,.330,6,8,.750,6,41,47,53,11,30,2,30,106,2007/2008
"Stoudamire,Salim",65,180,.361,29,85,.341,36,95,.379,41,50,.820,4,20,24,28,7,21,5,34,200,2007/2008
"Stoudemire,Amar'e",714,1211,.590,5,31,.161,709,1180,.601,556,691,.805,178,541,719,118,64,174,163,294,1989,2007/2008
"Strawberry,D.J.",29,92,.315,6,25,.240,23,67,.343,9,19,.474,9,19,28,30,12,11,6,36,73,2007/2008
"Stuckey,Rodney",153,382,.401,3,16,.188,150,366,.410,127,156,.814,32,97,129,160,49,78,6,113,436,2007/2008
"Swift,Robert",6,17,.353,0,0,,6,17,.353,2,2,1.000,6,12,18,1,5,10,6,16,14,2007/2008
"Swift,Stromile",135,265,.509,0,2,.000,135,263,.513,73,109,.670,64,135,199,26,15,51,54,113,343,2007/2008
"Swift,Stromile",93,177,.525,0,2,.000,93,175,.531,52,81,.642,46,83,129,22,10,39,36,74,238,2007/2008
"Swift,Stromile",42,88,.477,0,0,,42,88,.477,21,28,.750,18,52,70,4,5,12,18,39,105,2007/2008
"Szczerbiak,Wally",311,722,.431,90,218,.413,221,504,.438,149,175,.851,34,183,217,104,23,76,12,103,861,2007/2008
"Szczerbiak,Wally",236,513,.460,71,166,.428,165,347,.476,113,134,.843,16,120,136,69,14,56,5,67,656,2007/2008
"Szczerbiak,Wally",75,209,.359,19,52,.365,56,157,.357,36,41,.878,18,63,81,35,9,20,7,36,205,2007/2008
"Telfair,Sebastian",223,556,.401,32,114,.281,191,442,.432,78,105,.743,16,119,135,355,59,111,11,171,556,2007/2008
"Terry,Jason",471,1008,.467,136,363,.375,335,645,.519,191,223,.857,30,178,208,264,88,92,18,170,1269,2007/2008
"Thomas,Billy",4,17,.235,4,16,.250,0,1,.000,2,2,1.000,0,2,2,0,1,4,0,4,14,2007/2008
"Thomas,Billy",0,3,.000,0,3,.000,0,0,,2,2,1.000,0,0,0,0,0,1,0,0,2,2007/2008
"Thomas,Billy",4,14,.286,4,13,.308,0,1,.000,0,0,,0,2,2,0,1,3,0,4,12,2007/2008
"Thomas,Kenny",16,38,.421,0,0,,16,38,.421,0,5,.000,18,43,61,13,6,21,1,38,32,2007/2008
"Thomas,Kurt",195,396,.492,0,1,.000,195,395,.494,53,80,.663,130,377,507,67,56,46,57,188,443,2007/2008
"Thomas,Kurt",139,271,.513,0,0,,139,271,.513,39,56,.696,94,275,369,53,35,28,43,131,317,2007/2008
"Thomas,Kurt",56,125,.448,0,1,.000,56,124,.452,14,24,.583,36,102,138,14,21,18,14,57,126,2007/2008
"Thomas,Tim",291,705,.413,83,271,.306,208,434,.479,115,153,.752,62,261,323,171,40,98,29,192,780,2007/2008
"Thomas,Tyrus",186,440,.423,1,6,.167,185,434,.426,129,174,.741,102,240,342,90,48,77,72,170,502,2007/2008
"Thornton,Al",374,871,.429,43,130,.331,331,741,.447,214,288,.743,98,260,358,98,46,128,43,195,1005,2007/2008
"Tinsley,Jamaal",176,463,.380,40,141,.284,136,322,.422,72,100,.720,24,117,141,326,66,130,10,97,464,2007/2008
"Tucker,Alando",8,22,.364,1,4,.250,7,18,.389,5,6,.833,4,4,8,0,0,0,1,2,22,2007/2008
"Turiaf,Ronny",188,397,.474,0,1,.000,188,396,.475,140,186,.753,95,211,306,128,28,72,108,199,516,2007/2008
"Türkoğlu,Hedo",556,1219,.456,166,415,.400,390,804,.485,324,391,.829,83,388,471,409,74,246,25,244,1602,2007/2008
"Udoka,Ime",159,375,.424,61,165,.370,98,210,.467,44,58,.759,36,192,228,63,56,58,17,127,423,2007/2008
"Udrih,Beno",328,708,.463,53,137,.387,275,571,.482,125,147,.850,34,183,217,282,56,148,10,138,834,2007/2008
"Varejão,Anderson",136,295,.461,0,2,.000,136,293,.464,49,82,.598,134,265,399,53,37,59,26,134,321,2007/2008
"Vaughn,Jacque",121,283,.428,3,10,.300,118,273,.432,61,80,.763,13,61,74,159,23,54,1,97,306,2007/2008
"Villanueva,Charlie",354,814,.435,55,185,.297,299,629,.475,123,157,.783,145,321,466,78,30,107,35,174,886,2007/2008
"Vinicius,Marcus",9,20,.450,5,12,.417,4,8,.500,5,11,.455,1,7,8,2,1,3,1,4,28,2007/2008
"Voskuhl,Jake",37,80,.463,0,0,,37,80,.463,24,29,.828,30,67,97,13,9,29,21,83,98,2007/2008
"Vujačić,Sasha",219,482,.454,118,270,.437,101,212,.476,76,91,.835,19,135,154,72,36,52,5,107,632,2007/2008
"Wade,Dwyane",439,937,.469,22,77,.286,417,860,.485,354,467,.758,45,169,214,354,87,224,37,137,1254,2007/2008
"Wafer,Von",17,61,.279,4,26,.154,13,35,.371,8,12,.667,1,18,19,7,2,13,3,7,46,2007/2008
"Wafer,Von",10,38,.263,1,15,.067,9,23,.391,6,8,.750,1,9,10,5,2,11,1,4,27,2007/2008
"Wafer,Von",7,23,.304,3,11,.273,4,12,.333,2,4,.500,0,9,9,2,0,2,2,3,19,2007/2008
"Walker,Antoine",136,375,.363,61,188,.324,75,187,.401,35,66,.530,56,112,168,45,33,46,8,80,368,2007/2008
"Wallace,Ben",138,352,.392,0,4,.000,138,348,.397,72,169,.426,234,370,604,105,88,67,117,121,348,2007/2008
"Wallace,Ben",101,271,.373,0,4,.000,101,267,.378,53,125,.424,175,266,441,92,69,49,80,86,255,2007/2008
"Wallace,Ben",37,81,.457,0,0,,37,81,.457,19,44,.432,59,104,163,13,19,18,37,35,93,2007/2008
"Wallace,Gerald",408,908,.449,71,221,.321,337,687,.491,313,428,.731,58,315,373,216,131,180,58,189,1200,2007/2008
"Wallace,Rasheed",376,870,.432,112,315,.356,264,555,.476,115,150,.767,84,427,511,137,91,86,129,213,979,2007/2008
"Walton,Luke",215,478,.450,28,84,.333,187,394,.475,77,109,.706,85,206,291,218,60,100,18,133,535,2007/2008
"Warrick,Hakim",328,653,.502,13,48,.271,315,605,.521,183,260,.704,123,233,356,53,36,85,28,156,852,2007/2008
"Washington,Darius",21,48,.438,4,12,.333,17,36,.472,7,13,.538,4,16,20,15,5,14,0,16,53,2007/2008
"Watkins,Darryl",5,15,.333,0,0,,5,15,.333,2,5,.400,5,7,12,0,2,7,2,8,12,2007/2008
"Watson,C.J.",43,101,.426,9,26,.346,34,75,.453,23,29,.793,13,19,32,35,15,18,0,19,118,2007/2008
"Watson,Earl",339,747,.454,49,132,.371,290,615,.472,111,145,.766,43,182,225,531,69,175,11,158,838,2007/2008
"Webber,Chris",15,31,.484,0,0,,15,31,.484,5,12,.417,2,30,32,18,4,11,6,17,35,2007/2008
"Webster,Martell",277,656,.422,123,317,.388,154,339,.454,122,166,.735,54,242,296,90,42,83,28,159,799,2007/2008
"Wells,Bonzi",252,569,.443,12,50,.240,240,519,.462,146,227,.643,84,247,331,97,75,103,32,157,662,2007/2008
"Wells,Bonzi",175,412,.425,8,38,.211,167,374,.447,111,174,.638,63,197,260,80,51,76,24,113,469,2007/2008
"Wells,Bonzi",77,157,.490,4,12,.333,73,145,.503,35,53,.660,21,50,71,17,24,27,8,44,193,2007/2008
"West,David",629,1305,.482,6,25,.240,623,1280,.487,300,353,.850,180,495,675,177,62,165,99,208,1564,2007/2008
"West,Delonte",196,475,.413,48,135,.356,148,340,.435,67,91,.736,31,162,193,229,59,117,29,103,507,2007/2008
"West,Delonte",97,250,.388,19,56,.339,78,194,.402,26,39,.667,13,83,96,113,30,66,10,44,239,2007/2008
"West,Delonte",99,225,.440,29,79,.367,70,146,.479,41,52,.788,18,79,97,116,29,51,19,59,268,2007/2008
"West,Mario",21,49,.429,0,4,.000,21,45,.467,17,26,.654,26,22,48,13,12,9,4,61,59,2007/2008
"Wilcox,Chris",334,638,.524,0,3,.000,334,635,.526,160,248,.645,126,307,433,74,46,103,36,174,828,2007/2008
"Wilkins,Damien",271,673,.403,50,155,.323,221,518,.427,106,144,.736,72,173,245,150,62,89,19,128,698,2007/2008
"Wilks,Mike",17,36,.472,3,8,.375,14,28,.500,4,4,1.000,5,14,19,14,9,9,0,13,41,2007/2008
"Wilks,Mike",10,23,.435,2,5,.400,8,18,.444,2,2,1.000,4,8,12,6,5,5,0,9,24,2007/2008
"Wilks,Mike",2,4,.500,1,2,.500,1,2,.500,0,0,,1,5,6,3,3,1,0,2,5,2007/2008
"Wilks,Mike",5,9,.556,0,1,.000,5,8,.625,2,2,1.000,0,1,1,5,1,3,0,2,12,2007/2008
"Williams,Aaron",27,55,.491,0,0,,27,55,.491,14,18,.778,15,46,61,9,12,13,15,44,68,2007/2008
"Williams,Deron",566,1117,.507,83,210,.395,483,907,.533,330,411,.803,34,209,243,862,90,279,23,200,1545,2007/2008
"Williams,Jason",211,550,.384,97,275,.353,114,275,.415,69,80,.863,12,118,130,307,83,91,5,93,588,2007/2008
"Williams,Justin",13,29,.448,0,0,,13,29,.448,8,26,.308,20,29,49,0,5,4,5,17,34,2007/2008
"Williams,Justin",12,26,.462,0,0,,12,26,.462,7,22,.318,19,29,48,0,5,3,5,14,31,2007/2008
"Williams,Justin",1,3,.333,0,0,,1,3,.333,1,4,.250,1,0,1,0,0,1,0,3,3,2007/2008
"Williams,Lou",319,752,.424,55,153,.359,264,599,.441,227,290,.783,41,126,167,253,81,125,13,130,920,2007/2008
"Williams,Marcus",111,293,.379,54,142,.380,57,151,.377,37,47,.787,14,87,101,140,25,75,3,52,313,2007/2008
"Williams,Marcus",5,20,.250,0,0,,5,20,.250,0,0,,4,8,12,3,1,0,1,3,10,2007/2008
"Williams,Marcus",0,1,.000,0,0,,0,1,.000,0,0,,0,0,0,0,0,0,1,0,0,2007/2008
"Williams,Marcus",5,19,.263,0,0,,5,19,.263,0,0,,4,8,12,3,1,0,0,3,10,2007/2008
"Williams,Marvin",424,918,.462,1,10,.100,423,908,.466,336,409,.822,119,338,457,137,81,127,33,225,1185,2007/2008
"Williams,Mo",441,919,.480,89,231,.385,352,688,.512,166,194,.856,37,193,230,419,78,182,10,188,1137,2007/2008
"Williams,Sean",164,305,.538,0,0,,164,305,.538,81,133,.609,115,207,322,28,28,70,106,193,409,2007/2008
"Williams,Shawne",159,372,.427,43,137,.314,116,235,.494,76,106,.717,54,122,176,59,26,58,26,132,437,2007/2008
"Williams,Shelden",92,212,.434,0,2,.000,92,210,.438,71,105,.676,68,137,205,19,22,35,21,110,255,2007/2008
"Williams,Shelden",37,100,.370,0,1,.000,37,99,.374,35,51,.686,34,73,107,11,13,14,11,60,109,2007/2008
"Williams,Shelden",55,112,.491,0,1,.000,55,111,.495,36,54,.667,34,64,98,8,9,21,10,50,146,2007/2008
"Woods,Loren",3,5,.600,0,0,,3,5,.600,0,0,,0,1,1,2,0,0,0,2,6,2007/2008
"World Peace,Metta",436,962,.453,84,221,.380,352,741,.475,212,295,.719,101,227,328,199,133,148,38,159,1168,2007/2008
"Wright,Antoine",136,329,.413,32,110,.291,104,219,.475,46,67,.687,40,107,147,80,28,50,21,127,350,2007/2008
"Wright,Antoine",115,287,.401,27,101,.267,88,186,.473,41,58,.707,35,90,125,67,26,39,17,105,298,2007/2008
"Wright,Antoine",21,42,.500,5,9,.556,16,33,.485,5,9,.556,5,17,22,13,2,11,4,22,52,2007/2008
"Wright,Brandan",62,112,.554,0,0,,62,112,.554,27,40,.675,38,61,99,9,6,13,22,36,151,2007/2008
"Wright,Dorell",143,293,.488,4,11,.364,139,282,.493,57,69,.826,48,172,220,60,29,29,41,79,347,2007/2008
"Wright,Julian",90,169,.533,10,24,.417,80,145,.552,33,52,.635,33,84,117,40,29,34,12,43,223,2007/2008
"Wright,Lorenzen",6,21,.286,0,0,,6,21,.286,3,6,.500,8,30,38,4,3,4,3,31,15,2007/2008
"Wright,Lorenzen",5,17,.294,0,0,,5,17,.294,3,6,.500,7,30,37,3,3,2,3,26,13,2007/2008
"Wright,Lorenzen",1,4,.250,0,0,,1,4,.250,0,0,,1,0,1,1,0,2,0,5,2,2007/2008
"Young,Nick",210,478,.439,40,100,.400,170,378,.450,101,124,.815,23,92,115,63,35,94,7,130,561,2007/2008
"Young,Thaddeus",264,490,.539,6,19,.316,258,471,.548,76,103,.738,120,192,312,58,73,64,8,126,610,2007/2008
"Acker,Alex",30,76,.395,7,20,.350,23,56,.411,5,10,.500,8,16,24,12,5,7,4,9,72,2008/2009
"Acker,Alex",4,11,.364,0,4,.000,4,7,.571,1,2,.500,0,2,2,1,2,0,1,0,9,2008/2009
"Acker,Alex",26,65,.400,7,16,.438,19,49,.388,4,8,.500,8,14,22,11,3,7,3,9,63,2008/2009
"Adams,Hassan",4,13,.308,0,0,,4,13,.308,3,6,.500,1,6,7,1,1,4,1,4,11,2008/2009
"Afflalo,Arron",131,300,.437,43,107,.402,88,193,.456,58,71,.817,30,104,134,44,28,43,13,144,363,2008/2009
"Ager,Maurice",15,43,.349,0,6,.000,15,37,.405,4,8,.500,3,7,10,3,1,4,2,17,34,2008/2009
"Ahearn,Blake",2,6,.333,2,4,.500,0,2,.000,2,2,1.000,0,1,1,2,1,1,0,3,8,2008/2009
"Ajinça,Alexis",25,69,.362,0,2,.000,25,67,.373,20,28,.714,9,21,30,3,7,12,6,34,70,2008/2009
"Aldridge,LaMarcus",601,1243,.484,7,28,.250,594,1215,.489,261,334,.781,234,371,605,157,77,121,77,207,1470,2008/2009
"Alexander,Joe",102,245,.416,16,46,.348,86,199,.432,58,83,.699,44,71,115,42,15,52,29,107,278,2008/2009
"Allen,Malik",73,170,.429,0,1,.000,73,169,.432,10,21,.476,35,68,103,35,7,20,12,89,156,2008/2009
"Allen,Ray",499,1040,.480,199,486,.409,300,554,.542,237,249,.952,66,212,278,218,69,134,13,157,1434,2008/2009
"Allen,Tony",137,284,.482,6,27,.222,131,257,.510,79,109,.725,22,82,104,66,54,77,23,98,359,2008/2009
"Almond,Morris",33,81,.407,5,17,.294,28,64,.438,21,26,.808,9,27,36,7,4,16,4,31,92,2008/2009
"Alston,Rafer",316,820,.385,112,331,.338,204,489,.417,156,208,.750,33,194,227,406,108,140,10,135,900,2008/2009
"Alston,Rafer",193,522,.370,80,230,.348,113,292,.387,86,109,.789,25,119,144,258,57,88,7,72,552,2008/2009
"Alston,Rafer",123,298,.413,32,101,.317,91,197,.462,70,99,.707,8,75,83,148,51,52,3,63,348,2008/2009
"Amundson,Lou",134,250,.536,0,1,.000,134,249,.538,53,120,.442,128,142,270,28,32,56,65,154,321,2008/2009
"Andersen,Chris",160,292,.548,2,10,.200,158,282,.560,130,181,.718,163,279,442,31,41,69,175,174,452,2008/2009
"Anderson,Ryan",160,407,.393,69,189,.365,91,218,.417,98,116,.845,104,207,311,52,44,63,20,157,487,2008/2009
"Anthony,Carmelo",535,1207,.443,63,170,.371,472,1037,.455,371,468,.793,106,344,450,222,75,199,24,195,1504,2008/2009
"Anthony,Joel",57,118,.483,0,0,,57,118,.483,30,46,.652,89,108,197,27,20,41,93,139,144,2008/2009
"Arenas,Gilbert",6,23,.261,2,7,.286,4,16,.250,12,16,.750,1,8,9,20,0,1,1,4,26,2008/2009
"Ariza,Trevor",274,596,.460,61,191,.319,213,405,.526,120,169,.710,111,241,352,145,137,87,24,166,729,2008/2009
"Armstrong,Hilton",138,246,.561,0,2,.000,138,244,.566,62,98,.633,81,114,195,29,26,80,45,181,338,2008/2009
"Arthur,Darrell",191,436,.438,0,2,.000,191,434,.440,40,60,.667,108,238,346,43,52,47,52,206,422,2008/2009
"Atkins,Chucky",34,113,.301,15,57,.263,19,56,.339,15,16,.938,5,19,24,59,10,23,2,27,98,2008/2009
"Atkins,Chucky",9,27,.333,5,17,.294,4,10,.400,4,4,1.000,0,6,6,28,2,10,1,5,27,2008/2009
"Atkins,Chucky",25,86,.291,10,40,.250,15,46,.326,11,12,.917,5,13,18,31,8,13,1,22,71,2008/2009
"Augustin,D.J.",267,621,.430,108,246,.439,159,375,.424,208,233,.893,17,116,133,250,42,119,2,140,850,2008/2009
"Azubuike,Kelenna",392,845,.464,94,210,.448,298,635,.469,185,229,.808,112,258,370,117,57,95,50,183,1063,2008/2009
"Balkman,Renaldo",110,197,.558,2,7,.286,108,190,.568,42,65,.646,86,117,203,34,47,35,23,98,264,2008/2009
"Banks,Marcus",21,57,.368,3,19,.158,18,38,.474,11,18,.611,1,17,18,28,11,14,2,26,56,2008/2009
"Banks,Marcus",15,39,.385,2,14,.143,13,25,.520,10,15,.667,0,15,15,22,10,11,2,21,42,2008/2009
"Banks,Marcus",6,18,.333,1,5,.200,5,13,.385,1,3,.333,1,2,3,6,1,3,0,5,14,2008/2009
"Barbosa,Leandro",366,759,.482,90,240,.375,276,519,.532,171,194,.881,34,147,181,162,82,93,7,115,993,2008/2009
"Barea,J.J.",246,557,.442,55,154,.357,191,403,.474,70,93,.753,36,141,177,269,37,105,5,121,617,2008/2009
"Bargnani,Andrea",431,958,.450,119,291,.409,312,667,.468,221,266,.831,70,346,416,94,34,135,97,242,1202,2008/2009
"Barnes,Matt",285,674,.423,117,341,.343,168,333,.505,101,136,.743,79,342,421,212,52,130,26,209,788,2008/2009
"Barry,Brent",70,172,.407,49,131,.374,21,41,.512,19,20,.950,17,77,94,78,24,48,3,45,208,2008/2009
"Bass,Brandon",252,508,.496,0,6,.000,252,502,.502,182,210,.867,129,238,367,43,27,86,55,140,686,2008/2009
"Baston,Maceo",25,46,.543,0,1,.000,25,45,.556,17,27,.630,22,30,52,7,6,12,10,39,67,2008/2009
"Battie,Tony",158,323,.489,2,9,.222,156,314,.497,54,82,.659,92,186,278,31,26,46,25,112,372,2008/2009
"Battier,Shane",145,354,.410,91,237,.384,54,117,.462,55,67,.821,52,233,285,137,48,49,54,114,436,2008/2009
"Batum,Nicolas",161,361,.446,62,168,.369,99,193,.513,42,52,.808,84,136,220,74,50,50,40,139,426,2008/2009
"Bayless,Jerryd",69,189,.365,7,27,.259,62,162,.383,83,103,.806,8,49,57,78,16,56,2,81,228,2008/2009
"Beasley,Michael",452,957,.472,33,81,.407,419,876,.478,186,241,.772,110,329,439,83,41,121,37,184,1123,2008/2009
"Belinelli,Marco",140,317,.442,52,131,.397,88,186,.473,40,52,.769,10,61,71,88,36,59,1,73,372,2008/2009
"Bell,Charlie",217,524,.414,87,240,.363,130,284,.458,66,80,.825,32,102,134,151,50,76,7,138,587,2008/2009
"Bell,Raja",299,684,.437,114,271,.421,185,413,.448,87,102,.853,41,202,243,142,50,86,8,166,799,2008/2009
"Bell,Raja",76,177,.429,44,94,.468,32,83,.386,16,21,.762,8,56,64,29,13,18,2,57,212,2008/2009
"Bell,Raja",223,507,.440,70,177,.395,153,330,.464,71,81,.877,33,146,179,113,37,68,6,109,587,2008/2009
"Bibby,Mike",437,1005,.435,167,428,.390,270,577,.468,135,171,.789,38,240,278,392,98,128,11,145,1176,2008/2009
"Biedriņš,Andris",308,533,.578,0,1,.000,308,532,.579,119,216,.551,223,470,693,121,63,110,96,236,735,2008/2009
"Billups,Chauncey",410,980,.418,162,397,.408,248,583,.425,418,458,.913,32,207,239,506,93,177,18,161,1400,2008/2009
"Billups,Chauncey",7,21,.333,2,7,.286,5,14,.357,9,10,.900,1,9,10,15,3,4,1,3,25,2008/2009
"Billups,Chauncey",403,959,.420,160,390,.410,243,569,.427,409,448,.913,31,198,229,491,90,173,17,158,1375,2008/2009
"Blake,Steve",277,647,.428,140,328,.427,137,319,.429,63,75,.840,28,145,173,348,69,108,4,126,757,2008/2009
"Blatche,Andray",297,630,.471,5,21,.238,292,609,.479,114,162,.704,126,252,378,118,53,117,74,211,713,2008/2009
"Blount,Mark",30,78,.385,11,27,.407,19,51,.373,8,13,.615,10,31,41,4,1,14,7,17,79,2008/2009
"Bogans,Keith",119,324,.367,74,218,.339,45,106,.425,52,57,.912,31,171,202,64,43,41,4,105,364,2008/2009
"Bogans,Keith",63,175,.360,42,126,.333,21,49,.429,21,24,.875,15,96,111,31,23,19,2,61,189,2008/2009
"Bogans,Keith",56,149,.376,32,92,.348,24,57,.421,31,33,.939,16,75,91,33,20,22,2,44,175,2008/2009
"Bogut,Andrew",183,317,.577,0,0,,183,317,.577,56,98,.571,117,252,369,72,23,86,37,130,422,2008/2009
"Bonner,Matt",266,536,.496,118,268,.440,148,268,.552,17,23,.739,97,289,386,82,47,37,26,190,667,2008/2009
"Boone,Josh",113,214,.528,0,0,,113,214,.528,32,85,.376,104,154,258,31,22,31,48,106,258,2008/2009
"Booth,Calvin",5,10,.500,0,0,,5,10,.500,6,8,.750,5,6,11,0,1,1,2,10,16,2008/2009
"Booth,Calvin",0,0,,0,0,,0,0,,0,0,,1,0,1,0,0,0,0,0,0,2008/2009
"Booth,Calvin",5,10,.500,0,0,,5,10,.500,6,8,.750,4,6,10,0,1,1,2,10,16,2008/2009
"Boozer,Carlos",251,512,.490,0,0,,251,512,.490,97,139,.698,111,274,385,79,39,79,7,132,599,2008/2009
"Bosh,Chris",615,1263,.487,12,49,.245,603,1214,.497,504,617,.817,215,556,771,191,67,174,77,189,1746,2008/2009
"Bowen,Bruce",79,187,.422,42,98,.429,37,89,.416,14,26,.538,16,129,145,40,36,25,13,123,214,2008/2009
"Bowen,Ryan",22,38,.579,0,0,,22,38,.579,3,5,.600,10,14,24,9,14,5,5,37,47,2008/2009
"Brand,Elton",163,365,.447,0,0,,163,365,.447,73,108,.676,77,177,254,37,17,68,45,78,399,2008/2009
"Brewer,Corey",37,90,.411,5,12,.417,32,78,.410,14,19,.737,18,31,49,25,15,13,3,37,93,2008/2009
"Brewer,Ronnie",421,828,.508,22,85,.259,399,743,.537,247,352,.702,101,199,300,179,138,110,30,128,1111,2008/2009
"Brooks,Aaron",316,783,.404,113,309,.366,203,474,.428,149,172,.866,33,124,157,238,46,125,8,152,894,2008/2009
"Brown,Andre",1,7,.143,0,0,,1,7,.143,2,2,1.000,7,5,12,1,1,5,0,9,4,2008/2009
"Brown,Bobby",141,360,.392,45,130,.346,96,230,.417,34,43,.791,14,38,52,117,21,63,3,95,361,2008/2009
"Brown,Bobby",94,247,.381,31,94,.330,63,153,.412,26,34,.765,8,28,36,87,15,47,1,74,245,2008/2009
"Brown,Bobby",47,113,.416,14,36,.389,33,77,.429,8,9,.889,6,10,16,30,6,16,2,21,116,2008/2009
"Brown,Dee",18,49,.367,7,24,.292,11,25,.440,3,5,.600,7,22,29,36,10,17,0,28,46,2008/2009
"Brown,Dee",17,44,.386,6,20,.300,11,24,.458,1,3,.333,7,21,28,33,10,14,0,22,41,2008/2009
"Brown,Dee",1,5,.200,1,4,.250,0,1,.000,2,2,1.000,0,1,1,3,0,3,0,6,5,2008/2009
"Brown,Devin",111,313,.355,28,97,.289,83,216,.384,78,100,.780,31,88,119,54,32,54,5,81,328,2008/2009
"Brown,Kwame",90,169,.533,0,0,,90,169,.533,63,122,.516,91,199,290,32,24,50,24,138,243,2008/2009
"Brown,Shannon",78,165,.473,14,37,.378,64,128,.500,32,39,.821,11,33,44,38,22,38,7,42,202,2008/2009
"Brown,Shannon",56,123,.455,8,28,.286,48,95,.505,24,30,.800,8,16,24,28,18,29,5,33,144,2008/2009
"Brown,Shannon",22,42,.524,6,9,.667,16,33,.485,8,9,.889,3,17,20,10,4,9,2,9,58,2008/2009
"Bryant,Kobe",800,1712,.467,118,336,.351,682,1376,.496,483,564,.856,90,339,429,399,120,210,37,189,2201,2008/2009
"Buckner,Greg",61,159,.384,13,51,.255,48,108,.444,20,25,.800,32,98,130,57,29,38,8,108,155,2008/2009
"Butler,Caron",491,1085,.453,65,210,.310,426,875,.487,345,402,.858,118,296,414,290,106,210,20,165,1392,2008/2009
"Butler,Rasual",348,803,.433,140,359,.390,208,444,.468,86,110,.782,49,222,271,75,51,59,61,159,922,2008/2009
"Bynum,Andrew",281,502,.560,0,0,,281,502,.560,152,215,.707,137,261,398,71,18,85,90,157,714,2008/2009
"Bynum,Will",156,342,.456,3,19,.158,153,323,.474,95,119,.798,19,56,75,157,34,76,2,85,410,2008/2009
"Calderón,José",320,644,.497,82,202,.406,238,442,.538,151,154,.981,16,178,194,607,74,143,7,114,873,2008/2009
"Camby,Marcus",254,496,.512,1,4,.250,253,492,.514,132,182,.725,161,529,690,127,51,93,132,129,641,2008/2009
"Cardinal,Brian",65,169,.385,30,92,.326,35,77,.455,30,35,.857,39,103,142,76,37,48,13,135,190,2008/2009
"Carney,Rodney",176,423,.416,79,226,.350,97,197,.492,50,66,.758,36,90,126,26,45,43,29,94,481,2008/2009
"Carroll,Matt",65,171,.380,13,53,.245,52,118,.441,21,25,.840,7,62,69,27,21,33,6,67,164,2008/2009
"Carroll,Matt",56,138,.406,12,45,.267,44,93,.473,15,19,.789,5,50,55,24,18,26,5,53,139,2008/2009
"Carroll,Matt",9,33,.273,1,8,.125,8,25,.320,6,6,1.000,2,12,14,3,3,7,1,14,25,2008/2009
"Carter,Anthony",167,386,.433,21,88,.239,146,298,.490,57,78,.731,40,165,205,364,96,155,13,142,412,2008/2009
"Carter,Vince",588,1345,.437,151,392,.385,437,953,.459,335,410,.817,74,336,410,376,82,166,38,234,1662,2008/2009
"Chalmers,Mario",278,662,.420,114,311,.367,164,351,.467,148,193,.767,37,191,228,403,160,165,8,240,818,2008/2009
"Chandler,Tyson",160,283,.565,0,0,,160,283,.565,77,133,.579,163,230,393,22,15,70,56,144,397,2008/2009
"Chandler,Wilson",455,1054,.432,103,314,.328,352,740,.476,171,215,.795,91,354,445,170,71,139,75,250,1184,2008/2009
"Claxton,Speedy",2,7,.286,0,0,,2,7,.286,1,2,.500,0,0,0,3,0,0,0,1,5,2008/2009
"Collins,Jarron",16,35,.457,0,0,,16,35,.457,8,11,.727,20,17,37,7,2,9,1,35,40,2008/2009
"Collins,Jason",22,70,.314,0,0,,22,70,.314,13,28,.464,28,42,70,11,9,12,13,73,57,2008/2009
"Collins,Mardy",105,247,.425,13,31,.419,92,216,.426,28,46,.609,31,76,107,111,31,58,10,80,251,2008/2009
"Collins,Mardy",8,23,.348,0,3,.000,8,20,.400,4,9,.444,2,6,8,10,2,5,0,7,20,2008/2009
"Collins,Mardy",97,224,.433,13,28,.464,84,196,.429,24,37,.649,29,70,99,101,29,53,10,73,231,2008/2009
"Collison,Nick",243,428,.568,0,2,.000,243,426,.570,98,136,.721,181,308,489,66,51,73,50,239,584,2008/2009
"Conley,Mike",323,730,.442,88,217,.406,235,513,.458,161,197,.817,25,251,276,354,90,143,8,146,895,2008/2009
"Cook,Brian",28,76,.368,13,30,.433,15,46,.326,5,6,.833,7,25,32,5,3,13,3,26,74,2008/2009
"Cook,Brian",23,60,.383,11,25,.440,12,35,.343,5,6,.833,6,21,27,4,3,11,0,23,62,2008/2009
"Cook,Brian",5,16,.313,2,5,.400,3,11,.273,0,0,,1,4,5,1,0,2,3,3,12,2008/2009
"Cook,Daequan",242,645,.375,153,395,.387,89,250,.356,49,56,.875,19,170,189,71,39,42,10,125,686,2008/2009
"Crawford,Jamal",419,1022,.410,142,394,.360,277,628,.441,300,344,.872,23,170,193,288,57,148,13,92,1280,2008/2009
"Crawford,Jamal",73,169,.432,35,77,.455,38,92,.413,35,46,.761,2,15,17,48,9,26,0,13,216,2008/2009
"Crawford,Jamal",346,853,.406,107,317,.338,239,536,.446,265,298,.889,21,155,176,240,48,122,13,79,1064,2008/2009
"Crawford,Joe",3,10,.300,1,4,.250,2,6,.333,2,2,1.000,1,3,4,1,1,0,0,2,9,2008/2009
"Crittenton,Javaris",131,285,.460,2,15,.133,129,270,.478,53,92,.576,57,109,166,150,40,82,6,101,317,2008/2009
"Crittenton,Javaris",7,15,.467,0,1,.000,7,14,.500,5,11,.455,4,2,6,5,1,3,0,5,19,2008/2009
"Crittenton,Javaris",124,270,.459,2,14,.143,122,256,.477,48,81,.593,53,107,160,145,39,79,6,96,298,2008/2009
"Croshere,Austin",14,39,.359,5,15,.333,9,24,.375,7,12,.583,11,23,34,9,1,6,1,5,40,2008/2009
"Croshere,Austin",12,30,.400,5,11,.455,7,19,.368,7,11,.636,7,17,24,6,1,4,1,4,36,2008/2009
"Croshere,Austin",2,9,.222,0,4,.000,2,5,.400,0,1,.000,4,6,10,3,0,2,0,1,4,2008/2009
"Curry,Eddy",2,2,1.000,0,0,,2,2,1.000,1,3,.333,0,4,4,0,0,2,0,5,5,2008/2009
"Dalembert,Samuel",216,434,.498,0,2,.000,216,432,.500,91,124,.734,214,487,701,18,33,117,146,248,523,2008/2009
"Dampier,Erick",182,280,.650,0,0,,182,280,.650,90,141,.638,216,349,565,77,24,74,95,191,454,2008/2009
"Daniels,Antonio",99,236,.419,22,60,.367,77,176,.438,80,100,.800,5,72,77,177,26,62,1,55,300,2008/2009
"Daniels,Antonio",18,45,.400,5,11,.455,13,34,.382,25,33,.758,0,22,22,47,7,13,0,14,66,2008/2009
"Daniels,Antonio",81,191,.424,17,49,.347,64,142,.451,55,67,.821,5,50,55,130,19,49,1,41,234,2008/2009
"Daniels,Marquis",311,689,.451,18,90,.200,293,599,.489,93,129,.721,80,168,248,114,62,94,26,120,733,2008/2009
"Davidson,Jermareo",17,35,.486,0,0,,17,35,.486,8,17,.471,10,24,34,1,2,5,3,12,42,2008/2009
"Davis,Baron",355,959,.370,99,328,.302,256,631,.406,159,210,.757,46,192,238,501,108,193,35,193,968,2008/2009
"Davis,Glen",199,450,.442,2,5,.400,197,445,.443,130,178,.730,121,180,301,69,53,71,19,230,530,2008/2009
"Davis,Paul",40,98,.408,0,1,.000,40,97,.412,27,34,.794,28,39,67,12,10,13,3,44,107,2008/2009
"Davis,Ricky",83,245,.339,35,111,.315,48,134,.358,31,36,.861,9,51,60,82,19,39,5,63,232,2008/2009
"Deng,Luol",265,591,.448,8,20,.400,257,571,.450,152,191,.796,80,215,295,94,60,72,25,85,690,2008/2009
"Diaw,Boris",448,884,.507,75,181,.414,373,703,.531,101,147,.687,118,314,432,333,61,215,53,202,1072,2008/2009
"Diaw,Boris",80,141,.567,5,14,.357,75,127,.591,18,26,.692,24,60,84,46,11,37,9,39,183,2008/2009
"Diaw,Boris",368,743,.495,70,167,.419,298,576,.517,83,121,.686,94,254,348,287,50,178,44,163,889,2008/2009
"Diawara,Yakhouba",76,217,.350,51,163,.313,25,54,.463,10,19,.526,26,56,82,27,13,16,6,75,213,2008/2009
"Diener,Travis",74,179,.413,46,118,.390,28,61,.459,12,15,.800,6,80,86,122,26,21,5,42,206,2008/2009
"Diogu,Ike",39,74,.527,1,2,.500,38,72,.528,40,53,.755,26,30,56,3,3,12,3,23,119,2008/2009
"Diogu,Ike",6,19,.316,0,0,,6,19,.316,15,20,.750,12,5,17,0,1,6,2,9,27,2008/2009
"Diogu,Ike",33,55,.600,1,2,.500,32,53,.604,25,33,.758,14,25,39,3,2,6,1,14,92,2008/2009
"Diop,DeSagana",74,171,.433,0,0,,74,171,.433,22,66,.333,114,159,273,32,29,39,56,128,170,2008/2009
"Diop,DeSagana",22,58,.379,0,0,,22,58,.379,12,29,.414,45,73,118,13,12,11,25,55,56,2008/2009
"Diop,DeSagana",52,113,.460,0,0,,52,113,.460,10,37,.270,69,86,155,19,17,28,31,73,114,2008/2009
"Dixon,Juan",101,256,.395,25,75,.333,76,181,.420,34,39,.872,8,59,67,118,35,70,6,74,261,2008/2009
"Dooling,Keyon",261,598,.436,99,235,.421,162,363,.446,127,154,.825,24,131,155,270,71,105,8,135,748,2008/2009
"Dorsey,Joey",1,2,.500,0,0,,1,2,.500,0,0,,0,1,1,1,0,0,0,0,2,2008/2009
"Douby,Quincy",42,110,.382,14,46,.304,28,64,.438,17,19,.895,6,26,32,25,5,13,5,27,115,2008/2009
"Douby,Quincy",30,88,.341,10,37,.270,20,51,.392,14,15,.933,3,22,25,13,2,6,5,23,84,2008/2009
"Douby,Quincy",12,22,.545,4,9,.444,8,13,.615,3,4,.750,3,4,7,12,3,7,0,4,31,2008/2009
"Douglas-Roberts,Chris",81,176,.460,3,12,.250,78,164,.476,51,62,.823,14,36,50,52,12,31,7,34,216,2008/2009
"Dragić,Goran",88,224,.393,20,54,.370,68,170,.400,50,65,.769,33,70,103,111,29,73,3,87,246,2008/2009
"Dudley,Jared",136,285,.477,29,74,.392,107,211,.507,71,105,.676,82,123,205,56,57,43,8,105,372,2008/2009
"Dudley,Jared",45,96,.469,3,8,.375,42,88,.477,15,24,.625,25,34,59,19,18,10,2,40,108,2008/2009
"Dudley,Jared",91,189,.481,26,66,.394,65,123,.528,56,81,.691,57,89,146,37,39,33,6,65,264,2008/2009
"Duhon,Chris",287,681,.421,127,325,.391,160,356,.449,179,209,.856,45,201,246,566,72,221,7,126,880,2008/2009
"Duncan,Tim",558,1107,.504,0,2,.000,558,1105,.505,334,483,.692,201,599,800,264,38,165,126,173,1450,2008/2009
"Dunleavy,Mike",93,232,.401,32,90,.356,61,142,.430,53,65,.815,14,54,68,44,12,38,9,36,271,2008/2009
"Durant,Kevin",661,1390,.476,97,230,.422,564,1160,.486,452,524,.863,77,405,482,205,96,225,53,134,1871,2008/2009
"Ellis,Monta",194,430,.451,8,26,.308,186,404,.460,78,94,.830,14,94,108,93,39,67,8,67,474,2008/2009
"Elson,Francisco",83,169,.491,1,4,.250,82,165,.497,33,39,.846,100,129,229,32,36,48,36,144,200,2008/2009
"Ely,Melvin",37,95,.389,0,0,,37,95,.389,23,36,.639,30,34,64,18,2,23,9,58,97,2008/2009
"Evans,Maurice",208,482,.432,98,248,.395,110,234,.470,60,73,.822,88,155,243,54,50,43,10,163,574,2008/2009
"Evans,Reggie",79,178,.444,0,1,.000,79,177,.446,104,175,.594,135,226,361,26,41,69,8,161,262,2008/2009
"Farmar,Jordan",161,412,.391,49,146,.336,112,266,.421,45,77,.584,22,95,117,155,57,87,10,105,416,2008/2009
"Farmer,Desmon",4,14,.286,3,12,.250,1,2,.500,2,2,1.000,0,6,6,2,0,4,0,6,13,2008/2009
"Felton,Raymond",442,1083,.408,59,207,.285,383,876,.437,219,272,.805,54,256,310,553,126,228,30,191,1162,2008/2009
"Fernández,Rudy",268,630,.425,159,398,.399,109,232,.470,120,143,.839,47,160,207,159,69,86,12,111,815,2008/2009
"Fesenko,Kyrylo",21,36,.583,0,0,,21,36,.583,7,21,.333,14,23,37,4,7,9,15,35,49,2008/2009
"Finley,Michael",301,689,.437,131,319,.411,170,370,.459,51,62,.823,26,244,270,114,37,61,17,82,784,2008/2009
"Fisher,Derek",292,688,.424,120,302,.397,172,386,.446,110,130,.846,25,163,188,261,95,72,6,187,814,2008/2009
"Ford,T.J.",413,913,.452,35,104,.337,378,809,.467,245,281,.872,59,200,259,392,89,180,16,180,1106,2008/2009
"Foster,Jeff",177,353,.501,2,7,.286,175,346,.506,96,146,.658,215,293,508,130,53,88,49,229,452,2008/2009
"Foye,Randy",399,981,.407,111,308,.360,288,673,.428,230,272,.846,34,180,214,303,72,150,26,201,1139,2008/2009
"Foyle,Adonal",7,11,.636,0,0,,7,11,.636,3,6,.500,9,17,26,1,0,3,8,5,17,2008/2009
"Foyle,Adonal",7,11,.636,0,0,,7,11,.636,3,6,.500,9,17,26,1,0,3,8,4,17,2008/2009
"Foyle,Adonal",0,0,,0,0,,0,0,,0,0,,0,0,0,0,0,0,0,1,0,2008/2009
"Frye,Channing",113,267,.423,11,33,.333,102,234,.436,26,36,.722,41,99,140,24,17,29,16,106,263,2008/2009
"Gadzuric,Dan",117,244,.480,0,2,.000,117,242,.483,37,68,.544,95,160,255,39,32,41,43,162,271,2008/2009
"Gallinari,Danilo",56,125,.448,32,72,.444,24,53,.453,26,27,.963,13,42,55,15,14,15,4,48,170,2008/2009
"García,Francisco",295,665,.444,88,221,.398,207,444,.466,146,178,.820,56,162,218,150,80,112,67,196,824,2008/2009
"Gardner,Thomas",9,36,.250,4,23,.174,5,13,.385,2,4,.500,0,7,7,2,4,3,1,4,24,2008/2009
"Garnett,Kevin",393,740,.531,2,8,.250,391,732,.534,111,132,.841,78,407,485,144,63,90,68,128,899,2008/2009
"Gasol,Marc",350,661,.530,0,1,.000,350,660,.530,275,375,.733,201,404,605,143,63,164,90,265,975,2008/2009
"Gasol,Pau",592,1045,.567,1,2,.500,591,1043,.567,343,439,.781,262,518,780,284,52,157,81,172,1528,2008/2009
"Gay,Rudy",572,1262,.453,85,242,.351,487,1020,.477,264,344,.767,109,328,437,135,98,203,59,221,1493,2008/2009
"George,Devean",54,142,.380,22,76,.289,32,66,.485,17,22,.773,25,53,78,15,23,17,11,57,147,2008/2009
"Gibson,Daniel",206,527,.391,108,283,.382,98,244,.402,66,86,.767,31,124,155,132,44,61,16,163,586,2008/2009
"Giddens,J.R.",2,3,.667,0,0,,2,3,.667,0,0,,2,1,3,0,1,1,0,1,4,2008/2009
"Gill,Eddie",6,9,.667,2,3,.667,4,6,.667,0,0,,0,4,4,11,3,5,1,10,14,2008/2009
"Ginóbili,Manu",223,491,.454,69,209,.330,154,282,.546,168,190,.884,24,174,198,157,64,88,16,90,683,2008/2009
"Gomes,Ryan",420,974,.431,106,285,.372,314,689,.456,146,181,.807,106,286,392,135,63,128,22,183,1092,2008/2009
"Gooden,Drew",237,506,.468,0,4,.000,237,502,.472,131,156,.840,113,249,362,48,30,76,18,144,605,2008/2009
"Gooden,Drew",161,352,.457,0,3,.000,161,349,.461,84,97,.866,82,184,266,43,26,57,14,103,406,2008/2009
"Gooden,Drew",5,9,.556,0,0,,5,9,.556,2,2,1.000,3,10,13,2,0,3,0,2,12,2008/2009
"Gooden,Drew",71,145,.490,0,1,.000,71,144,.493,45,57,.789,28,55,83,3,4,16,4,39,187,2008/2009
"Gordon,Ben",598,1315,.455,173,422,.410,425,893,.476,330,382,.864,52,231,283,279,71,200,22,184,1699,2008/2009
"Gordon,Eric",411,901,.456,131,337,.389,280,564,.496,299,350,.854,45,156,201,215,78,164,35,172,1252,2008/2009
"Gortat,Marcin",106,187,.567,1,1,1.000,105,186,.565,26,45,.578,96,190,286,14,18,25,53,111,239,2008/2009
"Graham,Joey",231,480,.481,3,16,.188,228,464,.491,132,160,.825,95,197,292,48,35,74,12,191,597,2008/2009
"Graham,Stephen",106,256,.414,20,66,.303,86,190,.453,50,62,.806,21,75,96,33,10,45,4,82,282,2008/2009
"Granger,Danny",571,1277,.447,182,450,.404,389,827,.470,404,460,.878,49,292,341,183,69,165,97,207,1728,2008/2009
"Gray,Aaron",81,167,.485,0,1,.000,81,166,.488,34,59,.576,84,136,220,46,14,40,18,135,196,2008/2009
"Green,Gerald",79,180,.439,14,46,.304,65,134,.485,27,32,.844,14,40,54,15,10,33,5,51,199,2008/2009
"Green,Jeff",476,1068,.446,96,247,.389,380,821,.463,242,307,.788,120,399,519,155,81,173,33,202,1290,2008/2009
"Green,Willie",286,658,.435,51,161,.317,235,497,.473,62,85,.729,29,97,126,158,53,64,13,154,685,2008/2009
"Greene,Donté",77,236,.326,26,100,.260,51,136,.375,29,34,.853,19,67,86,30,16,37,14,68,209,2008/2009
"Haddadi,Hamed",15,31,.484,0,0,,15,31,.484,18,30,.600,16,31,47,8,1,9,12,20,48,2008/2009
"Hairston,Malik",24,49,.490,0,1,.000,24,48,.500,2,7,.286,11,17,28,13,6,12,7,19,50,2008/2009
"Hamilton,Richard",466,1043,.447,70,190,.368,396,853,.464,223,263,.848,44,163,207,297,40,133,4,176,1225,2008/2009
"Harpring,Matt",111,241,.461,0,2,.000,111,239,.464,55,72,.764,47,76,123,28,29,29,9,102,277,2008/2009
"Harrington,Al",532,1212,.439,171,470,.364,361,742,.487,234,295,.793,99,356,455,102,88,161,22,227,1469,2008/2009
"Harrington,Al",23,70,.329,11,28,.393,12,42,.286,5,10,.500,10,18,28,10,7,7,0,14,62,2008/2009
"Harrington,Al",509,1142,.446,160,442,.362,349,700,.499,229,285,.804,89,338,427,92,81,154,22,213,1407,2008/2009
"Harris,Devin",455,1039,.438,64,220,.291,391,819,.477,496,605,.820,30,201,231,476,114,212,13,164,1470,2008/2009
"Hart,Jason",30,94,.319,0,6,.000,30,88,.341,18,23,.783,13,33,46,48,12,22,4,39,78,2008/2009
"Hart,Jason",25,84,.298,0,4,.000,25,80,.313,15,19,.789,12,30,42,43,12,19,4,35,65,2008/2009
"Hart,Jason",5,10,.500,0,2,.000,5,8,.625,3,4,.750,1,3,4,5,0,3,0,4,13,2008/2009
"Haslem,Udonis",333,643,.518,0,0,,333,643,.518,128,170,.753,169,449,618,85,43,82,25,204,794,2008/2009
"Hassell,Trenton",86,191,.450,2,8,.250,84,183,.459,20,25,.800,50,96,146,51,21,30,16,92,194,2008/2009
"Hawes,Spencer",373,800,.466,40,115,.348,333,685,.486,90,136,.662,148,401,549,149,44,160,93,249,876,2008/2009
"Hayes,Chuck",42,113,.372,0,4,.000,42,109,.385,7,19,.368,74,176,250,42,34,25,19,134,91,2008/2009
"Hayes,Jarvis",257,577,.445,94,244,.385,163,333,.489,36,52,.692,27,240,267,54,52,49,7,162,644,2008/2009
"Haywood,Brendan",24,50,.480,0,0,,24,50,.480,10,21,.476,13,31,44,8,4,9,15,14,58,2008/2009
"Head,Luther",55,144,.382,20,54,.370,35,90,.389,19,24,.792,6,46,52,58,17,25,2,37,149,2008/2009
"Head,Luther",39,101,.386,14,38,.368,25,63,.397,14,16,.875,3,24,27,35,6,16,1,15,106,2008/2009
"Head,Luther",16,43,.372,6,16,.375,10,27,.370,5,8,.625,3,22,25,23,11,9,1,22,43,2008/2009
"Herrmann,Walter",82,207,.396,41,120,.342,41,87,.471,19,25,.760,28,79,107,22,7,17,4,43,224,2008/2009
"Hibbert,Roy",198,420,.471,0,0,,198,420,.471,98,147,.667,115,128,243,49,20,55,76,215,494,2008/2009
"Hickson,J.J.",100,194,.515,0,0,,100,194,.515,45,67,.672,52,113,165,9,14,45,30,81,245,2008/2009
"Hilário,Nenê",428,709,.604,1,5,.200,427,704,.607,266,368,.723,183,415,598,108,95,147,101,278,1123,2008/2009
"Hill,George",150,372,.403,24,73,.329,126,299,.421,114,146,.781,30,128,158,136,45,74,21,150,438,2008/2009
"Hill,Grant",390,745,.523,24,76,.316,366,669,.547,181,224,.808,64,341,405,186,90,126,54,182,985,2008/2009
"Hill,Steven",1,1,1.000,0,0,,1,1,1.000,0,0,,2,1,3,0,0,0,0,0,2,2008/2009
"Hinrich,Kirk",183,419,.437,69,169,.408,114,250,.456,68,86,.791,16,107,123,197,66,87,19,126,503,2008/2009
"Hollins,Ryan",50,94,.532,0,0,,50,94,.532,43,72,.597,46,51,97,7,7,24,32,78,143,2008/2009
"Hollins,Ryan",19,35,.543,0,0,,19,35,.543,26,39,.667,19,17,36,4,3,10,17,34,64,2008/2009
"Hollins,Ryan",31,59,.525,0,0,,31,59,.525,17,33,.515,27,34,61,3,4,14,15,44,79,2008/2009
"Horford,Al",312,594,.525,0,1,.000,312,593,.526,149,205,.727,145,479,624,163,53,103,95,190,773,2008/2009
"House,Eddie",249,560,.445,151,340,.444,98,220,.445,42,53,.792,11,146,157,92,61,55,7,113,691,2008/2009
"Howard,Dwight",560,979,.572,0,2,.000,560,977,.573,504,849,.594,336,757,1093,112,77,240,231,270,1624,2008/2009
"Howard,Josh",353,783,.451,58,168,.345,295,615,.480,172,220,.782,59,204,263,83,55,89,30,135,936,2008/2009
"Howard,Juwan",75,147,.510,0,0,,75,147,.510,23,34,.676,30,46,76,26,7,26,6,71,173,2008/2009
"Howard,Juwan",1,2,.500,0,0,,1,2,.500,0,0,,1,3,4,2,1,0,1,4,2,2008/2009
"Howard,Juwan",74,145,.510,0,0,,74,145,.510,23,34,.676,29,43,72,24,6,26,5,67,171,2008/2009
"Hughes,Larry",224,557,.402,75,193,.389,149,364,.409,117,145,.807,16,143,159,119,72,71,14,96,640,2008/2009
"Hughes,Larry",127,308,.412,40,102,.392,87,206,.422,67,82,.817,6,88,94,59,36,36,9,51,361,2008/2009
"Hughes,Larry",97,249,.390,35,91,.385,62,158,.392,50,63,.794,10,55,65,60,36,35,5,45,279,2008/2009
"Humphries,Kris",38,90,.422,0,0,,38,90,.422,38,48,.792,24,46,70,10,8,8,6,31,114,2008/2009
"Hunter,Lindsey",27,82,.329,16,48,.333,11,34,.324,3,5,.600,2,10,12,37,20,19,1,28,73,2008/2009
"Hunter,Othello",11,20,.550,0,0,,11,20,.550,0,5,.000,9,15,24,1,2,2,5,11,22,2008/2009
"Iguodala,Andre",542,1147,.473,80,261,.307,462,886,.521,377,521,.724,92,379,471,434,131,222,36,152,1541,2008/2009
"Ilgauskas,Zydrunas",342,724,.472,15,39,.385,327,685,.477,139,174,.799,157,333,490,64,28,90,84,183,838,2008/2009
"Ilunga-Mbenga,Didier",27,57,.474,0,1,.000,27,56,.482,7,8,.875,9,22,31,9,10,13,24,33,61,2008/2009
"Iverson,Allen",348,834,.417,28,99,.283,320,735,.435,271,347,.781,30,143,173,283,88,146,6,86,995,2008/2009
"Iverson,Allen",18,40,.450,2,8,.250,16,32,.500,18,25,.720,3,5,8,20,3,10,1,3,56,2008/2009
"Iverson,Allen",330,794,.416,26,91,.286,304,703,.432,253,322,.786,27,138,165,263,85,136,5,83,939,2008/2009
"Ivey,Royal",69,208,.332,39,114,.342,30,94,.319,34,43,.791,19,57,76,43,36,23,7,76,211,2008/2009
"Jack,Jarrett",386,853,.453,78,221,.353,308,632,.487,224,263,.852,44,232,276,338,88,184,17,179,1074,2008/2009
"Jackson,Bobby",193,485,.398,60,197,.305,133,288,.462,86,101,.851,42,158,200,143,62,66,4,100,532,2008/2009
"Jackson,Darnell",37,86,.430,0,2,.000,37,84,.440,24,35,.686,32,55,87,8,10,14,4,77,98,2008/2009
"Jackson,Stephen",413,997,.414,103,305,.338,310,692,.448,294,356,.826,70,233,303,381,88,229,31,153,1223,2008/2009
"James,Jerome",3,8,.375,0,0,,3,8,.375,0,0,,1,2,3,0,1,1,1,2,6,2008/2009
"James,LeBron",789,1613,.489,132,384,.344,657,1229,.535,594,762,.780,106,507,613,587,137,241,93,139,2304,2008/2009
"James,Mike",197,514,.383,69,184,.375,128,330,.388,68,82,.829,25,108,133,201,44,94,6,108,531,2008/2009
"James,Mike",8,25,.320,3,4,.750,5,21,.238,1,2,.500,1,6,7,8,2,3,0,7,20,2008/2009
"James,Mike",189,489,.387,66,180,.367,123,309,.398,67,80,.838,24,102,126,193,42,91,6,101,511,2008/2009
"Jamison,Antawn",674,1441,.468,112,319,.351,562,1122,.501,341,452,.754,196,525,721,153,95,125,25,218,1801,2008/2009
"Jarić,Marko",48,145,.331,11,28,.393,37,117,.316,29,41,.707,23,42,65,74,29,49,11,62,136,2008/2009
"Jawai,Nathan",1,4,.250,0,0,,1,4,.250,0,0,,1,1,2,0,0,2,0,3,2,2008/2009
"Jefferson,Al",485,975,.497,0,4,.000,485,971,.499,186,252,.738,172,376,548,79,39,92,83,141,1156,2008/2009
"Jefferson,Dontell",11,22,.500,1,2,.500,10,20,.500,6,9,.667,1,11,12,9,4,6,1,9,29,2008/2009
"Jefferson,Richard",537,1222,.439,116,292,.397,421,930,.453,417,518,.805,57,317,374,199,66,165,14,252,1607,2008/2009
"Jeffries,Jared",120,273,.440,1,12,.083,119,261,.456,55,90,.611,128,103,231,80,47,65,33,153,296,2008/2009
"Jianlian,Yi",191,500,.382,48,140,.343,143,360,.397,95,123,.772,67,259,326,60,29,70,36,157,525,2008/2009
"Johnson,Amir",97,163,.595,0,0,,97,163,.595,23,35,.657,102,130,232,20,20,33,60,171,217,2008/2009
"Johnson,Anthony",154,381,.404,52,133,.391,102,248,.411,61,81,.753,29,118,147,200,46,82,5,111,421,2008/2009
"Johnson,Joe",620,1420,.437,149,414,.360,471,1006,.468,299,362,.826,65,281,346,455,84,195,19,176,1688,2008/2009
"Johnson,Linton",4,11,.364,1,2,.500,3,9,.333,0,0,,3,5,8,2,1,2,0,7,9,2008/2009
"Johnson,Linton",0,0,,0,0,,0,0,,0,0,,0,0,0,0,0,0,0,1,0,2008/2009
"Johnson,Linton",4,11,.364,1,2,.500,3,9,.333,0,0,,3,5,8,2,1,2,0,6,9,2008/2009
"Johnson,Trey",0,5,.000,0,0,,0,5,.000,4,4,1.000,0,1,1,0,0,1,0,4,4,2008/2009
"Jones,Dahntay",154,336,.458,11,17,.647,143,319,.448,110,151,.728,58,110,168,78,49,68,19,199,429,2008/2009
"Jones,Damon",11,34,.324,11,28,.393,0,6,.000,0,0,,0,6,6,7,3,6,0,4,33,2008/2009
"Jones,Dwayne",4,7,.571,0,0,,4,7,.571,4,6,.667,6,6,12,0,0,4,1,6,12,2008/2009
"Jones,Fred",129,317,.407,54,147,.367,75,170,.441,66,81,.815,23,103,126,188,53,66,11,112,378,2008/2009
"Jones,James",55,149,.369,33,96,.344,22,53,.415,26,31,.839,12,50,62,20,12,12,14,58,169,2008/2009
"Jones,Solomon",67,111,.604,1,2,.500,66,109,.606,53,74,.716,52,90,142,15,7,27,34,125,188,2008/2009
"Jordan,DeAndre",93,147,.633,0,0,,93,147,.633,42,109,.385,72,165,237,11,11,41,59,96,228,2008/2009
"Kaman,Chris",161,305,.528,0,0,,161,305,.528,51,75,.680,75,172,247,46,17,84,45,93,373,2008/2009
"Kapono,Jason",261,604,.432,98,229,.428,163,375,.435,34,42,.810,26,137,163,105,22,70,3,144,654,2008/2009
"Kidd,Jason",257,618,.416,131,323,.406,126,295,.427,86,105,.819,85,415,500,702,160,185,39,168,731,2008/2009
"Kinsey,Tarence",31,69,.449,7,18,.389,24,51,.471,33,38,.868,10,28,38,10,12,22,0,34,102,2008/2009
"Kirilenko,Andrei",256,570,.449,20,73,.274,236,497,.475,244,311,.785,84,235,319,175,83,121,77,127,776,2008/2009
"Kleiza,Linas",289,646,.447,87,267,.326,202,379,.533,148,204,.725,92,235,327,64,31,82,14,155,813,2008/2009
"Knight,Brevin",66,189,.349,0,6,.000,66,183,.361,48,64,.750,13,75,88,190,68,66,4,98,180,2008/2009
"Korver,Kyle",245,560,.438,103,267,.386,142,293,.485,112,127,.882,35,223,258,137,47,90,30,170,705,2008/2009
"Koufos,Kosta",94,185,.508,0,0,,94,185,.508,36,51,.706,50,88,138,20,12,26,31,70,224,2008/2009
"Krstić,Nenad",191,407,.469,0,0,,191,407,.469,63,79,.797,85,168,253,29,21,45,49,114,445,2008/2009
"Kurz,Rob",51,131,.389,15,38,.395,36,93,.387,40,50,.800,33,48,81,20,14,16,19,78,157,2008/2009
"Landry,Carl",240,418,.574,1,3,.333,239,415,.576,157,193,.813,124,219,343,39,26,68,31,166,638,2008/2009
"Law,Acie",52,139,.374,9,29,.310,43,110,.391,49,60,.817,6,52,58,86,11,29,3,43,162,2008/2009
"Lee,Courtney",243,540,.450,82,203,.404,161,337,.478,78,94,.830,18,160,178,91,76,69,14,157,646,2008/2009
"Lee,David",522,951,.549,0,3,.000,522,948,.551,249,330,.755,256,695,951,174,80,150,22,260,1293,2008/2009
"Lewis,Rashard",478,1089,.439,220,554,.397,258,535,.482,225,269,.836,92,361,453,205,81,158,51,194,1401,2008/2009
"Livingston,Shaun",31,60,.517,0,0,,31,60,.517,9,10,.900,3,25,28,20,7,9,2,12,71,2008/2009
"Livingston,Shaun",3,8,.375,0,0,,3,8,.375,3,4,.750,0,2,2,4,2,3,0,4,9,2008/2009
"Livingston,Shaun",28,52,.538,0,0,,28,52,.538,6,6,1.000,3,23,26,16,5,6,2,8,62,2008/2009
"Lopez,Brook",448,844,.531,0,2,.000,448,842,.532,172,217,.793,225,440,665,86,44,147,151,257,1068,2008/2009
"Lopez,Robin",71,137,.518,0,1,.000,71,136,.522,47,68,.691,52,66,118,8,11,28,41,97,189,2008/2009
"Love,Kevin",316,688,.459,2,19,.105,314,669,.469,265,336,.789,274,460,734,84,35,118,50,205,899,2008/2009
"Lowry,Kyle",189,434,.435,25,98,.255,164,336,.488,181,226,.801,26,163,189,275,69,117,17,146,584,2008/2009
"Lowry,Kyle",112,272,.412,17,69,.246,95,203,.468,129,161,.801,13,98,111,178,48,79,8,89,370,2008/2009
"Lowry,Kyle",77,162,.475,8,29,.276,69,133,.519,52,65,.800,13,65,78,97,21,38,9,57,214,2008/2009
"Lue,Tyronn",71,162,.438,27,62,.435,44,100,.440,14,19,.737,6,40,46,60,8,23,0,54,183,2008/2009
"Lue,Tyronn",54,119,.454,21,45,.467,33,74,.446,12,16,.750,6,29,35,46,6,21,0,41,141,2008/2009
"Lue,Tyronn",17,43,.395,6,17,.353,11,26,.423,2,3,.667,0,11,11,14,2,2,0,13,42,2008/2009
"Madsen,Mark",3,14,.214,0,0,,3,14,.214,0,4,.000,10,8,18,4,1,3,1,18,6,2008/2009
"Maggette,Corey",292,634,.461,24,95,.253,268,539,.497,342,415,.824,49,233,282,92,44,120,8,192,950,2008/2009
"Magloire,Jamaal",65,131,.496,0,0,,65,131,.496,29,60,.483,82,140,222,22,11,32,25,121,159,2008/2009
"Marbury,Stephon",38,111,.342,6,25,.240,32,86,.372,6,13,.462,2,26,28,75,10,37,3,34,88,2008/2009
"Marion,Shawn",382,788,.485,10,53,.189,372,735,.506,117,147,.796,180,409,589,139,88,105,66,132,891,2008/2009
"Marion,Shawn",215,446,.482,8,40,.200,207,406,.510,67,85,.788,107,258,365,77,57,56,45,92,505,2008/2009
"Marion,Shawn",167,342,.488,2,13,.154,165,329,.502,50,62,.806,73,151,224,62,31,49,21,40,386,2008/2009
"Marks,Sean",80,165,.485,2,10,.200,78,155,.503,30,44,.682,62,125,187,14,7,35,33,121,192,2008/2009
"Marshall,Donyell",33,73,.452,25,55,.455,8,18,.444,3,6,.500,6,34,40,15,4,6,5,24,94,2008/2009
"Martin,Cartier",28,77,.364,10,33,.303,18,44,.409,20,25,.800,7,26,33,13,8,9,4,33,86,2008/2009
"Martin,Kenyon",318,648,.491,14,38,.368,304,610,.498,119,197,.604,81,314,395,132,96,104,74,201,769,2008/2009
"Martin,Kevin",341,811,.420,115,277,.415,226,534,.423,457,527,.867,29,154,183,138,61,146,8,116,1254,2008/2009
"Mason,Desmond",124,285,.435,0,3,.000,124,282,.440,46,85,.541,41,116,157,46,15,56,30,96,294,2008/2009
"Mason,Roger",349,822,.425,166,394,.421,183,428,.428,105,118,.890,16,235,251,173,40,100,12,160,969,2008/2009
"Maxiell,Jason",184,320,.575,0,1,.000,184,319,.577,84,158,.532,169,155,324,24,25,45,63,157,452,2008/2009
"May,Sean",39,98,.398,1,1,1.000,38,97,.392,14,20,.700,20,49,69,10,5,26,4,32,93,2008/2009
"Mayo,O.J.",562,1283,.438,145,378,.384,417,905,.461,247,281,.879,56,252,308,262,91,226,13,204,1516,2008/2009
"Mbah a Moute,Luc",227,491,.462,0,4,.000,227,487,.466,140,192,.729,189,298,487,87,87,100,45,204,594,2008/2009
"McCants,Rashad",192,488,.393,63,189,.333,129,299,.431,107,141,.759,21,89,110,68,47,64,14,103,554,2008/2009
"McCants,Rashad",105,292,.360,38,119,.319,67,173,.387,60,81,.741,11,52,63,32,27,45,6,63,308,2008/2009
"McCants,Rashad",87,196,.444,25,70,.357,62,126,.492,47,60,.783,10,37,47,36,20,19,8,40,246,2008/2009
"McDyess,Antonio",268,525,.510,0,0,,268,525,.510,60,86,.698,185,422,607,83,41,51,50,191,596,2008/2009
"McGee,JaVale",191,387,.494,0,0,,191,387,.494,107,162,.660,120,174,294,23,33,61,75,155,489,2008/2009
"McGrady,Tracy",188,485,.388,44,117,.376,144,368,.391,125,156,.801,20,134,154,175,42,69,15,38,545,2008/2009
"McGuire,Dominic",140,324,.432,2,4,.500,138,320,.431,74,102,.725,113,315,428,198,62,92,74,153,356,2008/2009
"McRoberts,Josh",35,83,.422,0,10,.000,35,73,.479,10,13,.769,26,48,74,16,12,12,16,41,80,2008/2009
"Mensah-Bonsu,Pops",39,103,.379,0,2,.000,39,101,.386,33,48,.688,55,58,113,6,9,19,5,43,111,2008/2009
"Mensah-Bonsu,Pops",5,7,.714,0,0,,5,7,.714,5,7,.714,5,5,10,0,1,2,1,6,15,2008/2009
"Mensah-Bonsu,Pops",34,96,.354,0,2,.000,34,94,.362,28,41,.683,50,53,103,6,8,17,4,37,96,2008/2009
"Mihm,Chris",15,40,.375,0,0,,15,40,.375,6,7,.857,15,19,34,10,1,10,6,23,36,2008/2009
"Miles,C.J.",258,562,.459,63,179,.352,195,383,.509,78,89,.876,45,122,167,107,46,64,15,187,657,2008/2009
"Miles,Darius",48,99,.485,1,6,.167,47,93,.505,23,31,.742,19,38,57,17,11,21,20,32,120,2008/2009
"Miličić,Darko",137,266,.515,0,0,,137,266,.515,59,105,.562,83,181,264,34,22,48,51,134,333,2008/2009
"Miller,Andre",492,1041,.473,15,53,.283,477,988,.483,338,409,.826,123,245,368,534,109,199,14,196,1337,2008/2009
"Miller,Brad",292,614,.476,23,56,.411,269,558,.482,224,272,.824,150,395,545,234,52,130,36,223,831,2008/2009
"Miller,Brad",184,388,.474,20,43,.465,164,345,.475,125,156,.801,83,261,344,148,30,83,24,135,513,2008/2009
"Miller,Brad",108,226,.478,3,13,.231,105,213,.493,99,116,.853,67,134,201,86,22,47,12,88,318,2008/2009
"Miller,Mike",264,548,.482,85,225,.378,179,323,.554,109,149,.732,73,410,483,326,30,145,31,139,722,2008/2009
"Millsap,Paul",400,749,.534,0,4,.000,400,745,.537,228,326,.699,251,403,654,138,78,129,73,288,1028,2008/2009
"Ming,Yao",566,1032,.548,1,1,1.000,565,1031,.548,381,440,.866,204,557,761,137,30,234,150,257,1514,2008/2009
"Mobley,Cuttino",63,146,.432,12,35,.343,51,111,.459,13,18,.722,9,20,29,12,15,18,2,21,151,2008/2009
"Mohammed,Nazr",41,101,.406,0,0,,41,101,.406,22,40,.550,35,44,79,8,5,23,16,63,104,2008/2009
"Moon,Jamario",222,474,.468,65,183,.355,157,291,.540,68,80,.850,58,307,365,95,86,43,60,133,577,2008/2009
"Moon,Jamario",150,317,.473,38,110,.345,112,207,.541,55,65,.846,48,201,249,70,65,31,44,85,393,2008/2009
"Moon,Jamario",72,157,.459,27,73,.370,45,84,.536,13,15,.867,10,106,116,25,21,12,16,48,184,2008/2009
"Moore,Mikki",114,206,.553,0,0,,114,206,.553,48,61,.787,76,182,258,53,17,48,19,208,276,2008/2009
"Moore,Mikki",63,121,.521,0,0,,63,121,.521,34,42,.810,45,107,152,28,13,27,14,112,160,2008/2009
"Moore,Mikki",51,85,.600,0,0,,51,85,.600,14,19,.737,31,75,106,25,4,21,5,96,116,2008/2009
"Morris,Randolph",7,17,.412,0,0,,7,17,.412,4,4,1.000,4,16,20,2,2,7,1,25,18,2008/2009
"Morrison,Adam",80,223,.359,32,96,.333,48,127,.378,17,23,.739,18,62,80,41,9,32,4,77,209,2008/2009
"Morrison,Adam",76,211,.360,31,92,.337,45,119,.378,16,21,.762,16,56,72,38,9,29,4,73,199,2008/2009
"Morrison,Adam",4,12,.333,1,4,.250,3,8,.375,1,2,.500,2,6,8,3,0,3,0,4,10,2008/2009
"Morrow,Anthony",255,534,.478,86,184,.467,169,350,.483,80,92,.870,78,121,199,80,36,52,12,130,676,2008/2009
"Murphy,Troy",364,767,.475,161,358,.450,203,409,.496,152,184,.826,146,715,861,172,58,114,34,226,1041,2008/2009
"Murray,Ronald",355,795,.447,87,242,.360,268,553,.485,177,233,.760,22,146,168,158,88,128,17,173,974,2008/2009
"Mutombo,Dikembe",5,13,.385,0,0,,5,13,.385,6,9,.667,12,21,33,0,0,6,11,11,16,2008/2009
"Nájera,Eduardo",33,74,.446,5,25,.200,28,49,.571,8,22,.364,17,50,67,19,10,18,4,50,79,2008/2009
"Nash,Steve",428,851,.503,108,246,.439,320,605,.529,196,210,.933,19,204,223,717,55,248,10,108,1160,2008/2009
"Nelson,DeMarcus",24,54,.444,0,3,.000,24,51,.471,5,14,.357,6,18,24,13,9,15,2,24,53,2008/2009
"Nelson,Jameer",267,531,.503,82,181,.453,185,350,.529,86,97,.887,20,125,145,226,51,83,3,123,702,2008/2009
"Nesterović,Rasho",224,437,.513,0,1,.000,224,436,.514,25,32,.781,93,147,240,109,30,63,38,171,473,2008/2009
"Nichols,Demetris",3,9,.333,0,2,.000,3,7,.429,1,2,.500,0,2,2,1,0,0,1,1,7,2008/2009
"Nichols,Demetris",1,4,.250,0,1,.000,1,3,.333,0,0,,0,0,0,1,0,0,0,1,2,2008/2009
"Nichols,Demetris",2,5,.400,0,1,.000,2,4,.500,1,2,.500,0,2,2,0,0,0,1,0,5,2008/2009
"Noah,Joakim",207,372,.556,0,1,.000,207,371,.558,123,182,.676,244,362,606,106,49,82,110,238,537,2008/2009
"Nocioni,Andrés",299,701,.427,124,311,.399,175,390,.449,145,183,.792,54,307,361,102,39,113,33,261,867,2008/2009
"Nocioni,Andrés",186,449,.414,79,209,.378,107,240,.446,100,124,.806,34,188,222,60,26,73,16,176,551,2008/2009
"Nocioni,Andrés",113,252,.448,45,102,.441,68,150,.453,45,59,.763,20,119,139,42,13,40,17,85,316,2008/2009
"Novak,Steve",176,396,.444,119,286,.416,57,110,.518,21,23,.913,19,106,125,40,20,23,5,71,492,2008/2009
"Nowitzki,Dirk",774,1616,.479,61,170,.359,713,1446,.493,485,545,.890,88,593,681,197,61,157,63,176,2094,2008/2009
"O'Bryant,Patrick",45,84,.536,0,2,.000,45,82,.549,11,20,.550,13,53,66,11,6,22,19,61,101,2008/2009
"O'Bryant,Patrick",16,31,.516,0,0,,16,31,.516,8,12,.667,7,27,34,8,3,17,8,29,40,2008/2009
"O'Bryant,Patrick",29,53,.547,0,2,.000,29,51,.569,3,8,.375,6,26,32,3,3,5,11,32,61,2008/2009
"O'Neal,Jermaine",365,770,.474,0,1,.000,365,769,.475,175,222,.788,126,307,433,122,29,144,136,211,905,2008/2009
"O'Neal,Jermaine",220,465,.473,0,1,.000,220,464,.474,115,142,.810,71,217,288,67,18,92,82,130,555,2008/2009
"O'Neal,Jermaine",145,305,.475,0,0,,145,305,.475,60,80,.750,55,90,145,55,11,52,54,81,350,2008/2009
"O'Neal,Shaquille",512,841,.609,0,1,.000,512,840,.610,309,519,.595,187,446,633,126,49,168,108,253,1333,2008/2009
"Oberto,Fabricio",61,104,.587,0,1,.000,61,103,.592,20,35,.571,65,77,142,59,7,38,11,95,142,2008/2009
"Oden,Greg",198,351,.564,0,0,,198,351,.564,144,226,.637,169,255,424,31,25,87,69,238,540,2008/2009
"Odom,Lamar",346,703,.492,33,103,.320,313,600,.522,160,257,.623,176,461,637,204,77,138,98,235,885,2008/2009
"Okafor,Emeka",433,772,.561,0,0,,433,772,.561,219,369,.593,275,552,827,53,48,144,136,247,1085,2008/2009
"Okur,Mehmet",431,888,.485,90,202,.446,341,686,.497,273,334,.817,124,433,557,120,54,132,53,219,1225,2008/2009
"Ollie,Kevin",61,150,.407,0,1,.000,61,149,.409,80,96,.833,13,62,75,117,19,34,4,79,202,2008/2009
"Outlaw,Travis",385,850,.453,89,236,.377,296,614,.482,175,242,.723,70,261,331,83,47,94,57,168,1034,2008/2009
"Pachulia,Zaza",159,320,.497,0,3,.000,159,317,.502,163,230,.709,173,263,436,57,35,91,26,208,481,2008/2009
"Parker,Anthony",321,754,.426,94,241,.390,227,513,.442,121,145,.834,45,272,317,269,100,114,15,145,857,2008/2009
"Parker,Tony",639,1263,.506,19,65,.292,620,1198,.518,284,363,.782,27,196,223,496,67,186,4,110,1581,2008/2009
"Paul,Chris",631,1255,.503,64,176,.364,567,1079,.525,455,524,.868,69,363,432,861,216,231,10,212,1781,2008/2009
"Pavlović,Sasha",116,275,.422,48,117,.410,68,158,.430,25,54,.463,31,96,127,72,22,48,16,122,305,2008/2009
"Pecherov,Oleksiy",39,101,.386,14,43,.326,25,58,.431,24,29,.828,35,41,76,2,6,10,3,34,116,2008/2009
"Perkins,Kendrick",276,478,.577,0,2,.000,276,476,.580,96,160,.600,204,415,619,96,22,165,150,253,648,2008/2009
"Peterson,Morris",73,183,.399,33,85,.388,40,98,.408,12,19,.632,13,71,84,16,15,15,2,51,191,2008/2009
"Petro,Johan",73,176,.415,0,2,.000,73,174,.420,16,29,.552,42,116,158,16,19,28,15,107,162,2008/2009
"Petro,Johan",46,113,.407,0,1,.000,46,112,.411,10,15,.667,27,68,95,6,16,15,5,51,102,2008/2009
"Petro,Johan",27,63,.429,0,1,.000,27,62,.435,6,14,.429,15,48,63,10,3,13,10,56,60,2008/2009
"Pierce,Paul",540,1181,.457,119,304,.391,421,877,.480,459,553,.830,56,401,457,294,80,228,27,215,1658,2008/2009
"Piétrus,Mickaël",176,426,.413,80,223,.359,96,203,.473,78,110,.709,44,132,176,65,31,56,24,126,510,2008/2009
"Posey,James",216,524,.412,116,314,.369,100,210,.476,120,146,.822,38,324,362,82,58,79,21,216,668,2008/2009
"Powe,Leon",177,338,.524,0,0,,177,338,.524,184,267,.689,145,200,345,46,24,76,38,192,538,2008/2009
"Powell,Josh",106,239,.444,0,0,,106,239,.444,38,50,.760,71,105,176,27,9,51,17,98,250,2008/2009
"Price,Ronnie",77,203,.379,19,61,.311,58,142,.408,34,45,.756,12,57,69,108,39,61,5,74,207,2008/2009
"Prince,Tayshaun",459,1020,.450,56,141,.397,403,879,.458,189,243,.778,128,348,476,253,44,101,51,104,1163,2008/2009
"Pruitt,Gabe",31,101,.307,14,48,.292,17,53,.321,17,21,.810,9,34,43,39,15,19,3,34,93,2008/2009
"Przybilla,Joel",168,269,.625,0,1,.000,168,268,.627,112,169,.663,204,513,717,27,34,78,97,215,448,2008/2009
"Quinn,Chris",118,289,.408,56,137,.409,62,152,.408,47,58,.810,8,67,75,132,24,33,2,79,339,2008/2009
"Radmanović,Vladimir",196,466,.421,105,262,.401,91,204,.446,43,58,.741,45,177,222,81,46,98,15,111,540,2008/2009
"Radmanović,Vladimir",95,214,.444,60,136,.441,35,78,.449,23,27,.852,18,99,117,38,28,47,7,51,273,2008/2009
"Radmanović,Vladimir",101,252,.401,45,126,.357,56,126,.444,20,31,.645,27,78,105,43,18,51,8,60,267,2008/2009
"Randolph,Anthony",199,431,.462,0,4,.000,199,427,.466,101,141,.716,128,235,363,49,42,80,74,141,499,2008/2009
"Randolph,Shavlik",8,13,.615,1,1,1.000,7,12,.583,1,4,.250,10,8,18,0,0,6,1,4,18,2008/2009
"Randolph,Zach",415,873,.475,32,97,.330,383,776,.494,179,244,.734,157,347,504,103,43,114,16,133,1041,2008/2009
"Randolph,Zach",82,189,.434,7,24,.292,75,165,.455,55,67,.821,40,97,137,15,13,23,3,28,226,2008/2009
"Randolph,Zach",333,684,.487,25,73,.342,308,611,.504,124,177,.701,117,250,367,88,30,91,13,105,815,2008/2009
"Ratliff,Theo",34,64,.531,0,0,,34,64,.531,21,35,.600,46,82,128,9,17,14,47,77,89,2008/2009
"Redd,Michael",249,547,.455,70,191,.366,179,356,.503,131,161,.814,24,83,107,88,35,53,2,45,699,2008/2009
"Redick,J.J.",117,299,.391,67,179,.374,50,120,.417,81,93,.871,8,101,109,73,21,54,1,72,382,2008/2009
"Richardson,Jason",465,974,.477,129,325,.397,336,649,.518,153,199,.769,77,242,319,146,76,95,28,146,1212,2008/2009
"Richardson,Jason",97,220,.441,27,59,.458,70,161,.435,41,55,.745,13,45,58,36,14,24,3,43,262,2008/2009
"Richardson,Jason",368,754,.488,102,266,.383,266,488,.545,112,144,.778,64,197,261,110,62,71,25,103,950,2008/2009
"Richardson,Jeremy",14,49,.286,6,17,.353,8,32,.250,3,6,.500,1,13,14,3,0,3,0,6,37,2008/2009
"Richardson,Quentin",262,667,.393,120,329,.365,142,338,.420,89,117,.761,71,248,319,117,47,74,7,132,733,2008/2009
"Ridnour,Luke",250,621,.403,55,157,.350,195,464,.420,133,153,.869,33,185,218,365,92,128,16,200,688,2008/2009
"Roberson,Anthony",44,120,.367,26,81,.321,18,39,.462,5,5,1.000,6,16,22,20,10,8,1,18,119,2008/2009
"Roberson,Anthony",39,103,.379,24,71,.338,15,32,.469,5,5,1.000,4,11,15,19,10,7,1,18,107,2008/2009
"Roberson,Anthony",5,17,.294,2,10,.200,3,7,.429,0,0,,2,5,7,1,0,1,0,0,12,2008/2009
"Robinson,Nate",449,1028,.437,125,385,.325,324,643,.504,249,296,.841,98,192,290,301,95,139,6,206,1272,2008/2009
"Rodríguez,Sergio",129,329,.392,37,114,.325,92,215,.428,61,77,.792,43,87,130,286,54,119,2,133,356,2008/2009
"Rondo,Rajon",383,759,.505,15,48,.313,368,711,.518,172,268,.642,100,316,416,659,149,209,11,193,953,2008/2009
"Rose,Derrick",574,1208,.475,16,72,.222,558,1136,.491,197,250,.788,96,221,317,512,66,202,18,125,1361,2008/2009
"Rose,Malik",45,131,.344,0,7,.000,45,124,.363,40,51,.784,17,79,96,36,10,36,3,72,130,2008/2009
"Rose,Malik",11,41,.268,0,4,.000,11,37,.297,8,11,.727,4,27,31,10,1,17,1,24,30,2008/2009
"Rose,Malik",34,90,.378,0,3,.000,34,87,.391,32,40,.800,13,52,65,26,9,19,2,48,100,2008/2009
"Ross,Quinton",99,259,.382,33,88,.375,66,171,.386,34,42,.810,29,97,126,47,32,36,14,114,265,2008/2009
"Roy,Brandon",633,1318,.480,83,220,.377,550,1098,.501,416,505,.824,104,266,370,400,88,152,22,127,1765,2008/2009
"Ruffin,Michael",2,7,.286,0,0,,2,7,.286,2,2,1.000,6,5,11,0,3,2,1,7,6,2008/2009
"Rush,Brandon",243,575,.423,78,209,.373,165,366,.451,46,66,.697,34,199,233,66,38,75,37,128,610,2008/2009
"Rush,Kareem",20,58,.345,10,33,.303,10,25,.400,4,4,1.000,0,15,15,15,5,10,1,10,54,2008/2009
"Salmons,John",516,1093,.472,126,302,.417,390,791,.493,288,347,.830,59,274,333,249,83,165,24,182,1446,2008/2009
"Salmons,John",351,744,.472,77,184,.418,274,560,.489,191,232,.823,43,178,221,196,58,122,9,122,970,2008/2009
"Salmons,John",165,349,.473,49,118,.415,116,231,.502,97,115,.843,16,96,112,53,25,43,15,60,476,2008/2009
"Samb,Cheikh",6,32,.188,0,3,.000,6,29,.207,3,7,.429,10,14,24,1,3,3,10,7,15,2008/2009
"Samb,Cheikh",2,13,.154,0,1,.000,2,12,.167,0,0,,2,7,9,1,2,2,5,4,4,2008/2009
"Samb,Cheikh",4,16,.250,0,2,.000,4,14,.286,3,5,.600,7,6,13,0,1,1,5,3,11,2008/2009
"Samb,Cheikh",0,3,.000,0,0,,0,3,.000,0,2,.000,1,1,2,0,0,0,0,0,0,2008/2009
"Scalabrine,Brian",48,114,.421,24,61,.393,24,53,.453,16,18,.889,7,43,50,18,7,12,10,73,136,2008/2009
"Scola,Luis",424,799,.531,0,3,.000,424,796,.533,196,258,.760,200,520,720,123,68,123,11,261,1044,2008/2009
"Sefolosha,Thabo",152,357,.426,24,87,.276,128,270,.474,61,73,.836,54,188,242,111,75,64,45,104,389,2008/2009
"Sefolosha,Thabo",79,182,.434,15,50,.300,64,132,.485,21,25,.840,26,97,123,65,35,37,19,50,194,2008/2009
"Sefolosha,Thabo",73,175,.417,9,37,.243,64,138,.464,40,48,.833,28,91,119,46,40,27,26,54,195,2008/2009
"Sene,Mouhamed",6,9,.667,0,0,,6,9,.667,8,10,.800,5,9,14,0,1,4,3,2,20,2008/2009
"Sene,Mouhamed",5,7,.714,0,0,,5,7,.714,7,9,.778,3,6,9,0,1,3,2,2,17,2008/2009
"Sene,Mouhamed",1,2,.500,0,0,,1,2,.500,1,1,1.000,2,3,5,0,0,1,1,0,3,2008/2009
"Sessions,Ramon",345,775,.445,6,34,.176,339,741,.457,281,354,.794,64,205,269,452,83,152,7,158,977,2008/2009
"Sharpe,Walter",4,11,.364,0,2,.000,4,9,.444,0,2,.000,0,3,3,0,0,0,2,3,8,2008/2009
"Simmons,Bobby",198,441,.449,117,262,.447,81,179,.453,43,58,.741,72,205,277,92,50,62,10,186,556,2008/2009
"Simmons,Cedric",11,25,.440,0,0,,11,25,.440,7,16,.438,5,11,16,2,1,2,4,8,29,2008/2009
"Simmons,Cedric",11,21,.524,0,0,,11,21,.524,6,14,.429,4,8,12,2,1,0,4,6,28,2008/2009
"Simmons,Cedric",0,4,.000,0,0,,0,4,.000,1,2,.500,1,3,4,0,0,2,0,2,1,2008/2009
"Sims,Courtney",3,6,.500,0,0,,3,6,.500,0,0,,2,2,4,0,0,1,0,1,6,2008/2009
"Sims,Courtney",0,0,,0,0,,0,0,,0,0,,0,0,0,0,0,1,0,0,0,2008/2009
"Sims,Courtney",3,6,.500,0,0,,3,6,.500,0,0,,2,2,4,0,0,0,0,1,6,2008/2009
"Singletary,Sean",31,85,.365,10,25,.400,21,60,.350,18,21,.857,10,25,35,29,11,23,0,45,90,2008/2009
"Singletary,Sean",12,37,.324,4,10,.400,8,27,.296,6,6,1.000,5,11,16,12,6,5,0,14,34,2008/2009
"Singletary,Sean",19,48,.396,6,15,.400,13,33,.394,12,15,.800,5,14,19,17,5,18,0,31,56,2008/2009
"Singleton,James",117,221,.529,13,40,.325,104,181,.575,67,78,.859,89,161,250,17,26,36,28,110,314,2008/2009
"Skinner,Brian",92,205,.449,0,2,.000,92,203,.453,30,47,.638,72,131,203,27,17,43,52,94,214,2008/2009
"Smith,Craig",289,514,.562,0,1,.000,289,513,.563,168,248,.677,98,186,284,79,31,105,19,184,746,2008/2009
"Smith,J.R.",424,950,.446,180,453,.397,244,497,.491,205,272,.754,43,254,297,227,78,150,14,190,1233,2008/2009
"Smith,Joe",156,333,.468,3,7,.429,153,326,.469,59,82,.720,89,174,263,41,17,25,40,122,374,2008/2009
"Smith,Joe",99,218,.454,2,4,.500,97,214,.453,38,54,.704,53,110,163,25,10,15,26,72,238,2008/2009
"Smith,Joe",57,115,.496,1,3,.333,56,112,.500,21,28,.750,36,64,100,16,7,10,14,50,136,2008/2009
"Smith,Josh",418,849,.492,26,87,.299,392,762,.514,211,359,.588,134,364,498,169,94,161,111,184,1073,2008/2009
"Solomon,Will",105,245,.429,28,86,.326,77,159,.484,25,34,.735,12,52,64,133,27,54,4,71,263,2008/2009
"Solomon,Will",79,181,.436,15,57,.263,64,124,.516,20,24,.833,9,34,43,123,20,49,4,60,193,2008/2009
"Solomon,Will",26,64,.406,13,29,.448,13,35,.371,5,10,.500,3,18,21,10,7,5,0,11,70,2008/2009
"Songaila,Darius",243,457,.532,0,1,.000,243,456,.533,80,90,.889,75,152,227,94,64,74,20,200,566,2008/2009
"Speights,Marreese",252,502,.502,2,8,.250,250,494,.506,102,132,.773,123,170,293,30,27,46,56,181,608,2008/2009
"Stackhouse,Jerry",16,60,.267,3,19,.158,13,41,.317,7,7,1.000,5,12,17,12,4,9,1,6,42,2008/2009
"Stevenson,DeShawn",72,231,.312,35,129,.271,37,102,.363,32,60,.533,11,65,76,98,21,32,2,43,211,2008/2009
"Stojaković,Peja",287,719,.399,145,384,.378,142,335,.424,93,104,.894,44,220,264,75,52,51,3,101,812,2008/2009
"Stoudemire,Amar'e",404,749,.539,3,7,.429,401,742,.540,323,387,.835,116,314,430,104,49,150,57,163,1134,2008/2009
"Stuckey,Rodney",401,913,.439,23,78,.295,378,835,.453,233,290,.803,69,206,275,387,78,173,11,217,1058,2008/2009
"Swift,Robert",37,71,.521,0,0,,37,71,.521,12,16,.750,21,68,89,9,5,8,17,50,86,2008/2009
"Swift,Stromile",24,56,.429,1,1,1.000,23,55,.418,13,26,.500,16,30,46,3,4,16,8,40,62,2008/2009
"Swift,Stromile",9,15,.600,0,0,,9,15,.600,5,11,.455,5,8,13,1,0,7,2,15,23,2008/2009
"Swift,Stromile",15,41,.366,1,1,1.000,14,40,.350,8,15,.533,11,22,33,2,4,9,6,25,39,2008/2009
"Szczerbiak,Wally",179,398,.450,69,168,.411,110,230,.478,90,106,.849,43,189,232,82,28,55,10,130,517,2008/2009
"Taylor,Mike",110,267,.412,13,40,.325,97,227,.427,56,81,.691,22,65,87,106,36,73,0,84,289,2008/2009
"Telfair,Sebastian",267,697,.383,73,211,.346,194,486,.399,131,160,.819,32,95,127,343,73,146,12,184,738,2008/2009
"Terry,Jason",541,1168,.463,167,456,.366,374,712,.525,198,225,.880,39,138,177,251,97,119,20,141,1447,2008/2009
"Thomas,Etan",32,66,.485,0,0,,32,66,.485,16,23,.696,25,41,66,6,3,18,18,35,80,2008/2009
"Thomas,Kenny",3,8,.375,0,0,,3,8,.375,0,0,,4,11,15,1,6,1,1,9,6,2008/2009
"Thomas,Kurt",153,304,.503,0,2,.000,153,302,.507,37,45,.822,134,271,405,66,34,42,58,170,343,2008/2009
"Thomas,Tim",189,438,.432,78,189,.413,111,249,.446,89,121,.736,42,159,201,68,31,70,11,144,545,2008/2009
"Thomas,Tim",34,90,.378,6,20,.300,28,70,.400,21,34,.618,14,32,46,10,3,14,1,26,95,2008/2009
"Thomas,Tim",119,258,.461,53,126,.421,66,132,.500,54,67,.806,20,93,113,46,22,46,10,91,345,2008/2009
"Thomas,Tim",36,90,.400,19,43,.442,17,47,.362,14,20,.700,8,34,42,12,6,10,0,27,105,2008/2009
"Thomas,Tyrus",308,683,.451,3,9,.333,305,674,.453,238,304,.783,148,360,508,77,91,129,151,220,857,2008/2009
"Thompson,Jason",356,717,.497,0,8,.000,356,709,.502,198,286,.692,234,372,606,93,46,146,59,314,910,2008/2009
"Thornton,Al",469,1051,.446,20,79,.253,449,972,.462,236,313,.754,122,246,368,103,59,130,62,227,1194,2008/2009
"Tolliver,Anthony",19,65,.292,9,41,.220,10,24,.417,5,10,.500,12,29,41,17,5,7,1,16,52,2008/2009
"Tucker,Alando",52,121,.430,8,23,.348,44,98,.449,26,33,.788,19,12,31,12,5,14,1,14,138,2008/2009
"Turiaf,Ronny",186,366,.508,0,3,.000,186,363,.512,98,124,.790,88,272,360,166,34,70,168,243,470,2008/2009
"Türkoğlu,Hedo",423,1025,.413,134,376,.356,289,649,.445,314,389,.807,45,365,410,375,64,204,19,218,1294,2008/2009
"Udoka,Ime",110,287,.383,41,125,.328,69,162,.426,28,46,.609,28,159,187,54,36,38,12,86,289,2008/2009
"Udrih,Beno",321,696,.461,35,113,.310,286,583,.491,123,150,.820,46,174,220,342,81,158,12,192,800,2008/2009
"Ukić,Roko",123,324,.380,11,62,.177,112,262,.427,44,60,.733,27,48,75,153,30,60,2,77,301,2008/2009
"Varejão,Anderson",270,504,.536,0,2,.000,270,502,.538,154,250,.616,166,415,581,81,75,80,66,239,694,2008/2009
"Vaughn,Jacque",24,75,.320,1,1,1.000,23,74,.311,16,18,.889,4,18,22,55,6,15,0,26,65,2008/2009
"Villanueva,Charlie",487,1089,.447,89,258,.345,398,831,.479,201,240,.838,154,366,520,137,50,138,56,254,1264,2008/2009
"Voskuhl,Jake",12,45,.267,0,0,,12,45,.267,11,14,.786,21,38,59,8,3,17,4,60,35,2008/2009
"Vujačić,Sasha",155,401,.387,81,223,.363,74,178,.416,70,76,.921,19,116,135,113,77,35,7,154,461,2008/2009
"Wade,Dwyane",854,1739,.491,88,278,.317,766,1461,.524,590,771,.765,89,309,398,589,173,272,106,178,2386,2008/2009
"Wafer,Von",229,512,.447,64,164,.390,165,348,.474,88,117,.752,19,94,113,71,40,59,8,71,610,2008/2009
"Walker,Henry",36,58,.621,0,1,.000,36,57,.632,16,23,.696,8,21,29,13,6,18,2,51,88,2008/2009
"Wallace,Ben",69,155,.445,0,0,,69,155,.445,27,64,.422,136,226,362,44,48,34,75,82,165,2008/2009
"Wallace,Gerald",389,811,.480,39,131,.298,350,680,.515,365,454,.804,112,441,553,189,121,148,67,210,1182,2008/2009
"Wallace,Rasheed",302,720,.419,113,319,.354,189,401,.471,78,101,.772,56,434,490,91,62,59,86,197,795,2008/2009
"Walton,Luke",134,307,.436,17,57,.298,117,250,.468,41,57,.719,55,125,180,177,32,69,10,105,326,2008/2009
"Warrick,Hakim",340,693,.491,5,23,.217,335,670,.500,266,374,.711,129,277,406,66,48,98,39,170,951,2008/2009
"Watson,C.J.",257,562,.457,48,120,.400,209,442,.473,168,193,.870,39,153,192,206,96,92,4,137,730,2008/2009
"Watson,Earl",174,453,.384,20,85,.235,154,368,.418,80,106,.755,36,147,183,391,50,156,11,137,448,2008/2009
"Weaver,Kyle",113,246,.459,32,93,.344,81,153,.529,41,58,.707,31,99,130,101,47,69,25,81,299,2008/2009
"Webster,Martell",0,1,.000,0,1,.000,0,0,,0,0,,0,0,0,0,0,0,0,0,0,2008/2009
"Weems,Sonny",8,25,.320,0,3,.000,8,22,.364,3,8,.375,0,4,4,3,1,6,0,8,19,2008/2009
"West,David",610,1292,.472,6,25,.240,604,1267,.477,367,415,.884,160,486,646,173,49,163,68,207,1593,2008/2009
"West,Delonte",285,624,.457,91,228,.399,194,396,.490,90,108,.833,31,172,203,226,94,92,13,125,751,2008/2009
"West,Mario",14,34,.412,1,1,1.000,13,33,.394,14,30,.467,24,32,56,19,18,13,4,35,43,2008/2009
"Westbrook,Russell",436,1095,.398,35,129,.271,401,966,.415,349,428,.815,178,221,399,435,110,274,16,191,1256,2008/2009
"White,D.J.",26,50,.520,0,0,,26,50,.520,10,13,.769,10,22,32,6,3,3,5,10,62,2008/2009
"White,James",3,5,.600,1,2,.500,2,3,.667,0,0,,0,0,0,1,1,3,1,2,7,2008/2009
"Wilcox,Chris",184,370,.497,0,4,.000,184,366,.503,79,140,.564,96,181,277,47,26,75,16,137,447,2008/2009
"Wilcox,Chris",130,268,.485,0,3,.000,130,265,.491,52,87,.598,65,130,195,33,18,55,11,89,312,2008/2009
"Wilcox,Chris",54,102,.529,0,1,.000,54,101,.535,27,53,.509,31,51,82,14,8,20,5,48,135,2008/2009
"Wilkins,Damien",77,213,.362,27,72,.375,50,141,.355,37,46,.804,20,50,70,37,22,37,7,55,218,2008/2009
"Williams,Deron",463,984,.471,70,226,.310,393,758,.518,326,384,.849,24,171,195,725,73,228,20,134,1322,2008/2009
"Williams,Jawad",5,12,.417,2,6,.333,3,6,.500,0,0,,1,1,2,0,1,1,0,2,12,2008/2009
"Williams,Lou",336,844,.398,63,220,.286,273,624,.438,304,385,.790,36,129,165,242,85,151,14,128,1039,2008/2009
"Williams,Marcus",4,17,.235,2,6,.333,2,11,.182,2,6,.333,0,4,4,13,1,4,1,6,12,2008/2009
"Williams,Marcus",2,2,1.000,0,0,,2,2,1.000,0,0,,0,0,0,0,0,0,0,1,4,2008/2009
"Williams,Marvin",285,622,.458,55,155,.355,230,467,.493,220,273,.806,110,272,382,81,57,70,39,127,845,2008/2009
"Williams,Mo",526,1126,.467,183,420,.436,343,706,.486,208,228,.912,47,232,279,329,69,179,9,215,1443,2008/2009
"Williams,Sean",30,72,.417,0,0,,30,72,.417,20,32,.625,34,45,79,13,7,20,29,72,80,2008/2009
"Williams,Shawne",16,56,.286,1,17,.059,15,39,.385,9,11,.818,19,27,46,2,2,5,9,19,42,2008/2009
"Williams,Shelden",70,157,.446,0,2,.000,70,155,.452,46,63,.730,49,104,153,12,22,34,18,64,186,2008/2009
"Williams,Shelden",40,89,.449,0,2,.000,40,87,.460,32,42,.762,25,53,78,8,12,26,10,36,112,2008/2009
"Williams,Shelden",30,68,.441,0,0,,30,68,.441,14,21,.667,24,51,75,4,10,8,8,28,74,2008/2009
"World Peace,Metta",416,1037,.401,153,383,.399,263,654,.402,196,262,.748,65,294,359,229,105,140,24,155,1181,2008/2009
"Wright,Antoine",179,431,.415,45,149,.302,134,282,.475,71,95,.747,31,105,136,77,46,54,27,172,474,2008/2009
"Wright,Brandan",130,246,.528,0,4,.000,130,242,.537,63,85,.741,62,95,157,21,22,23,37,74,323,2008/2009
"Wright,Dorell",8,20,.400,0,0,,8,20,.400,2,6,.333,2,18,20,2,2,6,0,8,18,2008/2009
"Wright,Julian",109,234,.466,2,21,.095,107,213,.502,17,30,.567,46,106,152,43,35,43,19,49,237,2008/2009
"Wright,Lorenzen",10,27,.370,0,0,,10,27,.370,3,8,.375,7,18,25,3,4,9,5,17,23,2008/2009
"Young,Nick",336,756,.444,56,164,.341,280,592,.473,164,193,.850,31,119,150,95,39,92,20,140,892,2008/2009
"Young,Thaddeus",475,960,.495,56,164,.341,419,796,.526,139,189,.735,139,238,377,86,100,118,23,165,1145,2008/2009
"Yue,Sun",3,11,.273,0,6,.000,3,5,.600,0,0,,0,0,0,2,1,3,1,10,6,2008/2009
"Afflalo,Arron",272,585,.465,108,249,.434,164,336,.488,72,98,.735,59,193,252,138,46,74,30,225,724,2009/2010
"Ajinça,Alexis",5,10,.500,0,0,,5,10,.500,0,1,.000,1,3,4,0,1,2,1,5,10,2009/2010
"Aldridge,LaMarcus",579,1169,.495,5,16,.313,574,1153,.498,230,304,.757,192,435,627,160,67,104,48,231,1393,2009/2010
"Alexander,Joe",1,6,.167,0,1,.000,1,5,.200,2,3,.667,2,3,5,2,1,0,1,9,4,2009/2010
"Allen,Malik",46,116,.397,1,6,.167,45,110,.409,12,13,.923,36,46,82,16,11,22,5,68,105,2009/2010
"Allen,Ray",464,973,.477,145,399,.363,319,574,.556,231,253,.913,45,208,253,210,64,129,25,182,1304,2009/2010
"Allen,Tony",129,253,.510,0,5,.000,129,248,.520,72,119,.605,52,93,145,72,59,66,19,109,330,2009/2010
"Alston,Rafer",155,446,.348,58,168,.345,97,278,.349,59,81,.728,13,116,129,176,50,95,10,103,427,2009/2010
"Alston,Rafer",95,277,.343,28,87,.322,67,190,.353,44,54,.815,9,66,75,104,27,61,5,50,262,2009/2010
"Alston,Rafer",60,169,.355,30,81,.370,30,88,.341,15,27,.556,4,50,54,72,23,34,5,53,165,2009/2010
"Amundson,Lou",152,276,.551,0,1,.000,152,275,.553,67,123,.545,128,218,346,31,24,57,73,169,371,2009/2010
"Andersen,Chris",142,251,.566,0,3,.000,142,248,.573,164,236,.695,147,336,483,33,42,59,143,171,448,2009/2010
"Andersen,David",147,340,.432,27,78,.346,120,262,.458,46,67,.687,54,154,208,44,15,37,12,119,367,2009/2010
"Anderson,Antonio",1,3,.333,0,0,,1,3,.333,0,0,,1,0,1,0,0,1,0,1,2,2009/2010
"Anderson,Ryan",169,388,.436,78,211,.370,91,177,.514,71,82,.866,70,132,202,37,25,56,14,81,487,2009/2010
"Anthony,Carmelo",688,1502,.458,59,187,.316,629,1315,.478,508,612,.830,152,302,454,222,88,209,30,225,1943,2009/2010
"Anthony,Joel",76,159,.478,0,0,,76,159,.478,66,92,.717,123,126,249,12,20,45,109,158,218,2009/2010
"Arenas,Gilbert",253,616,.411,63,181,.348,190,435,.437,153,207,.739,17,116,133,230,41,117,9,95,722,2009/2010
"Ariza,Trevor",394,999,.394,136,407,.334,258,592,.436,148,228,.649,78,325,403,276,126,161,40,162,1072,2009/2010
"Armstrong,Hilton",28,79,.354,0,1,.000,28,78,.359,15,32,.469,27,54,81,21,15,22,12,59,71,2009/2010
"Armstrong,Hilton",19,50,.380,0,0,,19,50,.380,13,28,.464,17,44,61,16,8,13,8,44,51,2009/2010
"Armstrong,Hilton",4,12,.333,0,0,,4,12,.333,2,2,1.000,5,9,14,2,2,4,4,5,10,2009/2010
"Armstrong,Hilton",5,17,.294,0,1,.000,5,16,.313,0,2,.000,5,1,6,3,5,5,0,10,10,2009/2010
"Arroyo,Carlos",178,375,.475,7,25,.280,171,350,.489,76,90,.844,26,104,130,225,36,54,6,102,439,2009/2010
"Arthur,Darrell",63,146,.432,0,1,.000,63,145,.434,17,30,.567,37,73,110,15,14,22,14,60,143,2009/2010
"Atkins,Chucky",57,157,.363,22,73,.301,35,84,.417,25,27,.926,5,24,29,91,17,32,0,53,161,2009/2010
"Augustin,D.J.",168,435,.386,70,178,.393,98,257,.381,102,131,.779,11,86,97,193,45,74,5,127,508,2009/2010
"Ayres,Jeff",43,65,.662,0,0,,43,65,.662,18,20,.900,25,73,98,1,7,12,16,76,104,2009/2010
"Azubuike,Kelenna",48,88,.545,10,27,.370,38,61,.623,19,28,.679,12,29,41,10,5,7,9,16,125,2009/2010
"Balkman,Renaldo",6,18,.333,0,7,.000,6,11,.545,2,6,.333,4,19,23,7,8,6,2,16,14,2009/2010
"Banks,Marcus",39,73,.534,7,24,.292,32,49,.653,24,29,.828,3,20,23,26,12,20,2,30,109,2009/2010
"Barbosa,Leandro",155,365,.425,44,136,.324,111,229,.485,64,73,.877,11,58,69,64,23,46,12,71,418,2009/2010
"Barea,J.J.",232,527,.440,56,157,.357,176,370,.476,76,90,.844,17,129,146,258,35,102,6,119,596,2009/2010
"Bargnani,Andrea",537,1143,.470,121,325,.372,416,818,.509,181,234,.774,105,388,493,93,25,120,111,215,1376,2009/2010
"Barnes,Matt",271,557,.487,66,207,.319,205,350,.586,108,146,.740,106,339,445,134,59,112,30,185,716,2009/2010
"Barron,Earl",30,68,.441,0,0,,30,68,.441,22,29,.759,31,46,77,8,4,11,4,24,82,2009/2010
"Bass,Brandon",119,233,.511,0,0,,119,233,.511,52,63,.825,54,73,127,19,12,31,27,69,290,2009/2010
"Battie,Tony",14,40,.350,1,4,.250,13,36,.361,7,10,.700,4,19,23,3,4,3,2,19,36,2009/2010
"Battier,Shane",178,447,.398,101,279,.362,77,168,.458,77,106,.726,74,238,312,164,53,64,76,139,534,2009/2010
"Batum,Nicolas",139,268,.519,54,132,.409,85,136,.625,43,51,.843,32,109,141,44,24,27,25,83,375,2009/2010
"Bayless,Jerryd",200,483,.414,29,92,.315,171,391,.437,201,242,.831,18,102,120,172,26,94,5,152,630,2009/2010
"Beasley,Michael",468,1040,.450,28,102,.275,440,938,.469,192,240,.800,123,375,498,100,80,131,49,221,1156,2009/2010
"Beaubois,Rodrigue",155,299,.518,45,110,.409,110,189,.582,42,52,.808,12,66,78,74,29,54,12,84,397,2009/2010
"Belinelli,Marco",154,379,.406,60,158,.380,94,221,.425,101,121,.835,14,81,95,89,42,60,5,80,469,2009/2010
"Bell,Charlie",169,443,.381,73,200,.365,96,243,.395,48,67,.716,31,101,132,104,39,54,12,136,459,2009/2010
"Bell,Raja",28,61,.459,12,27,.444,16,34,.471,3,3,1.000,5,18,23,13,4,5,2,15,71,2009/2010
"Bell,Raja",24,55,.436,9,24,.375,15,31,.484,3,3,1.000,5,16,21,10,4,5,2,13,60,2009/2010
"Bell,Raja",4,6,.667,3,3,1.000,1,3,.333,0,0,,0,2,2,3,0,0,0,2,11,2009/2010
"Bender,Jonathan",40,100,.400,14,39,.359,26,61,.426,24,26,.923,15,37,52,16,2,28,17,33,118,2009/2010
"Bibby,Mike",268,644,.416,126,324,.389,142,320,.444,68,79,.861,20,164,184,310,67,90,3,157,730,2009/2010
"Biedriņš,Andris",81,137,.591,0,0,,81,137,.591,4,25,.160,63,196,259,57,20,32,44,117,166,2009/2010
"Billups,Chauncey",402,962,.418,157,407,.386,245,555,.441,466,512,.910,25,203,228,409,82,177,9,153,1427,2009/2010
"Blair,DeJuan",275,495,.556,0,2,.000,275,493,.558,88,161,.547,200,326,526,65,50,112,39,224,638,2009/2010
"Blake,Steve",217,522,.416,116,294,.395,101,228,.443,36,48,.750,21,166,187,380,58,128,6,123,586,2009/2010
"Blake,Steve",143,355,.403,78,207,.377,65,148,.439,24,32,.750,15,103,118,203,37,65,2,84,388,2009/2010
"Blake,Steve",74,167,.443,38,87,.437,36,80,.450,12,16,.750,6,63,69,177,21,63,4,39,198,2009/2010
"Blatche,Andray",478,999,.478,13,44,.295,465,955,.487,174,234,.744,158,351,509,170,85,182,71,218,1143,2009/2010
"Bogans,Keith",120,298,.403,70,196,.357,50,102,.490,37,50,.740,25,151,176,95,45,53,12,156,347,2009/2010
"Bogut,Andrew",473,910,.520,0,2,.000,473,908,.521,149,237,.629,208,493,701,127,39,131,175,222,1095,2009/2010
"Bonner,Matt",166,372,.446,90,231,.390,76,141,.539,35,48,.729,52,162,214,68,30,39,24,109,457,2009/2010
"Boone,Josh",117,223,.525,0,0,,117,223,.525,19,58,.328,124,191,315,29,30,37,48,111,253,2009/2010
"Boozer,Carlos",617,1098,.562,0,0,,617,1098,.562,285,384,.742,181,693,874,247,84,212,36,270,1519,2009/2010
"Bosh,Chris",600,1158,.518,8,22,.364,592,1136,.521,470,590,.797,205,554,759,166,43,169,68,170,1678,2009/2010
"Bowen,Ryan",1,1,1.000,0,0,,1,1,1.000,2,2,1.000,1,1,2,0,1,0,0,2,4,2009/2010
"Boykins,Earl",172,403,.427,19,60,.317,153,343,.446,77,89,.865,17,58,75,171,24,69,3,48,440,2009/2010
"Brand,Elton",412,858,.480,0,1,.000,412,857,.481,172,233,.738,179,282,461,109,82,131,80,232,996,2009/2010
"Brewer,Corey",409,949,.431,82,237,.346,327,712,.459,166,256,.648,70,209,279,193,117,164,29,224,1066,2009/2010
"Brewer,Ronnie",209,429,.487,8,31,.258,201,398,.505,85,133,.639,45,142,187,154,91,53,15,80,511,2009/2010
"Brewer,Ronnie",206,416,.495,8,31,.258,198,385,.514,81,128,.633,44,136,180,151,85,51,15,80,501,2009/2010
"Brewer,Ronnie",3,13,.231,0,0,,3,13,.231,4,5,.800,1,6,7,3,6,2,0,0,10,2009/2010
"Brezec,Primož",9,26,.346,0,0,,9,26,.346,1,6,.167,12,13,25,1,1,2,3,19,19,2009/2010
"Brezec,Primož",2,13,.154,0,0,,2,13,.154,1,2,.500,6,6,12,0,1,0,1,9,5,2009/2010
"Brezec,Primož",7,13,.538,0,0,,7,13,.538,0,4,.000,6,7,13,1,0,2,2,10,14,2009/2010
"Brockman,Jon",55,103,.534,0,0,,55,103,.534,37,62,.597,105,108,213,22,15,23,5,115,147,2009/2010
"Brooks,Aaron",575,1331,.432,209,525,.398,366,806,.454,245,298,.822,54,161,215,434,69,232,14,199,1604,2009/2010
"Brown,Bobby",88,237,.371,26,98,.265,62,139,.446,13,15,.867,9,29,38,88,15,46,1,42,215,2009/2010
"Brown,Bobby",60,152,.395,17,66,.258,43,86,.500,8,8,1.000,1,17,18,46,9,24,1,28,145,2009/2010
"Brown,Bobby",28,85,.329,9,32,.281,19,53,.358,5,7,.714,8,12,20,42,6,22,0,14,70,2009/2010
"Brown,Derrick",68,147,.463,2,7,.286,66,140,.471,48,72,.667,31,47,78,19,21,19,10,53,186,2009/2010
"Brown,Devin",136,361,.377,58,164,.354,78,197,.396,69,86,.802,29,95,124,65,33,62,6,72,399,2009/2010
"Brown,Devin",128,325,.394,54,147,.367,74,178,.416,69,86,.802,27,82,109,58,30,57,5,62,379,2009/2010
"Brown,Devin",8,36,.222,4,17,.235,4,19,.211,0,0,,2,13,15,7,3,5,1,10,20,2009/2010
"Brown,Kwame",62,124,.500,0,1,.000,62,123,.504,33,98,.337,53,124,177,22,15,43,12,93,157,2009/2010
"Brown,Shannon",253,592,.427,62,189,.328,191,403,.474,99,121,.818,30,153,183,108,57,67,31,129,667,2009/2010
"Bryant,Kobe",716,1569,.456,99,301,.329,617,1268,.487,439,541,.811,78,313,391,365,113,233,20,187,1970,2009/2010
"Budinger,Chase",249,565,.441,92,249,.369,157,316,.497,67,87,.770,38,182,220,88,34,48,11,85,657,2009/2010
"Butler,Caron",450,1051,.428,42,145,.290,408,906,.450,264,315,.838,104,357,461,156,116,160,24,193,1206,2009/2010
"Butler,Caron",293,694,.422,25,95,.263,268,599,.447,185,211,.877,68,248,316,107,68,113,15,126,796,2009/2010
"Butler,Caron",157,357,.440,17,50,.340,140,307,.456,79,104,.760,36,109,145,49,48,47,9,67,410,2009/2010
"Butler,Rasual",356,870,.409,145,432,.336,211,438,.482,122,145,.841,39,201,240,116,36,79,68,121,979,2009/2010
"Bynum,Andrew",392,688,.570,0,1,.000,392,687,.571,193,261,.739,177,364,541,68,35,115,94,193,977,2009/2010
"Bynum,Will",237,534,.444,12,55,.218,225,479,.470,142,178,.798,24,118,142,283,55,115,7,143,628,2009/2010
"Calderón,José",274,568,.482,68,171,.398,206,397,.519,83,104,.798,23,119,142,404,47,99,7,135,699,2009/2010
"Camby,Marcus",238,501,.475,2,7,.286,236,494,.478,78,122,.639,249,622,871,186,95,91,146,161,556,2009/2010
"Camby,Marcus",166,356,.466,2,6,.333,164,350,.469,60,91,.659,166,450,616,151,69,64,99,105,394,2009/2010
"Camby,Marcus",72,145,.497,0,1,.000,72,144,.500,18,31,.581,83,172,255,35,26,27,47,56,162,2009/2010
"Cardinal,Brian",14,36,.389,3,9,.333,11,27,.407,17,18,.944,7,22,29,24,9,7,3,56,48,2009/2010
"Carney,Rodney",113,282,.401,41,135,.304,72,147,.490,52,63,.825,26,111,137,37,25,21,20,79,319,2009/2010
"Carroll,DeMarre",88,222,.396,0,6,.000,88,216,.407,33,53,.623,53,97,150,33,28,24,9,107,209,2009/2010
"Carroll,Matt",18,50,.360,4,19,.211,14,31,.452,6,6,1.000,4,8,12,6,5,7,0,13,46,2009/2010
"Carter,Anthony",76,181,.420,17,63,.270,59,118,.500,11,13,.846,17,72,89,160,39,58,13,72,180,2009/2010
"Carter,Vince",434,1015,.428,119,324,.367,315,691,.456,257,306,.840,33,260,293,236,53,106,18,189,1244,2009/2010
"Casspi,Omri",300,672,.446,75,203,.369,225,469,.480,117,174,.672,75,274,349,95,54,98,17,125,792,2009/2010
"Chalmers,Mario",182,454,.401,75,236,.318,107,218,.491,82,110,.745,25,110,135,246,91,123,12,175,521,2009/2010
"Chandler,Tyson",109,190,.574,0,0,,109,190,.574,115,157,.732,114,206,320,16,17,91,55,138,333,2009/2010
"Chandler,Wilson",412,860,.479,40,150,.267,372,710,.524,129,160,.806,93,255,348,138,46,108,49,184,993,2009/2010
"Clark,Earl",56,151,.371,2,5,.400,54,146,.370,26,36,.722,18,44,62,21,7,23,13,25,140,2009/2010
"Collins,Jarron",12,31,.387,0,0,,12,31,.387,10,25,.400,22,40,62,6,2,10,3,42,34,2009/2010
"Collins,Jason",8,23,.348,0,1,.000,8,22,.364,0,2,.000,5,9,14,4,3,5,2,21,16,2009/2010
"Collins,Mardy",47,128,.367,4,17,.235,43,111,.387,13,21,.619,13,37,50,44,23,32,1,45,111,2009/2010
"Collison,Darren",376,789,.477,46,115,.400,330,674,.490,148,174,.851,41,151,192,432,78,202,4,92,946,2009/2010
"Collison,Nick",182,309,.589,1,4,.250,181,305,.593,74,107,.692,152,232,384,38,37,63,48,230,439,2009/2010
"Conley,Mike",369,830,.445,82,212,.387,287,618,.464,139,187,.743,30,161,191,425,109,170,12,178,959,2009/2010
"Conroy,Will",3,10,.300,0,3,.000,3,7,.429,0,2,.000,0,3,3,7,0,4,0,5,6,2009/2010
"Cook,Brian",7,23,.304,2,9,.222,5,14,.357,5,7,.714,1,8,9,1,0,6,2,5,21,2009/2010
"Cook,Daequan",81,253,.320,40,126,.317,41,127,.323,21,25,.840,9,73,82,43,14,24,10,50,223,2009/2010
"Crawford,Jamal",496,1105,.449,163,427,.382,333,678,.491,270,315,.857,34,167,201,238,61,137,12,132,1425,2009/2010
"Cunningham,Dante",106,214,.495,0,2,.000,106,212,.500,31,48,.646,54,106,160,14,24,15,22,97,243,2009/2010
"Curry,Eddy",8,21,.381,0,0,,8,21,.381,10,17,.588,4,9,13,0,0,13,1,13,26,2009/2010
"Curry,JamesOn",0,0,,0,0,,0,0,,0,0,,0,0,0,0,0,0,0,0,0,2009/2010
"Curry,Stephen",528,1143,.462,166,380,.437,362,763,.474,177,200,.885,48,308,356,472,152,243,19,252,1399,2009/2010
"Dalembert,Samuel",285,523,.545,0,0,,285,523,.545,97,133,.729,239,545,784,64,42,123,151,252,667,2009/2010
"Dampier,Erick",133,213,.624,1,3,.333,132,210,.629,61,101,.604,128,272,400,31,15,61,77,153,328,2009/2010
"Daniels,Marquis",124,249,.498,6,28,.214,118,221,.534,34,56,.607,27,68,95,66,27,42,6,91,288,2009/2010
"Davis,Baron",412,1015,.406,82,296,.277,330,719,.459,239,291,.821,52,214,266,598,126,211,43,210,1145,2009/2010
"Davis,Glen",122,279,.437,0,4,.000,122,275,.444,96,138,.696,101,104,205,35,21,53,14,132,340,2009/2010
"Davis,Paul",2,4,.500,0,0,,2,4,.500,1,2,.500,0,0,0,3,0,0,1,0,5,2009/2010
"Davis,Ricky",62,143,.434,16,42,.381,46,101,.455,18,31,.581,10,47,57,39,11,29,3,39,158,2009/2010
"Daye,Austin",137,295,.464,29,95,.305,108,200,.540,46,56,.821,34,140,174,34,25,48,26,114,349,2009/2010
"Delfino,Carlos",299,732,.408,134,365,.367,165,367,.450,93,119,.782,51,343,394,202,80,119,21,138,825,2009/2010
"Deng,Luol",473,1014,.466,32,83,.386,441,931,.474,252,330,.764,131,381,512,143,66,134,61,129,1230,2009/2010
"DeRozan,DeMar",255,512,.498,4,16,.250,251,496,.506,148,194,.763,66,157,223,53,43,62,18,176,662,2009/2010
"Diaw,Boris",373,773,.483,66,206,.320,307,567,.541,113,147,.769,131,293,424,325,60,178,57,219,925,2009/2010
"Diawara,Yakhouba",2,10,.200,1,6,.167,1,4,.250,0,0,,1,3,4,3,1,3,0,8,5,2009/2010
"Diener,Travis",2,10,.200,1,7,.143,1,3,.333,1,4,.250,0,3,3,8,4,0,0,2,6,2009/2010
"Diener,Travis",1,6,.167,1,5,.200,0,1,.000,0,2,.000,0,2,2,4,3,0,0,1,3,2009/2010
"Diener,Travis",1,4,.250,0,2,.000,1,2,.500,1,2,.500,0,1,1,4,1,0,0,1,3,2009/2010
"Diop,DeSagana",15,29,.517,0,0,,15,29,.517,2,9,.222,24,41,65,5,5,12,14,31,32,2009/2010
"Dooling,Keyon",129,324,.398,59,157,.376,70,167,.419,47,61,.770,8,46,54,135,34,59,0,82,364,2009/2010
"Dorsey,Joey",9,20,.450,0,0,,9,20,.450,5,12,.417,16,27,43,2,3,6,2,21,23,2009/2010
"Dorsey,Joey",5,11,.455,0,0,,5,11,.455,1,2,.500,11,14,25,2,2,4,1,12,11,2009/2010
"Dorsey,Joey",4,9,.444,0,0,,4,9,.444,4,10,.400,5,13,18,0,1,2,1,9,12,2009/2010
"Douglas,Toney",179,391,.458,68,175,.389,111,216,.514,55,68,.809,40,68,108,112,42,55,3,116,481,2009/2010
"Douglas-Roberts,Chris",255,573,.445,14,54,.259,241,519,.464,133,157,.847,45,153,198,93,55,97,19,101,657,2009/2010
"Dragić,Goran",222,491,.452,74,188,.394,148,303,.488,117,159,.736,38,133,171,241,48,126,8,131,635,2009/2010
"Dudley,Jared",225,490,.459,120,262,.458,105,228,.461,104,138,.754,99,182,281,115,81,68,16,162,674,2009/2010
"Duhon,Chris",168,451,.373,90,258,.349,78,193,.404,68,95,.716,28,150,178,378,59,110,3,83,494,2009/2010
"Duncan,Tim",561,1082,.518,2,11,.182,559,1071,.522,271,374,.725,221,567,788,246,45,140,117,152,1395,2009/2010
"Dunleavy,Mike",229,558,.410,75,236,.318,154,322,.478,133,158,.842,25,211,236,103,38,72,15,105,666,2009/2010
"Durant,Kevin",794,1668,.476,128,351,.365,666,1317,.506,756,840,.900,105,518,623,231,112,271,84,171,2472,2009/2010
"Ellington,Wayne",190,448,.424,64,162,.395,126,286,.441,61,70,.871,33,126,159,74,20,74,5,72,505,2009/2010
"Ellis,Monta",631,1406,.449,77,228,.338,554,1178,.470,292,388,.753,47,210,257,340,143,244,25,189,1631,2009/2010
"Elson,Francisco",5,15,.333,0,0,,5,15,.333,2,5,.400,6,8,14,2,1,1,0,7,12,2009/2010
"Elson,Francisco",4,13,.308,0,0,,4,13,.308,2,2,1.000,5,8,13,2,1,1,0,7,10,2009/2010
"Elson,Francisco",1,2,.500,0,0,,1,2,.500,0,3,.000,1,0,1,0,0,0,0,0,2,2009/2010
"Evans,Maurice",175,393,.445,57,169,.337,118,224,.527,46,61,.754,59,95,154,48,34,20,17,125,453,2009/2010
"Evans,Reggie",34,69,.493,0,0,,34,69,.493,27,60,.450,30,75,105,8,14,22,4,44,95,2009/2010
"Evans,Tyreke",533,1165,.458,36,141,.255,497,1024,.485,348,465,.748,66,314,380,414,109,216,26,204,1450,2009/2010
"Farmar,Jordan",224,515,.435,86,229,.376,138,286,.483,57,85,.671,14,117,131,127,52,72,11,109,591,2009/2010
"Felton,Raymond",388,846,.459,60,156,.385,328,690,.475,132,173,.763,53,235,288,446,123,168,22,172,968,2009/2010
"Fernández,Rudy",160,423,.378,98,266,.368,62,157,.395,85,98,.867,35,129,164,127,62,72,11,87,503,2009/2010
"Fesenko,Kyrylo",52,95,.547,0,1,.000,52,94,.553,24,57,.421,33,57,90,15,6,24,19,78,128,2009/2010
"Finley,Michael",81,184,.440,32,82,.390,49,102,.480,8,15,.533,6,65,71,43,10,21,6,33,202,2009/2010
"Finley,Michael",37,97,.381,13,41,.317,24,56,.429,6,9,.667,5,33,38,19,6,13,4,12,93,2009/2010
"Finley,Michael",44,87,.506,19,41,.463,25,46,.543,2,6,.333,1,32,33,24,4,8,2,21,109,2009/2010
"Fisher,Derek",212,558,.380,78,224,.348,134,334,.401,113,132,.856,25,145,170,201,90,78,9,202,615,2009/2010
"Flynn,Jonny",397,952,.417,77,215,.358,320,737,.434,223,270,.826,24,167,191,356,82,233,2,98,1094,2009/2010
"Ford,T.J.",186,418,.445,8,50,.160,178,368,.484,104,135,.770,41,108,149,180,44,90,11,102,484,2009/2010
"Foster,Jeff",22,46,.478,0,1,.000,22,45,.489,5,9,.556,34,47,81,21,3,14,4,45,49,2009/2010
"Foye,Randy",256,619,.414,63,182,.346,193,437,.442,129,145,.890,16,114,130,228,33,94,10,123,704,2009/2010
"Frye,Channing",317,703,.451,172,392,.439,145,311,.466,98,121,.810,66,361,427,113,64,73,74,263,904,2009/2010
"Gadzuric,Dan",39,89,.438,0,0,,39,89,.438,10,25,.400,38,54,92,12,9,15,13,63,88,2009/2010
"Gaines,Sundiata",38,82,.463,7,26,.269,31,56,.554,23,46,.500,6,23,29,39,12,14,0,17,106,2009/2010
"Gallinari,Danilo",392,927,.423,186,488,.381,206,439,.469,251,307,.818,65,333,398,135,75,110,58,191,1221,2009/2010
"García,Francisco",82,176,.466,23,59,.390,59,117,.504,15,17,.882,11,55,66,45,10,21,19,49,202,2009/2010
"Garnett,Kevin",402,772,.521,1,5,.200,401,767,.523,185,221,.837,78,428,506,185,68,101,57,170,990,2009/2010
"Gasol,Marc",378,651,.581,0,1,.000,378,650,.582,252,376,.670,208,432,640,165,69,135,109,254,1008,2009/2010
"Gasol,Pau",452,844,.536,0,5,.000,452,839,.539,286,362,.790,243,491,734,218,37,143,113,152,1190,2009/2010
"Gay,Rudy",600,1288,.466,66,202,.327,534,1086,.492,301,400,.753,115,357,472,153,118,169,64,201,1567,2009/2010
"Gee,Alonzo",28,59,.475,7,9,.778,21,50,.420,18,29,.621,15,18,33,7,7,10,1,13,81,2009/2010
"George,Devean",89,206,.432,48,123,.390,41,83,.494,16,23,.696,21,93,114,32,41,15,10,89,242,2009/2010
"Gibson,Daniel",125,268,.466,71,149,.477,54,119,.454,34,49,.694,13,60,73,70,25,36,7,79,355,2009/2010
"Gibson,Taj",311,629,.494,0,0,,311,629,.494,113,175,.646,226,385,611,70,50,114,104,282,735,2009/2010
"Giddens,J.R.",28,60,.467,0,10,.000,28,50,.560,13,23,.565,16,35,51,13,9,17,2,29,69,2009/2010
"Giddens,J.R.",9,21,.429,0,2,.000,9,19,.474,6,12,.500,4,16,20,6,4,7,1,10,24,2009/2010
"Giddens,J.R.",19,39,.487,0,8,.000,19,31,.613,7,11,.636,12,19,31,7,5,10,1,19,45,2009/2010
"Gilder,Trey",1,1,1.000,0,0,,1,1,1.000,0,0,,0,1,1,0,1,0,0,0,2,2009/2010
"Ginóbili,Manu",398,903,.441,132,350,.377,266,553,.481,309,355,.870,68,216,284,370,103,154,24,154,1237,2009/2010
"Gomes,Ryan",327,732,.447,74,199,.372,253,533,.475,104,126,.825,76,272,348,124,62,95,16,155,832,2009/2010
"Gooden,Drew",288,602,.478,1,8,.125,287,594,.483,186,216,.861,207,335,542,47,41,108,58,194,763,2009/2010
"Gooden,Drew",157,336,.467,1,6,.167,156,330,.473,93,115,.809,123,193,316,26,26,56,50,129,408,2009/2010
"Gooden,Drew",131,266,.492,0,2,.000,131,264,.496,93,101,.921,84,142,226,21,15,52,8,65,355,2009/2010
"Gordon,Ben",291,699,.416,75,234,.321,216,465,.465,198,230,.861,26,93,119,166,49,118,6,147,855,2009/2010
"Gordon,Eric",352,784,.449,119,321,.371,233,463,.503,222,299,.742,25,135,160,186,69,144,14,96,1045,2009/2010
"Gortat,Marcin",121,227,.533,0,3,.000,121,224,.540,51,75,.680,104,237,341,17,17,46,70,138,293,2009/2010
"Graham,Joey",105,202,.520,2,13,.154,103,189,.545,54,73,.740,39,84,123,22,23,43,7,104,266,2009/2010
"Graham,Stephen",119,240,.496,16,50,.320,103,190,.542,42,65,.646,24,111,135,23,20,36,10,94,296,2009/2010
"Granger,Danny",488,1139,.428,158,438,.361,330,701,.471,363,428,.848,67,275,342,171,94,157,51,183,1497,2009/2010
"Gray,Aaron",42,82,.512,0,0,,42,82,.512,20,28,.714,45,61,106,22,9,18,11,54,104,2009/2010
"Gray,Aaron",8,21,.381,0,0,,8,21,.381,2,7,.286,5,11,16,2,0,1,0,10,18,2009/2010
"Gray,Aaron",34,61,.557,0,0,,34,61,.557,18,21,.857,40,50,90,20,9,17,11,44,86,2009/2010
"Green,Danny",15,39,.385,6,22,.273,9,17,.529,4,6,.667,8,9,17,5,6,5,3,9,40,2009/2010
"Green,Jeff",485,1070,.453,104,312,.333,381,758,.503,165,223,.740,112,378,490,134,104,135,72,221,1239,2009/2010
"Green,Willie",248,543,.457,47,136,.346,201,407,.494,95,114,.833,20,109,129,152,32,67,11,135,638,2009/2010
"Greene,Donté",244,553,.441,69,183,.377,175,370,.473,90,140,.643,53,181,234,71,41,93,53,150,647,2009/2010
"Griffin,Taylor",4,10,.400,0,2,.000,4,8,.500,2,4,.500,0,2,2,1,0,1,2,4,10,2009/2010
"Haddadi,Hamed",24,62,.387,0,3,.000,24,59,.407,14,19,.737,26,49,75,10,1,20,14,57,62,2009/2010
"Hairston,Malik",40,76,.526,2,11,.182,38,65,.585,17,30,.567,13,36,49,16,4,11,9,29,99,2009/2010
"Haislip,Marcus",10,21,.476,3,5,.600,7,16,.438,2,5,.400,4,6,10,0,0,3,2,5,25,2009/2010
"Hamilton,Richard",293,717,.409,41,138,.297,252,579,.435,204,241,.846,30,92,122,202,30,115,3,115,831,2009/2010
"Hansbrough,Tyler",81,225,.360,0,4,.000,81,221,.367,84,113,.743,60,78,138,28,17,21,8,70,246,2009/2010
"Harden,James",233,578,.403,93,248,.375,140,330,.424,194,240,.808,47,197,244,137,80,106,20,200,753,2009/2010
"Harrington,Al",448,1030,.435,140,409,.342,308,621,.496,240,317,.757,88,317,405,110,62,132,26,209,1276,2009/2010
"Harris,Devin",356,884,.403,60,217,.276,296,667,.444,308,386,.798,24,179,203,423,79,181,18,178,1080,2009/2010
"Harris,Mike",11,30,.367,0,1,.000,11,29,.379,7,11,.636,10,14,24,3,5,9,1,14,29,2009/2010
"Harris,Mike",10,27,.370,0,1,.000,10,26,.385,5,9,.556,9,11,20,3,4,9,1,10,25,2009/2010
"Harris,Mike",1,3,.333,0,0,,1,3,.333,2,2,1.000,1,3,4,0,1,0,0,4,4,2009/2010
"Hart,Jason",1,2,.500,0,0,,1,2,.500,0,0,,0,2,2,6,2,3,1,4,2,2009/2010
"Hart,Jason",0,1,.000,0,0,,0,1,.000,0,0,,0,0,0,1,1,0,0,0,0,2009/2010
"Hart,Jason",1,1,1.000,0,0,,1,1,1.000,0,0,,0,2,2,5,1,3,1,4,2,2009/2010
"Haslem,Udonis",312,632,.494,0,0,,312,632,.494,147,193,.762,167,462,629,52,30,75,23,174,771,2009/2010
"Hassell,Trenton",90,219,.411,0,5,.000,90,214,.421,52,69,.754,56,96,152,50,17,47,9,91,232,2009/2010
"Hawes,Spencer",312,666,.468,26,87,.299,286,579,.494,73,106,.689,145,291,436,158,32,131,83,200,723,2009/2010
"Hayes,Chuck",161,329,.489,0,0,,161,329,.489,36,66,.545,151,314,465,139,73,74,43,219,358,2009/2010
"Hayes,Jarvis",138,328,.421,60,179,.335,78,149,.523,14,18,.778,9,99,108,40,29,28,9,91,350,2009/2010
"Haywood,Brendan",276,491,.562,0,1,.000,276,490,.563,152,245,.620,278,437,715,43,26,99,158,209,704,2009/2010
"Haywood,Brendan",188,335,.561,0,0,,188,335,.561,102,158,.646,200,307,507,18,18,67,101,145,478,2009/2010
"Haywood,Brendan",88,156,.564,0,1,.000,88,155,.568,50,87,.575,78,130,208,25,8,32,57,64,226,2009/2010
"Head,Luther",136,311,.437,37,105,.352,99,206,.481,48,58,.828,6,74,80,72,18,54,9,53,357,2009/2010
"Henderson,Gerald",37,104,.356,4,19,.211,33,85,.388,35,47,.745,15,40,55,13,10,14,9,25,113,2009/2010
"Hibbert,Roy",387,782,.495,3,6,.500,384,776,.495,169,224,.754,177,287,464,158,30,145,131,285,946,2009/2010
"Hickson,J.J.",289,522,.554,0,1,.000,289,521,.555,111,163,.681,110,290,400,40,36,92,39,132,689,2009/2010
"Hilário,Nenê",421,717,.587,0,2,.000,421,715,.589,293,416,.704,166,461,627,203,115,125,82,281,1135,2009/2010
"Hill,George",353,738,.478,75,188,.399,278,550,.505,183,237,.772,42,163,205,226,69,101,26,222,964,2009/2010
"Hill,Grant",336,703,.478,35,80,.438,301,623,.483,205,251,.817,74,371,445,193,60,108,36,165,912,2009/2010
"Hill,Jordan",99,201,.493,0,2,.000,99,199,.497,46,68,.676,76,99,175,20,14,30,21,92,244,2009/2010
"Hill,Jordan",41,92,.446,0,2,.000,41,90,.456,15,21,.714,32,29,61,7,10,12,9,37,97,2009/2010
"Hill,Jordan",58,109,.532,0,0,,58,109,.532,31,47,.660,44,70,114,13,4,18,12,55,147,2009/2010
"Hinrich,Kirk",308,753,.409,104,280,.371,204,473,.431,85,113,.752,24,236,260,330,85,113,24,204,805,2009/2010
"Holiday,Jrue",230,520,.442,62,159,.390,168,361,.465,65,86,.756,56,135,191,280,79,156,18,153,587,2009/2010
"Hollins,Ryan",169,303,.558,0,1,.000,169,302,.560,109,158,.690,79,128,207,51,19,95,38,199,447,2009/2010
"Horford,Al",467,847,.551,1,1,1.000,466,846,.551,213,270,.789,236,563,799,189,59,122,91,225,1148,2009/2010
"House,Eddie",173,455,.380,79,227,.348,94,228,.412,48,52,.923,13,96,109,85,40,47,7,81,473,2009/2010
"House,Eddie",129,322,.401,64,167,.383,65,155,.419,36,40,.900,7,62,69,48,28,27,7,61,358,2009/2010
"House,Eddie",44,133,.331,15,60,.250,29,73,.397,12,12,1.000,6,34,40,37,12,20,0,20,115,2009/2010
"Howard,Dwight",510,834,.612,0,7,.000,510,827,.617,483,816,.592,284,798,1082,144,75,274,228,287,1503,2009/2010
"Howard,Josh",157,388,.405,23,86,.267,134,302,.444,109,139,.784,30,95,125,48,26,46,11,91,446,2009/2010
"Howard,Josh",137,342,.401,20,75,.267,117,267,.438,94,119,.790,26,86,112,44,23,43,9,78,388,2009/2010
"Howard,Josh",20,46,.435,3,11,.273,17,35,.486,15,20,.750,4,9,13,4,3,3,2,13,58,2009/2010
"Howard,Juwan",191,375,.509,0,1,.000,191,374,.511,55,70,.786,108,227,335,61,27,72,10,191,437,2009/2010
"Hudson,Lester",21,53,.396,5,16,.313,16,37,.432,11,13,.846,7,11,18,13,8,14,3,12,58,2009/2010
"Hudson,Lester",7,18,.389,3,5,.600,4,13,.308,5,6,.833,3,5,8,8,3,9,2,7,22,2009/2010
"Hudson,Lester",14,35,.400,2,11,.182,12,24,.500,6,7,.857,4,6,10,5,5,5,1,5,36,2009/2010
"Hughes,Larry",137,386,.355,43,139,.309,94,247,.381,94,113,.832,23,119,142,137,52,75,15,70,411,2009/2010
"Hughes,Larry",102,279,.366,28,97,.289,74,182,.407,65,79,.823,16,94,110,109,40,56,11,53,297,2009/2010
"Hughes,Larry",35,107,.327,15,42,.357,20,65,.308,29,34,.853,7,25,32,28,12,19,4,17,114,2009/2010
"Humphries,Kris",180,408,.441,0,1,.000,180,407,.442,127,190,.668,120,258,378,32,36,66,48,145,487,2009/2010
"Humphries,Kris",53,115,.461,0,0,,53,115,.461,25,44,.568,38,57,95,7,7,13,11,43,131,2009/2010
"Humphries,Kris",127,293,.433,0,1,.000,127,292,.435,102,146,.699,82,201,283,25,29,53,37,102,356,2009/2010
"Hunter,Chris",109,217,.502,0,4,.000,109,213,.512,52,69,.754,56,111,167,37,13,30,35,132,270,2009/2010
"Hunter,Lindsey",5,30,.167,1,13,.077,4,17,.235,2,2,1.000,1,13,14,9,1,4,0,12,13,2009/2010
"Hunter,Othello",4,12,.333,0,0,,4,12,.333,3,4,.750,6,6,12,0,0,3,1,5,11,2009/2010
"Hunter,Steven",17,43,.395,0,0,,17,43,.395,19,36,.528,18,24,42,0,1,9,10,10,53,2009/2010
"Ibaka,Serge",201,370,.543,1,2,.500,200,368,.543,58,92,.630,138,259,397,10,25,68,97,194,461,2009/2010
"Iguodala,Andre",496,1120,.443,94,303,.310,402,817,.492,315,430,.733,82,447,529,472,141,218,55,145,1401,2009/2010
"Ilgauskas,Zydrunas",194,438,.443,11,23,.478,183,415,.441,75,101,.743,114,231,345,48,14,63,50,183,474,2009/2010
"Ilunga-Mbenga,Didier",48,103,.466,0,0,,48,103,.466,9,19,.474,32,55,87,8,5,15,29,54,105,2009/2010
"İlyasova,Ersan",323,729,.443,81,241,.336,242,488,.496,113,158,.715,157,360,517,84,53,71,23,251,840,2009/2010
"Iverson,Allen",136,316,.430,9,25,.360,127,291,.436,104,131,.794,16,63,79,113,19,64,2,48,385,2009/2010
"Iverson,Allen",15,26,.577,1,1,1.000,14,25,.560,6,12,.500,1,3,4,11,1,7,0,5,37,2009/2010
"Iverson,Allen",121,290,.417,8,24,.333,113,266,.425,98,119,.824,15,60,75,102,18,57,2,43,348,2009/2010
"Ivey,Royal",35,83,.422,14,35,.400,21,48,.438,9,12,.750,6,28,34,27,19,11,2,39,93,2009/2010
"Ivey,Royal",26,55,.473,12,24,.500,14,31,.452,6,7,.857,5,21,26,17,10,5,2,25,70,2009/2010
"Ivey,Royal",9,28,.321,2,11,.182,7,17,.412,3,5,.600,1,7,8,10,9,6,0,14,23,2009/2010
"Jack,Jarrett",323,671,.481,82,199,.412,241,472,.511,203,241,.842,30,192,222,413,60,163,6,151,931,2009/2010
"Jackson,Cedric",6,20,.300,1,6,.167,5,14,.357,7,12,.583,2,6,8,14,3,11,2,7,20,2009/2010
"Jackson,Cedric",0,2,.000,0,1,.000,0,1,.000,1,4,.250,0,1,1,2,0,1,0,0,1,2009/2010
"Jackson,Cedric",2,7,.286,0,2,.000,2,5,.400,3,4,.750,1,3,4,6,3,2,2,2,7,2009/2010
"Jackson,Cedric",4,11,.364,1,3,.333,3,8,.375,3,4,.750,1,2,3,6,0,8,0,5,12,2009/2010
"Jackson,Darnell",9,30,.300,1,4,.250,8,26,.308,4,6,.667,9,13,22,4,2,13,4,21,23,2009/2010
"Jackson,Darnell",8,25,.320,1,3,.333,7,22,.318,4,6,.667,8,12,20,4,2,13,4,19,21,2009/2010
"Jackson,Darnell",1,5,.200,0,1,.000,1,4,.250,0,0,,1,1,2,0,0,0,0,2,2,2009/2010
"Jackson,Stephen",600,1418,.423,129,393,.328,471,1025,.460,338,434,.779,78,323,401,300,132,259,43,197,1667,2009/2010
"Jackson,Stephen",56,133,.421,11,40,.275,45,93,.484,26,37,.703,6,29,35,42,14,26,6,16,149,2009/2010
"Jackson,Stephen",544,1285,.423,118,353,.334,426,932,.457,312,397,.786,72,294,366,258,118,233,37,181,1518,2009/2010
"James,LeBron",768,1528,.503,129,387,.333,639,1141,.560,593,773,.767,71,483,554,651,125,261,77,119,2258,2009/2010
"James,Mike",6,20,.300,2,6,.333,4,14,.286,4,8,.500,1,2,3,5,3,5,0,3,18,2009/2010
"Jamison,Antawn",478,1036,.461,85,247,.344,393,789,.498,194,300,.647,136,419,555,84,71,91,21,179,1235,2009/2010
"Jamison,Antawn",315,700,.450,58,168,.345,257,532,.483,152,217,.700,99,263,362,52,43,61,9,112,840,2009/2010
"Jamison,Antawn",163,336,.485,27,79,.342,136,257,.529,42,83,.506,37,156,193,32,28,30,12,67,395,2009/2010
"Jawai,Nathan",49,111,.441,0,1,.000,49,110,.445,26,38,.684,49,55,104,24,10,27,9,58,124,2009/2010
"Jeffers,Othyus",12,29,.414,0,0,,12,29,.414,13,19,.684,8,11,19,1,4,6,0,10,37,2009/2010
"Jefferson,Al",560,1125,.498,0,4,.000,560,1121,.500,181,266,.680,180,523,703,137,63,136,98,205,1301,2009/2010
"Jefferson,Richard",362,775,.467,59,187,.316,303,588,.515,211,287,.735,58,298,356,158,45,105,40,178,994,2009/2010
"Jeffries,Jared",138,314,.439,21,71,.296,117,243,.481,75,120,.625,130,158,288,101,62,76,71,203,372,2009/2010
"Jeffries,Jared",102,230,.443,20,62,.323,82,168,.488,60,93,.645,99,124,223,83,53,62,58,157,284,2009/2010
"Jeffries,Jared",36,84,.429,1,9,.111,35,75,.467,15,27,.556,31,34,65,18,9,14,13,46,88,2009/2010
"Jennings,Brandon",451,1216,.371,145,388,.374,306,828,.370,223,273,.817,49,233,282,470,105,200,18,191,1270,2009/2010
"Jerebko,Jonas",290,603,.481,36,115,.313,254,488,.520,125,176,.710,194,284,478,58,79,82,29,230,741,2009/2010
"Jianlian,Yi",227,563,.403,15,41,.366,212,522,.406,154,193,.798,115,257,372,47,37,77,52,170,623,2009/2010
"Johnson,Amir",208,334,.623,0,4,.000,208,330,.630,95,149,.638,154,241,395,48,44,63,66,255,511,2009/2010
"Johnson,Anthony",49,111,.441,13,39,.333,36,72,.500,19,20,.950,8,40,48,63,11,26,1,32,130,2009/2010
"Johnson,James",95,210,.452,15,46,.326,80,164,.488,51,70,.729,34,94,128,48,21,62,43,126,256,2009/2010
"Johnson,Joe",635,1386,.458,129,350,.369,506,1036,.488,220,269,.818,74,279,353,369,82,145,5,145,1619,2009/2010
"Jones,Dahntay",287,623,.461,4,32,.125,283,591,.479,198,257,.770,48,181,229,150,40,129,39,237,776,2009/2010
"Jones,Dwayne",0,0,,0,0,,0,0,,0,0,,0,2,2,0,0,0,0,1,0,2009/2010
"Jones,James",43,119,.361,37,90,.411,6,29,.207,23,28,.821,4,41,45,17,11,11,4,45,146,2009/2010
"Jones,Solomon",78,176,.443,0,3,.000,78,173,.451,51,71,.718,51,93,144,32,14,40,37,125,207,2009/2010
"Jordan,DeAndre",144,238,.605,0,2,.000,144,236,.610,48,128,.375,122,230,352,21,16,75,62,152,336,2009/2010
"Kaman,Chris",589,1202,.490,0,6,.000,589,1196,.492,230,307,.749,184,520,704,120,37,223,94,213,1408,2009/2010
"Kapono,Jason",126,301,.419,63,171,.368,63,130,.485,9,15,.600,14,52,66,39,21,34,6,80,324,2009/2010
"Karl,Coby",11,32,.344,2,11,.182,9,21,.429,4,6,.667,4,14,18,15,3,10,1,14,28,2009/2010
"Karl,Coby",0,0,,0,0,,0,0,,0,0,,0,2,2,0,0,4,0,0,0,2009/2010
"Karl,Coby",11,32,.344,2,11,.182,9,21,.429,4,6,.667,4,12,16,15,3,6,1,14,28,2009/2010
"Kidd,Jason",284,671,.423,176,414,.425,108,257,.420,80,99,.808,48,397,445,724,145,195,35,142,824,2009/2010
"Kirilenko,Andrei",244,482,.506,26,89,.292,218,393,.555,174,234,.744,76,188,264,158,83,79,71,102,688,2009/2010
"Korver,Kyle",138,280,.493,59,110,.536,79,170,.465,39,49,.796,10,101,111,89,26,42,12,76,374,2009/2010
"Koufos,Kosta",22,47,.468,0,0,,22,47,.468,9,15,.600,16,29,45,6,2,15,4,26,53,2009/2010
"Krstić,Nenad",281,560,.502,1,5,.200,280,555,.505,76,106,.717,134,249,383,52,32,58,45,177,639,2009/2010
"Lafayette,Oliver",3,6,.500,1,2,.500,2,4,.500,0,0,,1,3,4,2,0,1,0,0,7,2009/2010
"Landry,Carl",499,931,.536,1,3,.333,498,928,.537,344,427,.806,188,280,468,66,55,136,63,234,1343,2009/2010
"Landry,Carl",302,552,.547,0,0,,302,552,.547,235,280,.839,122,164,286,40,28,86,46,146,839,2009/2010
"Landry,Carl",197,379,.520,1,3,.333,196,376,.521,109,147,.741,66,116,182,26,27,50,17,88,504,2009/2010
"Landry,Marcus",16,43,.372,9,28,.321,7,15,.467,3,5,.600,5,14,19,0,1,6,2,14,44,2009/2010
"Landry,Marcus",16,41,.390,9,26,.346,7,15,.467,3,5,.600,5,14,19,0,1,6,2,14,44,2009/2010
"Landry,Marcus",0,2,.000,0,2,.000,0,0,,0,0,,0,0,0,0,0,0,0,0,0,2009/2010
"Law,Acie",35,75,.467,5,16,.313,30,59,.508,38,49,.776,3,14,17,26,11,17,1,16,113,2009/2010
"Law,Acie",9,14,.643,1,3,.333,8,11,.727,12,15,.800,0,2,2,7,6,2,0,5,31,2009/2010
"Law,Acie",5,16,.313,0,1,.000,5,15,.333,6,7,.857,0,1,1,3,1,3,1,3,16,2009/2010
"Law,Acie",21,45,.467,4,12,.333,17,33,.515,20,27,.741,3,11,14,16,4,12,0,8,66,2009/2010
"Lawson,Ty",201,390,.515,34,83,.410,167,307,.544,106,140,.757,42,82,124,203,48,82,2,89,542,2009/2010
"Lee,Courtney",338,775,.436,76,225,.338,262,550,.476,133,153,.869,60,192,252,121,93,76,20,130,885,2009/2010
"Lee,David",686,1258,.545,0,8,.000,686,1250,.549,268,330,.812,228,721,949,295,85,189,40,257,1640,2009/2010
"Lewis,Rashard",350,805,.435,168,423,.397,182,382,.476,145,180,.806,62,256,318,107,78,108,28,180,1013,2009/2010
"Livingston,Shaun",104,201,.517,0,6,.000,104,195,.533,42,48,.875,16,62,78,130,17,58,11,61,250,2009/2010
"Livingston,Shaun",5,16,.313,0,2,.000,5,14,.357,0,0,,4,16,20,14,5,8,2,9,10,2009/2010
"Livingston,Shaun",99,185,.535,0,4,.000,99,181,.547,42,48,.875,12,46,58,116,12,50,9,52,240,2009/2010
"Lopez,Brook",563,1129,.499,0,2,.000,563,1127,.500,416,509,.817,270,439,709,187,55,204,139,251,1542,2009/2010
"Lopez,Robin",171,291,.588,0,0,,171,291,.588,88,125,.704,104,144,248,7,10,41,53,117,430,2009/2010
"Love,Kevin",291,646,.450,35,106,.330,256,540,.474,225,276,.815,227,431,658,136,43,117,23,136,842,2009/2010
"Lowry,Kyle",184,464,.397,37,136,.272,147,328,.448,215,260,.827,91,156,247,305,60,116,9,173,620,2009/2010
"Maggette,Corey",457,886,.516,13,50,.260,444,836,.531,460,551,.835,92,281,373,172,51,168,4,231,1387,2009/2010
"Magloire,Jamaal",28,56,.500,0,0,,28,56,.500,21,59,.356,41,80,121,1,9,17,11,59,77,2009/2010
"Mahinmi,Ian",35,55,.636,0,0,,35,55,.636,31,47,.660,13,39,52,2,3,15,8,32,101,2009/2010
"Marion,Shawn",395,778,.508,3,19,.158,392,759,.516,105,139,.755,158,319,477,107,69,99,61,141,898,2009/2010
"Marks,Sean",4,8,.500,0,0,,4,8,.500,2,5,.400,14,9,23,2,0,2,3,17,10,2009/2010
"Martin,Cartier",50,136,.368,17,49,.347,33,87,.379,24,30,.800,25,43,68,16,11,19,1,48,141,2009/2010
"Martin,Cartier",32,88,.364,10,31,.323,22,57,.386,16,21,.762,17,30,47,9,8,13,0,36,90,2009/2010
"Martin,Cartier",18,48,.375,7,18,.389,11,30,.367,8,9,.889,8,13,21,7,3,6,1,12,51,2009/2010
"Martin,Kenyon",283,620,.456,8,29,.276,275,591,.465,93,167,.557,142,404,546,109,72,91,61,186,667,2009/2010
"Martin,Kevin",289,693,.417,70,210,.333,219,483,.453,298,340,.876,29,135,164,111,46,92,6,96,946,2009/2010
"Martin,Kevin",135,339,.398,39,110,.355,96,229,.419,127,155,.819,20,74,94,57,23,35,4,51,436,2009/2010
"Martin,Kevin",154,354,.435,31,100,.310,123,254,.484,171,185,.924,9,61,70,54,23,57,2,45,510,2009/2010
"Mason,Desmond",5,12,.417,0,0,,5,12,.417,3,4,.750,4,9,13,2,1,4,1,5,13,2009/2010
"Mason,Roger",193,496,.389,88,264,.333,105,232,.453,27,34,.794,11,151,162,137,30,59,14,99,501,2009/2010
"Matthews,Wesley",273,565,.483,63,165,.382,210,400,.525,160,193,.829,50,141,191,124,64,93,15,152,769,2009/2010
"Maxiell,Jason",212,415,.511,0,1,.000,212,414,.512,89,155,.574,161,240,401,39,36,68,38,175,513,2009/2010
"May,Sean",51,111,.459,0,4,.000,51,107,.477,21,32,.656,20,50,70,17,12,19,7,46,123,2009/2010
"Maynor,Eric",154,368,.418,22,71,.310,132,297,.444,52,72,.722,21,108,129,266,40,85,10,115,382,2009/2010
"Maynor,Eric",52,133,.391,5,24,.208,47,109,.431,25,33,.758,10,28,38,81,13,28,2,33,134,2009/2010
"Maynor,Eric",102,235,.434,17,47,.362,85,188,.452,27,39,.692,11,80,91,185,27,57,8,82,248,2009/2010
"Mayo,O.J.",542,1183,.458,136,355,.383,406,828,.490,212,262,.809,61,250,311,242,98,176,17,174,1432,2009/2010
"Mbah a Moute,Luc",177,369,.480,6,17,.353,171,352,.486,93,133,.699,171,229,400,81,60,70,39,181,453,2009/2010
"McDyess,Antonio",205,428,.479,0,2,.000,205,426,.481,36,57,.632,149,306,455,83,43,79,32,147,446,2009/2010
"McGee,JaVale",156,307,.508,0,1,.000,156,306,.510,74,116,.638,88,155,243,14,16,51,101,122,386,2009/2010
"McGrady,Tracy",91,235,.387,16,64,.250,75,171,.439,47,63,.746,22,72,94,99,15,44,14,40,245,2009/2010
"McGrady,Tracy",7,19,.368,1,2,.500,6,17,.353,4,6,.667,0,5,5,6,0,1,2,2,19,2009/2010
"McGrady,Tracy",84,216,.389,15,62,.242,69,154,.448,43,57,.754,22,67,89,93,15,43,12,38,226,2009/2010
"McGuire,Dominic",19,52,.365,0,0,,19,52,.365,0,7,.000,23,56,79,11,5,17,4,35,38,2009/2010
"McGuire,Dominic",15,40,.375,0,0,,15,40,.375,0,5,.000,17,44,61,8,4,10,3,32,30,2009/2010
"McGuire,Dominic",4,12,.333,0,0,,4,12,.333,0,2,.000,6,12,18,3,1,7,1,3,8,2009/2010
"McRoberts,Josh",76,146,.521,8,23,.348,68,123,.553,19,38,.500,40,87,127,44,17,19,16,74,179,2009/2010
"Meeks,Jodie",104,268,.388,42,132,.318,62,136,.456,31,39,.795,9,90,99,39,18,25,5,52,281,2009/2010
"Meeks,Jodie",64,177,.362,23,82,.280,41,95,.432,18,21,.857,5,67,72,22,13,20,4,33,169,2009/2010
"Meeks,Jodie",40,91,.440,19,50,.380,21,41,.512,13,18,.722,4,23,27,17,5,5,1,19,112,2009/2010
"Mensah-Bonsu,Pops",13,33,.394,0,0,,13,33,.394,13,24,.542,16,19,35,3,4,10,9,20,39,2009/2010
"Mensah-Bonsu,Pops",1,4,.250,0,0,,1,4,.250,3,6,.500,1,3,4,1,1,0,1,3,5,2009/2010
"Mensah-Bonsu,Pops",12,29,.414,0,0,,12,29,.414,10,18,.556,15,16,31,2,3,10,8,17,34,2009/2010
"Miles,C.J.",241,562,.429,74,217,.341,167,345,.484,66,95,.695,42,126,168,105,58,81,17,190,622,2009/2010
"Miličić,Darko",100,204,.490,0,1,.000,100,203,.493,15,28,.536,47,104,151,47,22,35,34,82,215,2009/2010
"Miličić,Darko",8,17,.471,0,0,,8,17,.471,0,0,,5,13,18,4,4,2,1,7,16,2009/2010
"Miličić,Darko",92,187,.492,0,1,.000,92,186,.495,15,28,.536,42,91,133,43,18,33,33,75,199,2009/2010
"Miller,Andre",404,908,.445,16,80,.200,388,828,.469,322,392,.821,81,185,266,445,93,173,9,169,1146,2009/2010
"Miller,Brad",250,581,.430,37,132,.280,213,449,.474,182,220,.827,83,316,399,154,44,107,29,189,719,2009/2010
"Miller,Mike",217,433,.501,82,171,.480,135,262,.515,70,85,.824,55,281,336,212,39,115,12,131,586,2009/2010
"Mills,Patty",10,24,.417,2,4,.500,8,20,.400,4,7,.571,1,1,2,5,0,4,0,6,26,2009/2010
"Millsap,Paul",385,716,.538,1,9,.111,384,707,.543,183,264,.693,186,373,559,131,64,116,99,285,954,2009/2010
"Mohammed,Nazr",189,342,.553,0,0,,189,342,.553,81,125,.648,114,190,304,28,15,53,43,105,459,2009/2010
"Moon,Jamario",114,247,.462,32,100,.320,82,147,.558,36,45,.800,26,165,191,49,34,23,30,69,296,2009/2010
"Moore,Mikki",54,90,.600,0,0,,54,90,.600,7,11,.636,26,43,69,36,5,21,13,60,115,2009/2010
"Morris,Randolph",23,41,.561,0,0,,23,41,.561,16,27,.593,10,28,38,2,5,12,3,34,62,2009/2010
"Morrison,Adam",32,85,.376,5,21,.238,27,64,.422,5,8,.625,10,22,32,18,3,10,2,17,74,2009/2010
"Morrow,Anthony",329,703,.468,140,307,.456,189,396,.477,101,114,.886,61,198,259,104,65,84,16,158,899,2009/2010
"Mullens,Byron",7,19,.368,0,0,,7,19,.368,0,0,,3,7,10,1,2,4,0,13,14,2009/2010
"Murphy,Troy",384,813,.472,128,333,.384,256,480,.533,154,193,.798,129,608,737,150,72,100,34,175,1050,2009/2010
"Murray,Ronald",268,683,.392,69,221,.312,199,462,.431,141,194,.727,28,155,183,135,46,91,16,126,746,2009/2010
"Murray,Ronald",160,411,.389,41,131,.313,119,280,.425,93,131,.710,15,83,98,84,28,65,12,77,454,2009/2010
"Murray,Ronald",108,272,.397,28,90,.311,80,182,.440,48,63,.762,13,72,85,51,18,26,4,49,292,2009/2010
"Nájera,Eduardo",62,146,.425,19,64,.297,43,82,.524,14,24,.583,34,81,115,29,26,25,14,94,157,2009/2010
"Nájera,Eduardo",20,53,.377,3,17,.176,17,36,.472,6,12,.500,12,26,38,15,9,12,2,33,49,2009/2010
"Nájera,Eduardo",42,93,.452,16,47,.340,26,46,.565,8,12,.667,22,55,77,14,17,13,12,61,108,2009/2010
"Nash,Steve",499,985,.507,124,291,.426,375,694,.540,211,225,.938,34,234,268,892,42,295,12,108,1333,2009/2010
"Nelson,Jameer",317,706,.449,86,226,.381,231,480,.481,98,116,.845,26,168,194,353,48,139,2,147,818,2009/2010
"Nesterović,Rasho",81,149,.544,0,0,,81,149,.544,1,5,.200,37,52,89,25,10,16,17,54,163,2009/2010
"Noah,Joakim",262,520,.504,0,0,,262,520,.504,163,219,.744,220,484,704,132,32,117,100,198,687,2009/2010
"Nocioni,Andrés",234,587,.399,96,249,.386,138,338,.408,71,99,.717,32,190,222,75,32,67,26,160,635,2009/2010
"Novak,Steve",42,108,.389,22,71,.310,20,37,.541,7,9,.778,1,32,33,6,7,2,2,21,113,2009/2010
"Nowitzki,Dirk",720,1496,.481,51,121,.421,669,1375,.487,536,586,.915,80,540,620,218,70,149,79,208,2027,2009/2010
"O'Bryant,Patrick",8,15,.533,0,1,.000,8,14,.571,3,6,.500,2,9,11,1,2,5,4,12,19,2009/2010
"O'Neal,Jermaine",394,745,.529,0,2,.000,394,743,.530,162,225,.720,124,362,486,92,25,125,95,212,950,2009/2010
"O'Neal,Shaquille",262,463,.566,0,1,.000,262,462,.567,112,226,.496,93,262,355,80,15,105,62,169,636,2009/2010
"Oberto,Fabricio",35,56,.625,0,0,,35,56,.625,13,17,.765,34,71,105,51,11,36,9,121,83,2009/2010
"Oden,Greg",92,152,.605,0,0,,92,152,.605,49,64,.766,64,114,178,19,8,39,48,84,233,2009/2010
"Odom,Lamar",342,739,.463,58,182,.319,284,557,.510,140,202,.693,184,618,802,267,75,150,59,227,882,2009/2010
"Okafor,Emeka",348,656,.530,0,0,,348,656,.530,154,274,.562,251,491,742,55,54,111,127,218,850,2009/2010
"Okur,Mehmet",355,775,.458,82,213,.385,273,562,.486,196,239,.820,132,383,515,119,38,127,81,223,988,2009/2010
"Ollie,Kevin",18,45,.400,0,1,.000,18,44,.409,8,8,1.000,3,22,25,20,9,6,0,16,44,2009/2010
"Outlaw,Travis",110,281,.391,40,105,.381,70,176,.398,49,59,.831,33,88,121,34,18,32,17,43,309,2009/2010
"Outlaw,Travis",38,101,.376,12,31,.387,26,70,.371,21,24,.875,13,25,38,8,7,12,8,13,109,2009/2010
"Outlaw,Travis",72,180,.400,28,74,.378,44,106,.415,28,35,.800,20,63,83,26,11,20,9,30,200,2009/2010
"Pachulia,Zaza",120,246,.488,0,4,.000,120,242,.496,93,143,.650,117,176,293,42,37,58,31,186,333,2009/2010
"Pargo,Jannero",132,381,.346,38,138,.275,94,243,.387,42,45,.933,9,69,78,89,29,50,2,68,344,2009/2010
"Parker,Anthony",206,475,.434,108,261,.414,98,214,.458,75,95,.789,30,201,231,157,63,71,18,151,595,2009/2010
"Parker,Tony",349,716,.487,10,34,.294,339,682,.497,186,246,.756,7,128,135,317,29,149,8,96,894,2009/2010
"Paul,Chris",314,637,.493,52,127,.409,262,510,.514,161,190,.847,20,171,191,480,96,112,8,118,841,2009/2010
"Pavlović,Sasha",109,300,.363,35,118,.297,74,182,.407,10,26,.385,12,105,117,58,23,53,6,84,263,2009/2010
"Pecherov,Oleksiy",77,188,.410,14,52,.269,63,136,.463,29,32,.906,32,92,124,11,9,32,14,55,197,2009/2010
"Perkins,Kendrick",314,522,.602,0,3,.000,314,519,.605,163,280,.582,155,440,595,80,26,165,132,219,791,2009/2010
"Peterson,Morris",116,301,.385,62,171,.363,54,130,.415,33,54,.611,17,109,126,41,25,27,5,81,327,2009/2010
"Petro,Johan",54,101,.535,0,1,.000,54,100,.540,14,21,.667,32,97,129,14,10,23,13,80,122,2009/2010
"Pierce,Paul",409,867,.472,109,263,.414,300,604,.497,369,433,.852,39,271,310,218,84,166,31,196,1296,2009/2010
"Piétrus,Mickaël",233,539,.432,116,306,.379,117,233,.502,69,109,.633,39,176,215,49,53,69,31,138,651,2009/2010
"Posey,James",126,345,.365,81,242,.335,45,103,.437,66,80,.825,32,297,329,117,42,51,19,204,399,2009/2010
"Powe,Leon",21,49,.429,0,0,,21,49,.429,37,63,.587,19,42,61,0,6,11,2,36,79,2009/2010
"Powell,Josh",71,194,.366,7,16,.438,64,178,.360,20,31,.645,44,72,116,35,9,33,6,71,169,2009/2010
"Price,A.J.",145,354,.410,60,174,.345,85,180,.472,60,75,.800,12,76,88,106,35,59,3,53,410,2009/2010
"Price,Ronnie",98,242,.405,18,63,.286,80,179,.447,41,59,.695,28,46,74,123,40,56,13,109,255,2009/2010
"Prince,Tayshaun",282,580,.486,27,73,.370,255,507,.503,70,98,.714,71,177,248,161,34,60,22,77,661,2009/2010
"Przybilla,Joel",45,86,.523,0,0,,45,86,.523,33,51,.647,72,166,238,8,8,39,43,95,123,2009/2010
"Quinn,Chris",20,56,.357,10,32,.313,10,24,.417,6,6,1.000,1,15,16,29,9,10,1,15,56,2009/2010
"Radmanović,Vladimir",103,273,.377,30,108,.278,73,165,.442,20,27,.741,51,127,178,45,29,44,7,97,256,2009/2010
"Radmanović,Vladimir",14,42,.333,7,22,.318,7,20,.350,4,6,.667,8,21,29,7,3,5,1,18,39,2009/2010
"Radmanović,Vladimir",89,231,.385,23,86,.267,66,145,.455,16,21,.762,43,106,149,38,26,39,6,79,217,2009/2010
"Randolph,Anthony",137,309,.443,1,5,.200,136,304,.447,109,136,.801,73,142,215,42,28,49,51,92,384,2009/2010
"Randolph,Shavlik",6,18,.333,0,0,,6,18,.333,2,2,1.000,7,7,14,1,1,3,1,9,14,2009/2010
"Randolph,Shavlik",5,15,.333,0,0,,5,15,.333,0,0,,7,6,13,0,1,2,1,9,10,2009/2010
"Randolph,Shavlik",1,3,.333,0,0,,1,3,.333,2,2,1.000,0,1,1,1,0,1,0,0,4,2009/2010
"Randolph,Zach",652,1336,.488,15,52,.288,637,1284,.496,362,465,.778,330,620,950,149,80,174,34,226,1681,2009/2010
"Ratliff,Theo",70,152,.461,0,0,,70,152,.461,38,50,.760,59,98,157,25,12,41,61,87,178,2009/2010
"Ratliff,Theo",16,36,.444,0,0,,16,36,.444,2,4,.500,15,25,40,9,3,16,18,27,34,2009/2010
"Ratliff,Theo",54,116,.466,0,0,,54,116,.466,36,46,.783,44,73,117,16,9,25,43,60,144,2009/2010
"Redd,Michael",75,213,.352,18,60,.300,57,153,.373,47,66,.712,11,43,54,39,19,15,2,24,215,2009/2010
"Redick,J.J.",243,553,.439,111,274,.405,132,279,.473,191,222,.860,17,138,155,158,28,63,4,118,788,2009/2010
"Richard,Chris",15,29,.517,0,0,,15,29,.517,7,11,.636,19,40,59,7,8,14,4,50,37,2009/2010
"Richardson,Jason",473,998,.474,157,400,.393,316,598,.528,136,184,.739,81,323,404,143,66,92,33,169,1239,2009/2010
"Richardson,Quentin",242,561,.431,142,358,.397,100,203,.493,52,71,.732,64,310,374,93,70,62,18,169,678,2009/2010
"Ridnour,Luke",328,686,.478,69,181,.381,259,505,.513,127,140,.907,24,119,143,324,54,106,7,182,852,2009/2010
"Robinson,Nate",215,493,.436,87,223,.390,128,270,.474,50,67,.746,28,82,110,163,49,73,5,116,567,2009/2010
"Robinson,Nate",152,336,.452,51,136,.375,101,200,.505,42,54,.778,23,49,72,112,27,53,5,66,397,2009/2010
"Robinson,Nate",63,157,.401,36,87,.414,27,70,.386,8,13,.615,5,33,38,51,22,20,0,50,170,2009/2010
"Rodríguez,Sergio",167,351,.476,32,91,.352,135,260,.519,68,93,.731,24,65,89,212,50,114,5,84,434,2009/2010
"Rodríguez,Sergio",88,190,.463,15,42,.357,73,148,.493,43,62,.694,15,35,50,121,29,59,3,46,234,2009/2010
"Rodríguez,Sergio",79,161,.491,17,49,.347,62,112,.554,25,31,.806,9,30,39,91,21,55,2,38,200,2009/2010
"Rondo,Rajon",459,904,.508,17,80,.213,442,824,.536,175,282,.621,100,260,360,794,189,246,11,198,1110,2009/2010
"Rose,Derrick",672,1373,.489,16,60,.267,656,1313,.500,259,338,.766,65,228,293,469,57,217,27,96,1619,2009/2010
"Ross,Quinton",40,111,.360,4,21,.190,36,90,.400,8,14,.571,17,32,49,12,13,11,6,69,92,2009/2010
"Ross,Quinton",23,56,.411,3,13,.231,20,43,.465,5,8,.625,11,16,27,7,7,3,4,34,54,2009/2010
"Ross,Quinton",17,55,.309,1,8,.125,16,47,.340,3,6,.500,6,16,22,5,6,8,2,35,38,2009/2010
"Roy,Brandon",491,1038,.473,73,221,.330,418,817,.512,343,440,.780,73,212,285,305,61,129,16,136,1398,2009/2010
"Rush,Brandon",297,702,.423,124,302,.411,173,400,.433,56,89,.629,41,305,346,112,56,93,65,159,774,2009/2010
"Rush,Kareem",4,11,.364,1,3,.333,3,8,.375,0,0,,1,5,6,4,2,3,3,8,9,2009/2010
"Salmons,John",437,991,.441,118,309,.382,319,682,.468,253,305,.830,35,235,270,223,99,123,26,166,1245,2009/2010
"Salmons,John",230,548,.420,73,192,.380,157,356,.441,116,147,.789,18,156,174,125,65,70,22,101,649,2009/2010
"Salmons,John",207,443,.467,45,117,.385,162,326,.497,137,158,.867,17,79,96,98,34,53,4,65,596,2009/2010
"Scalabrine,Brian",29,85,.341,16,49,.327,13,36,.361,4,6,.667,9,39,48,27,9,17,4,59,78,2009/2010
"Scola,Luis",560,1090,.514,1,5,.200,559,1085,.515,208,267,.779,175,530,705,169,63,163,26,246,1329,2009/2010
"Sefolosha,Thabo",194,441,.440,41,131,.313,153,310,.494,60,89,.674,76,311,387,145,97,90,46,154,489,2009/2010
"Sessions,Ramon",253,555,.456,1,15,.067,252,540,.467,167,233,.717,58,156,214,258,55,137,5,137,674,2009/2010
"Simmons,Bobby",42,117,.359,20,63,.317,22,54,.407,18,20,.900,11,52,63,15,15,19,3,52,122,2009/2010
"Singleton,James",97,254,.382,7,37,.189,90,217,.415,53,62,.855,108,168,276,31,28,49,43,113,254,2009/2010
"Singleton,James",24,64,.375,5,22,.227,19,42,.452,6,6,1.000,17,38,55,9,11,12,7,31,59,2009/2010
"Singleton,James",73,190,.384,2,15,.133,71,175,.406,47,56,.839,91,130,221,22,17,37,36,82,195,2009/2010
"Skinner,Brian",10,25,.400,0,0,,10,25,.400,6,8,.750,9,18,27,0,3,7,4,20,26,2009/2010
"Smith,Craig",226,397,.569,1,5,.200,225,392,.574,132,208,.635,97,190,287,84,33,88,25,194,585,2009/2010
"Smith,J.R.",428,1033,.414,158,467,.338,270,566,.477,142,201,.706,28,206,234,183,99,139,20,174,1156,2009/2010
"Smith,Jason",75,174,.431,10,29,.345,65,145,.448,29,42,.690,54,81,135,33,21,35,28,110,189,2009/2010
"Smith,Joe",77,193,.399,1,7,.143,76,186,.409,39,48,.813,66,91,157,21,6,22,19,95,194,2009/2010
"Smith,Josh",504,999,.505,0,7,.000,504,992,.508,261,422,.618,223,482,705,342,130,198,172,240,1269,2009/2010
"Songaila,Darius",241,488,.494,1,6,.167,240,482,.498,60,74,.811,59,173,232,70,62,81,14,206,543,2009/2010
"Speights,Marreese",212,444,.477,0,5,.000,212,439,.483,108,145,.745,85,167,252,36,29,51,34,152,532,2009/2010
"Stackhouse,Jerry",129,316,.408,45,130,.346,84,186,.452,55,69,.797,19,81,100,70,21,66,9,56,358,2009/2010
"Stevenson,DeShawn",46,163,.282,19,87,.218,27,76,.355,25,35,.714,11,80,91,56,16,30,6,74,136,2009/2010
"Stevenson,DeShawn",29,103,.282,11,62,.177,18,41,.439,18,25,.720,7,58,65,44,11,24,5,51,87,2009/2010
"Stevenson,DeShawn",17,60,.283,8,25,.320,9,35,.257,7,10,.700,4,22,26,12,5,6,1,23,49,2009/2010
"Stojaković,Peja",278,688,.404,132,352,.375,146,336,.435,96,107,.897,39,188,227,92,48,56,5,83,784,2009/2010
"Stoudemire,Amar'e",704,1264,.557,1,6,.167,703,1258,.559,487,632,.771,230,502,732,82,52,213,83,281,1896,2009/2010
"Stuckey,Rodney",449,1109,.405,18,79,.228,431,1030,.418,299,359,.833,67,214,281,348,101,163,12,205,1215,2009/2010
"Summers,DaJuan",46,130,.354,15,42,.357,31,88,.352,27,38,.711,14,31,45,16,8,16,7,52,134,2009/2010
"Taylor,Jermaine",45,119,.378,5,22,.227,40,97,.412,33,46,.717,21,25,46,16,10,19,3,15,128,2009/2010
"Teague,Jeff",90,227,.396,7,32,.219,83,195,.426,41,49,.837,5,62,67,122,34,50,11,82,228,2009/2010
"Telfair,Sebastian",83,201,.413,13,56,.232,70,145,.483,29,37,.784,5,40,45,126,24,50,5,71,208,2009/2010
"Telfair,Sebastian",67,166,.404,11,47,.234,56,119,.471,24,31,.774,5,36,41,114,22,44,5,65,169,2009/2010
"Telfair,Sebastian",16,35,.457,2,9,.222,14,26,.538,5,6,.833,0,4,4,12,2,6,0,6,39,2009/2010
"Temple,Garrett",44,101,.436,13,37,.351,31,64,.484,35,50,.700,6,25,31,21,13,27,6,42,136,2009/2010
"Temple,Garrett",13,29,.448,3,12,.250,10,17,.588,16,24,.667,2,12,14,7,4,14,4,16,45,2009/2010
"Temple,Garrett",3,8,.375,0,2,.000,3,6,.500,5,5,1.000,1,2,3,2,1,2,0,1,11,2009/2010
"Temple,Garrett",28,64,.438,10,23,.435,18,41,.439,14,21,.667,3,11,14,12,8,11,2,25,80,2009/2010
"Terry,Jason",456,1041,.438,136,373,.365,320,668,.479,232,268,.866,19,121,140,292,94,109,17,142,1280,2009/2010
"Thabeet,Hasheem",77,131,.588,0,0,,77,131,.588,54,93,.581,85,158,243,11,15,43,89,162,208,2009/2010
"Thomas,Etan",31,68,.456,0,0,,31,68,.456,13,22,.591,18,46,64,1,4,18,16,39,75,2009/2010
"Thomas,Kenny",17,35,.486,0,0,,17,35,.486,7,12,.583,35,51,86,15,10,17,10,42,41,2009/2010
"Thomas,Kurt",99,208,.476,0,0,,99,208,.476,12,15,.800,84,207,291,47,26,48,46,159,210,2009/2010
"Thomas,Tim",49,106,.462,16,43,.372,33,63,.524,21,24,.875,13,28,41,14,10,14,2,31,135,2009/2010
"Thomas,Tyrus",194,420,.462,0,3,.000,194,417,.465,120,175,.686,81,254,335,56,63,92,85,129,508,2009/2010
"Thomas,Tyrus",99,205,.483,0,1,.000,99,204,.485,58,90,.644,42,141,183,33,40,52,48,64,256,2009/2010
"Thomas,Tyrus",95,215,.442,0,2,.000,95,213,.446,62,85,.729,39,113,152,23,23,40,37,65,252,2009/2010
"Thompson,Jason",370,784,.472,1,10,.100,369,774,.477,198,277,.715,224,413,637,124,41,139,73,279,939,2009/2010
"Thornton,Al",320,676,.473,11,31,.355,309,645,.479,153,211,.725,116,178,294,90,45,102,35,206,804,2009/2010
"Thornton,Al",220,460,.478,5,14,.357,215,446,.482,103,139,.741,85,107,192,61,25,66,22,144,548,2009/2010
"Thornton,Al",100,216,.463,6,17,.353,94,199,.472,50,72,.694,31,71,102,29,20,36,13,62,256,2009/2010
"Thornton,Marcus",398,883,.451,117,313,.374,281,570,.493,144,177,.814,72,139,211,114,58,76,11,127,1057,2009/2010
"Tinsley,Jamaal",52,140,.371,7,39,.179,45,101,.446,22,27,.815,11,55,66,108,33,63,5,67,133,2009/2010
"Tolliver,Anthony",193,449,.430,50,152,.329,143,297,.481,103,134,.769,84,236,320,87,32,46,33,128,539,2009/2010
"Tolliver,Anthony",0,1,.000,0,1,.000,0,0,,0,0,,0,1,1,0,0,0,0,1,0,2009/2010
"Tolliver,Anthony",193,448,.431,50,151,.331,143,297,.481,103,134,.769,84,235,319,87,32,46,33,127,539,2009/2010
"Tucker,Alando",17,39,.436,1,7,.143,16,32,.500,16,21,.762,6,4,10,4,0,5,0,6,51,2009/2010
"Tucker,Alando",13,30,.433,1,7,.143,12,23,.522,16,21,.762,5,2,7,3,0,4,0,5,43,2009/2010
"Tucker,Alando",4,9,.444,0,0,,4,9,.444,0,0,,1,2,3,1,0,1,0,1,8,2009/2010
"Turiaf,Ronny",85,146,.582,0,1,.000,85,145,.586,37,78,.474,54,137,191,90,23,49,54,98,207,2009/2010
"Türkoğlu,Hedo",276,674,.409,108,289,.374,168,385,.436,175,226,.774,42,301,343,304,55,125,32,220,835,2009/2010
"Udoka,Ime",91,241,.378,26,91,.286,65,150,.433,42,57,.737,51,140,191,58,34,42,6,83,250,2009/2010
"Udrih,Beno",415,841,.493,75,199,.377,340,642,.530,118,141,.837,38,181,219,372,89,136,10,166,1023,2009/2010
"Ukić,Roko",14,30,.467,3,12,.250,11,18,.611,9,11,.818,0,3,3,12,1,6,0,6,40,2009/2010
"Varejão,Anderson",267,467,.572,1,5,.200,266,462,.576,116,175,.663,189,389,578,87,71,67,67,223,651,2009/2010
"Villanueva,Charlie",363,827,.439,99,282,.351,264,545,.484,106,130,.815,85,280,365,53,48,74,55,223,931,2009/2010
"Vujačić,Sasha",66,164,.402,25,81,.309,41,83,.494,28,33,.848,25,54,79,41,20,17,4,67,185,2009/2010
"Wade,Dwyane",719,1511,.476,73,243,.300,646,1268,.509,534,702,.761,107,266,373,501,142,252,82,181,2045,2009/2010
"Walker,Henry",120,232,.517,50,116,.431,70,116,.603,39,49,.796,15,73,88,40,23,28,3,83,329,2009/2010
"Walker,Henry",3,6,.500,0,0,,3,6,.500,2,2,1.000,0,5,5,3,0,2,0,4,8,2009/2010
"Walker,Henry",117,226,.518,50,116,.431,67,110,.609,37,47,.787,15,68,83,37,23,26,3,79,321,2009/2010
"Wallace,Ben",158,292,.541,0,2,.000,158,290,.545,65,160,.406,245,352,597,105,86,64,84,131,381,2009/2010
"Wallace,Gerald",456,943,.484,52,140,.371,404,803,.503,422,544,.776,150,612,762,161,117,178,83,194,1386,2009/2010
"Wallace,Rasheed",266,650,.409,82,290,.283,184,360,.511,96,125,.768,42,283,325,80,80,63,70,222,710,2009/2010
"Walton,Luke",30,84,.357,7,17,.412,23,67,.343,2,4,.500,12,26,38,40,10,12,1,19,69,2009/2010
"Warrick,Hakim",265,550,.482,1,7,.143,264,543,.486,202,274,.737,127,187,314,52,24,80,18,126,733,2009/2010
"Warrick,Hakim",182,378,.481,1,6,.167,181,372,.487,125,172,.727,87,125,212,35,17,57,10,83,490,2009/2010
"Warrick,Hakim",83,172,.483,0,1,.000,83,171,.485,77,102,.755,40,62,102,17,7,23,8,43,243,2009/2010
"Watson,C.J.",247,528,.468,45,145,.310,202,383,.527,128,166,.771,28,141,169,180,103,69,8,124,667,2009/2010
"Watson,Earl",223,524,.426,53,184,.288,170,340,.500,120,169,.710,54,186,240,399,104,175,16,181,619,2009/2010
"Weaver,Kyle",12,33,.364,7,19,.368,5,14,.357,5,6,.833,1,17,18,11,6,4,6,13,36,2009/2010
"Webster,Martell",259,639,.405,124,332,.373,135,307,.440,126,155,.813,47,221,268,62,45,60,40,153,768,2009/2010
"Weems,Sonny",236,458,.515,2,15,.133,234,443,.528,44,64,.688,42,150,192,101,39,65,25,126,518,2009/2010
"West,David",619,1226,.505,7,27,.259,612,1199,.510,296,342,.865,164,441,605,239,76,173,60,233,1541,2009/2010
"West,Delonte",194,436,.445,25,77,.325,169,359,.471,115,142,.810,29,140,169,196,55,90,28,86,528,2009/2010
"West,Mario",12,21,.571,0,1,.000,12,20,.600,6,10,.600,8,19,27,9,8,7,0,25,30,2009/2010
"Westbrook,Russell",485,1160,.418,23,104,.221,462,1056,.438,329,422,.780,143,258,401,652,108,268,34,204,1322,2009/2010
"White,D.J.",25,41,.610,0,0,,25,41,.610,9,10,.900,10,13,23,4,5,3,3,12,59,2009/2010
"Wilcox,Chris",63,120,.525,0,0,,63,120,.525,26,52,.500,44,73,117,13,13,38,12,64,152,2009/2010
"Wilkins,Damien",165,381,.433,18,61,.295,147,320,.459,103,129,.798,72,177,249,135,66,76,25,144,451,2009/2010
"Wilks,Mike",6,12,.500,2,3,.667,4,9,.444,2,4,.500,1,3,4,4,0,4,0,5,16,2009/2010
"Williams,Deron",494,1053,.469,96,259,.371,398,794,.501,335,418,.801,50,253,303,798,96,252,16,208,1419,2009/2010
"Williams,Jason",189,426,.444,84,221,.380,105,205,.512,31,41,.756,7,119,126,298,53,87,3,65,493,2009/2010
"Williams,Jawad",81,206,.393,30,93,.323,51,113,.451,32,45,.711,16,67,83,34,12,18,5,73,224,2009/2010
"Williams,Lou",318,677,.470,70,206,.340,248,471,.527,192,233,.824,25,162,187,268,80,106,15,110,898,2009/2010
"Williams,Marcus",104,271,.384,24,81,.296,80,190,.421,37,55,.673,13,80,93,161,32,74,1,43,269,2009/2010
"Williams,Marvin",302,664,.455,40,132,.303,262,532,.492,176,215,.819,106,310,416,93,66,72,46,160,820,2009/2010
"Williams,Mo",378,855,.442,159,371,.429,219,484,.452,177,198,.894,28,178,206,368,70,173,21,170,1092,2009/2010
"Williams,Reggie",140,283,.495,33,92,.359,107,191,.560,52,62,.839,18,92,110,66,23,29,6,49,365,2009/2010
"Williams,Sean",21,49,.429,0,1,.000,21,48,.438,10,19,.526,21,25,46,1,8,20,19,41,52,2009/2010
"Williams,Shelden",63,121,.521,0,1,.000,63,120,.525,75,98,.765,47,99,146,21,13,30,21,85,201,2009/2010
"Williams,Terrence",261,651,.401,31,100,.310,230,551,.417,103,144,.715,46,302,348,223,43,124,10,126,656,2009/2010
"World Peace,Metta",306,740,.414,105,296,.355,201,444,.453,128,186,.688,99,232,331,234,106,121,21,165,845,2009/2010
"Wright,Antoine",162,399,.406,58,173,.335,104,226,.460,53,77,.688,38,152,190,71,30,58,11,134,435,2009/2010
"Wright,Dorell",194,419,.463,61,157,.389,133,262,.508,61,69,.884,50,185,235,91,52,53,32,94,510,2009/2010
"Wright,Julian",116,232,.500,2,6,.333,114,226,.504,25,41,.610,58,86,144,41,29,44,18,45,259,2009/2010
"Young,Nick",233,558,.418,69,170,.406,164,388,.423,104,130,.800,20,82,102,48,28,56,8,147,639,2009/2010
"Young,Sam",224,497,.451,11,56,.196,213,441,.483,136,175,.777,77,124,201,52,34,94,20,106,595,2009/2010
"Young,Thaddeus",382,813,.470,48,138,.348,334,675,.495,114,165,.691,130,220,350,97,81,126,15,133,926,2009/2010
"Adrien,Jeff",23,54,.426,0,0,,23,54,.426,11,19,.579,23,35,58,10,4,9,5,28,57,2010/2011
"Afflalo,Arron",312,627,.498,105,248,.423,207,379,.546,138,163,.847,45,206,251,168,34,71,31,153,867,2010/2011
"Ager,Maurice",6,11,.545,3,4,.750,3,7,.429,0,0,,0,2,2,1,1,4,0,4,15,2010/2011
"Ajinça,Alexis",59,133,.444,12,34,.353,47,99,.475,13,18,.722,17,61,78,10,11,18,19,73,143,2010/2011
"Ajinça,Alexis",12,32,.375,3,7,.429,9,25,.360,2,3,.667,5,12,17,2,3,1,5,13,29,2010/2011
"Ajinça,Alexis",47,101,.465,9,27,.333,38,74,.514,11,15,.733,12,49,61,8,8,17,14,60,114,2010/2011
"Alabi,Solomon",3,15,.200,0,0,,3,15,.200,0,2,.000,7,7,14,2,2,3,2,5,6,2010/2011
"Aldrich,Cole",8,15,.533,0,0,,8,15,.533,2,4,.500,13,22,35,4,5,8,7,30,18,2010/2011
"Aldridge,LaMarcus",707,1415,.500,4,23,.174,703,1392,.505,351,444,.791,278,431,709,170,82,153,94,220,1769,2010/2011
"Allen,Malik",11,31,.355,0,0,,11,31,.355,1,2,.500,12,20,32,4,1,3,4,30,23,2010/2011
"Allen,Ray",480,978,.491,168,378,.444,312,600,.520,193,219,.881,51,223,274,219,77,117,16,147,1321,2010/2011
"Allen,Tony",251,492,.510,4,23,.174,247,469,.527,137,182,.753,70,123,193,104,129,86,44,161,643,2010/2011
"Aminu,Al-Farouq",160,406,.394,45,143,.315,115,263,.437,92,119,.773,75,192,267,60,59,103,25,121,457,2010/2011
"Amundson,Lou",83,183,.454,0,0,,83,183,.454,34,87,.391,81,104,185,17,14,24,33,87,200,2010/2011
"Andersen,Chris",82,137,.599,0,1,.000,82,136,.603,86,135,.637,75,144,219,20,23,25,58,79,250,2010/2011
"Andersen,David",56,121,.463,8,23,.348,48,98,.490,14,22,.636,20,64,84,13,5,22,9,40,134,2010/2011
"Andersen,David",23,47,.489,3,10,.300,20,37,.541,7,7,1.000,8,26,34,7,3,8,3,11,56,2010/2011
"Andersen,David",33,74,.446,5,13,.385,28,61,.459,7,15,.467,12,38,50,6,2,14,6,29,78,2010/2011
"Anderson,James",31,81,.383,18,46,.391,13,35,.371,14,18,.778,2,21,23,18,3,13,6,24,94,2010/2011
"Anderson,Ryan",226,525,.430,134,341,.393,92,184,.500,95,117,.812,129,226,355,52,30,49,38,137,681,2010/2011
"Anthony,Carmelo",684,1503,.455,95,251,.378,589,1252,.470,507,605,.838,118,445,563,221,68,206,46,224,1970,2010/2011
"Anthony,Carmelo",437,967,.452,42,126,.333,395,841,.470,343,417,.823,77,305,382,140,43,142,31,134,1259,2010/2011
"Anthony,Carmelo",247,536,.461,53,125,.424,194,411,.472,164,188,.872,41,140,181,81,25,64,15,90,711,2010/2011
"Anthony,Joel",53,99,.535,0,0,,53,99,.535,47,73,.644,104,162,266,24,10,36,93,194,153,2010/2011
"Arenas,Gilbert",269,734,.366,97,327,.297,172,407,.423,120,153,.784,22,167,189,274,74,177,21,188,755,2010/2011
"Arenas,Gilbert",130,330,.394,47,145,.324,83,185,.449,56,67,.836,6,64,70,117,30,71,12,76,363,2010/2011
"Arenas,Gilbert",139,404,.344,50,182,.275,89,222,.401,64,86,.744,16,103,119,157,44,106,9,112,392,2010/2011
"Ariza,Trevor",303,762,.398,82,271,.303,221,491,.450,138,197,.701,61,347,408,162,120,118,31,180,826,2010/2011
"Armstrong,Hilton",37,76,.487,2,4,.500,35,72,.486,16,33,.485,42,89,131,14,18,28,21,84,92,2010/2011
"Armstrong,Hilton",31,64,.484,1,3,.333,30,61,.492,14,23,.609,39,75,114,10,15,25,16,75,77,2010/2011
"Armstrong,Hilton",6,12,.500,1,1,1.000,5,11,.455,2,10,.200,3,14,17,4,3,3,5,9,15,2010/2011
"Arroyo,Carlos",120,273,.440,31,69,.449,89,204,.436,39,47,.830,20,83,103,125,21,60,1,71,310,2010/2011
"Arroyo,Carlos",109,238,.458,28,64,.438,81,174,.466,28,35,.800,13,67,80,100,14,43,1,60,274,2010/2011
"Arroyo,Carlos",11,35,.314,3,5,.600,8,30,.267,11,12,.917,7,16,23,25,7,17,0,11,36,2010/2011
"Arthur,Darrell",310,624,.497,0,6,.000,310,618,.502,109,134,.813,115,227,342,53,52,88,63,228,729,2010/2011
"Aşık,Ömer",78,141,.553,0,0,,78,141,.553,73,145,.503,112,194,306,32,20,64,56,153,229,2010/2011
"Augustin,D.J.",399,958,.416,111,333,.333,288,625,.461,269,297,.906,38,187,225,498,54,155,3,152,1178,2010/2011
"Babbitt,Luke",15,55,.273,3,16,.188,12,39,.308,3,9,.333,6,24,30,6,2,8,2,15,36,2010/2011
"Balkman,Renaldo",6,13,.462,1,2,.500,5,11,.455,3,4,.750,2,5,7,2,4,1,2,15,16,2010/2011
"Balkman,Renaldo",5,9,.556,0,0,,5,9,.556,3,4,.750,1,3,4,2,3,0,2,11,13,2010/2011
"Balkman,Renaldo",1,4,.250,1,2,.500,0,2,.000,0,0,,1,2,3,0,1,1,0,4,3,2010/2011
"Banks,Marcus",0,2,.000,0,0,,0,2,.000,6,8,.750,0,1,1,3,1,2,0,4,6,2010/2011
"Barbosa,Leandro",294,653,.450,72,213,.338,222,440,.505,109,137,.796,14,85,99,119,50,84,6,112,769,2010/2011
"Barea,J.J.",285,649,.439,66,189,.349,219,460,.476,133,157,.847,29,130,159,317,30,136,1,136,769,2010/2011
"Bargnani,Andrea",525,1173,.448,77,223,.345,448,950,.472,287,350,.820,74,269,343,119,34,152,46,160,1414,2010/2011
"Barnes,Matt",131,279,.470,34,107,.318,97,172,.564,60,77,.779,73,155,228,71,39,58,22,127,356,2010/2011
"Barron,Earl",32,99,.323,0,0,,32,99,.323,15,24,.625,32,44,76,11,8,16,6,46,79,2010/2011
"Barron,Earl",12,51,.235,0,0,,12,51,.235,12,20,.600,16,24,40,4,6,11,4,32,36,2010/2011
"Barron,Earl",17,37,.459,0,0,,17,37,.459,2,2,1.000,12,10,22,4,2,2,2,10,36,2010/2011
"Barron,Earl",3,11,.273,0,0,,3,11,.273,1,2,.500,4,10,14,3,0,3,0,4,7,2010/2011
"Bass,Brandon",332,645,.515,0,2,.000,332,643,.516,190,233,.815,134,290,424,57,27,97,52,159,854,2010/2011
"Battie,Tony",45,96,.469,2,3,.667,43,93,.462,8,14,.571,17,82,99,12,5,12,15,59,100,2010/2011
"Battier,Shane",229,509,.450,102,267,.382,127,242,.525,64,93,.688,90,283,373,185,69,79,81,158,624,2010/2011
"Battier,Shane",186,408,.456,88,225,.391,98,183,.536,49,76,.645,58,223,281,153,53,63,71,127,509,2010/2011
"Battier,Shane",43,101,.426,14,42,.333,29,59,.492,15,17,.882,32,60,92,32,16,16,10,31,115,2010/2011
"Batum,Nicolas",367,807,.455,118,342,.345,249,465,.535,138,164,.841,109,252,361,123,68,83,49,194,990,2010/2011
"Bayless,Jerryd",218,517,.422,49,146,.336,169,371,.456,166,206,.806,26,139,165,266,38,127,5,149,651,2010/2011
"Bayless,Jerryd",17,49,.347,3,14,.214,14,35,.400,13,17,.765,2,13,15,28,2,17,1,16,50,2010/2011
"Bayless,Jerryd",201,468,.429,46,132,.348,155,336,.461,153,189,.810,24,126,150,238,36,110,4,133,601,2010/2011
"Beasley,Michael",561,1246,.450,60,164,.366,501,1082,.463,219,291,.753,118,291,409,158,54,195,52,222,1401,2010/2011
"Beaubois,Rodrigue",94,223,.422,25,83,.301,69,140,.493,23,30,.767,7,45,52,64,20,47,8,76,236,2010/2011
"Belinelli,Marco",302,691,.437,134,324,.414,168,367,.458,98,125,.784,17,134,151,92,38,77,6,146,836,2010/2011
"Bell,Charlie",12,43,.279,6,21,.286,6,22,.273,2,4,.500,6,12,18,13,6,6,1,13,32,2010/2011
"Bell,Raja",191,467,.409,68,193,.352,123,274,.449,91,102,.892,31,145,176,118,56,63,14,169,541,2010/2011
"Bibby,Mike",248,576,.431,153,348,.440,95,228,.417,39,62,.629,17,178,195,265,50,101,9,175,688,2010/2011
"Bibby,Mike",192,441,.435,113,256,.441,79,185,.427,29,46,.630,15,128,143,202,38,68,6,125,526,2010/2011
"Bibby,Mike",1,9,.111,0,4,.000,1,5,.200,0,0,,0,3,3,8,1,1,0,3,2,2010/2011
"Bibby,Mike",55,126,.437,40,88,.455,15,38,.395,10,16,.625,2,47,49,55,11,32,3,47,160,2010/2011
"Biedriņš,Andris",142,266,.534,0,0,,142,266,.534,10,31,.323,145,281,426,60,52,57,52,198,294,2010/2011
"Billups,Chauncey",339,794,.427,146,363,.402,193,431,.448,384,419,.916,25,165,190,387,71,177,14,146,1208,2010/2011
"Billups,Chauncey",235,536,.438,105,238,.441,130,298,.436,265,287,.923,12,113,125,271,52,129,12,94,840,2010/2011
"Billups,Chauncey",104,258,.403,41,125,.328,63,133,.474,119,132,.902,13,52,65,116,19,48,2,52,368,2010/2011
"Blair,DeJuan",292,583,.501,0,2,.000,292,581,.503,90,137,.657,215,350,565,77,95,113,42,213,674,2010/2011
"Blake,Steve",110,306,.359,73,193,.378,37,113,.327,26,30,.867,19,137,156,170,40,73,3,99,319,2010/2011
"Blatche,Andray",426,957,.445,4,18,.222,422,939,.449,220,283,.777,183,343,526,144,98,172,51,182,1076,2010/2011
"Bledsoe,Eric",206,486,.424,32,116,.276,174,370,.470,99,133,.744,68,155,223,289,92,194,26,130,543,2010/2011
"Bogans,Keith",124,307,.404,90,237,.380,34,70,.486,21,32,.656,19,129,148,101,38,41,9,113,359,2010/2011
"Bogut,Andrew",367,742,.495,0,4,.000,367,738,.497,96,217,.442,199,521,720,131,47,125,168,217,830,2010/2011
"Bonner,Matt",172,371,.464,105,230,.457,67,141,.475,32,43,.744,60,179,239,60,26,27,21,110,481,2010/2011
"Booker,Trevor",139,253,.549,0,1,.000,139,252,.552,68,101,.673,98,153,251,35,29,38,42,115,346,2010/2011
"Boozer,Carlos",431,845,.510,0,0,,431,845,.510,171,244,.701,130,435,565,145,45,149,18,186,1033,2010/2011
"Bosh,Chris",524,1056,.496,6,25,.240,518,1031,.502,384,471,.815,141,500,641,144,59,138,49,172,1438,2010/2011
"Boykins,Earl",156,352,.443,27,71,.380,129,281,.459,69,82,.841,15,40,55,141,38,52,3,43,408,2010/2011
"Brackins,Craig",4,16,.250,0,5,.000,4,11,.364,0,0,,2,2,4,1,1,0,0,3,8,2010/2011
"Bradley,Avery",23,67,.343,0,5,.000,23,62,.371,6,12,.500,4,13,17,12,9,16,0,20,52,2010/2011
"Brand,Elton",502,981,.512,0,1,.000,502,980,.512,213,273,.780,237,439,676,120,92,101,106,244,1217,2010/2011
"Brewer,Corey",193,488,.395,30,112,.268,163,376,.434,136,192,.708,57,118,175,89,100,87,16,159,552,2010/2011
"Brewer,Corey",168,437,.384,26,99,.263,142,338,.420,121,171,.708,45,107,152,77,89,77,14,134,483,2010/2011
"Brewer,Corey",25,51,.490,4,13,.308,21,38,.553,15,21,.714,12,11,23,12,11,10,2,25,69,2010/2011
"Brewer,Ronnie",205,427,.480,6,27,.222,199,400,.498,87,133,.654,55,207,262,140,106,55,22,82,503,2010/2011
"Brockman,Jon",48,94,.511,0,0,,48,94,.511,40,59,.678,74,110,184,18,14,24,3,119,136,2010/2011
"Brooks,Aaron",220,587,.375,70,236,.297,150,351,.427,124,140,.886,20,58,78,233,34,99,3,115,634,2010/2011
"Brooks,Aaron",134,387,.346,48,169,.284,86,218,.394,78,83,.940,11,40,51,129,21,55,2,69,394,2010/2011
"Brooks,Aaron",86,200,.430,22,67,.328,64,133,.481,46,57,.807,9,18,27,104,13,44,1,46,240,2010/2011
"Brown,Derrick",74,131,.565,5,10,.500,69,121,.570,32,60,.533,41,58,99,33,20,35,10,59,185,2010/2011
"Brown,Derrick",62,113,.549,2,6,.333,60,107,.561,25,47,.532,32,52,84,29,16,28,8,48,151,2010/2011
"Brown,Derrick",12,18,.667,3,4,.750,9,14,.643,7,13,.538,9,6,15,4,4,7,2,11,34,2010/2011
"Brown,Kwame",194,375,.517,0,0,,194,375,.517,136,231,.589,147,303,450,43,26,69,39,174,524,2010/2011
"Brown,Shannon",273,643,.425,74,212,.349,199,431,.462,92,101,.911,35,122,157,96,67,75,16,124,712,2010/2011
"Bryant,Kobe",740,1639,.451,115,356,.323,625,1283,.487,483,583,.828,83,336,419,388,99,243,12,172,2078,2010/2011
"Budinger,Chase",279,656,.425,89,274,.325,190,382,.497,118,138,.855,52,229,281,127,41,67,18,114,765,2010/2011
"Butler,Caron",170,378,.450,28,65,.431,142,313,.454,68,88,.773,22,96,118,46,28,49,8,59,436,2010/2011
"Butler,Rasual",79,237,.333,46,136,.338,33,101,.327,18,27,.667,10,67,77,27,8,24,15,37,222,2010/2011
"Butler,Rasual",73,226,.323,42,129,.326,31,97,.320,18,27,.667,10,66,76,27,8,22,15,34,206,2010/2011
"Butler,Rasual",6,11,.545,4,7,.571,2,4,.500,0,0,,0,1,1,0,0,2,0,3,16,2010/2011
"Bynum,Andrew",237,413,.574,0,0,,237,413,.574,138,209,.660,170,338,508,73,19,74,106,140,612,2010/2011
"Bynum,Will",182,406,.448,16,50,.320,166,356,.466,102,122,.836,15,59,74,195,52,83,4,113,482,2010/2011
"Calderón,José",262,596,.440,57,156,.365,205,440,.466,88,103,.854,30,172,202,605,81,148,7,143,669,2010/2011
"Camby,Marcus",117,294,.398,0,1,.000,117,293,.399,43,70,.614,182,424,606,121,40,62,92,140,277,2010/2011
"Caracter,Derrick",32,66,.485,0,0,,32,66,.485,17,23,.739,19,24,43,7,4,19,10,47,81,2010/2011
"Cardinal,Brian",43,100,.430,42,87,.483,1,13,.077,17,18,.944,10,49,59,40,24,17,7,82,145,2010/2011
"Carney,Rodney",46,110,.418,17,38,.447,29,72,.403,18,27,.667,13,35,48,11,12,16,5,33,127,2010/2011
"Carney,Rodney",45,107,.421,17,37,.459,28,70,.400,18,27,.667,12,35,47,11,11,16,5,33,125,2010/2011
"Carney,Rodney",1,3,.333,0,1,.000,1,2,.500,0,0,,1,0,1,0,1,0,0,0,2,2010/2011
"Carroll,DeMarre",4,12,.333,0,0,,4,12,.333,2,2,1.000,2,6,8,4,1,0,1,5,10,2010/2011
"Carroll,DeMarre",4,9,.444,0,0,,4,9,.444,2,2,1.000,2,6,8,2,1,0,1,5,10,2010/2011
"Carroll,DeMarre",0,3,.000,0,0,,0,3,.000,0,0,,0,0,0,2,0,0,0,0,0,2010/2011
"Carroll,Matt",89,199,.447,17,46,.370,72,153,.471,40,52,.769,12,56,68,23,17,23,6,43,235,2010/2011
"Carter,Anthony",45,106,.425,12,40,.300,33,66,.500,8,8,1.000,7,44,51,69,27,39,6,49,110,2010/2011
"Carter,Anthony",10,30,.333,4,12,.333,6,18,.333,2,2,1.000,0,12,12,26,9,14,1,19,26,2010/2011
"Carter,Anthony",35,76,.461,8,28,.286,27,48,.563,6,6,1.000,7,32,39,43,18,25,5,30,84,2010/2011
"Carter,Vince",389,891,.437,116,321,.361,273,570,.479,128,173,.740,54,221,275,146,67,90,20,193,1022,2010/2011
"Carter,Vince",125,266,.470,27,78,.346,98,188,.521,56,75,.747,11,79,90,64,20,36,3,70,333,2010/2011
"Carter,Vince",264,625,.422,89,243,.366,175,382,.458,72,98,.735,43,142,185,82,47,54,17,123,689,2010/2011
"Casspi,Omri",225,546,.412,92,247,.372,133,299,.445,68,101,.673,74,233,307,74,54,68,13,115,610,2010/2011
"Chalmers,Mario",155,388,.399,83,231,.359,72,157,.459,54,62,.871,12,134,146,177,76,91,7,158,447,2010/2011
"Chandler,Tyson",266,407,.654,0,0,,266,407,.654,216,295,.732,206,486,692,32,36,88,80,240,748,2010/2011
"Chandler,Wilson",429,953,.450,112,320,.350,317,633,.501,130,161,.807,75,333,408,120,48,104,94,199,1100,2010/2011
"Chandler,Wilson",328,712,.461,86,245,.351,242,467,.518,96,119,.807,62,241,303,86,34,67,70,152,838,2010/2011
"Chandler,Wilson",101,241,.419,26,75,.347,75,166,.452,34,42,.810,13,92,105,34,14,37,24,47,262,2010/2011
"Childress,Josh",121,214,.565,1,16,.063,120,198,.606,29,59,.492,69,86,155,42,33,44,23,68,272,2010/2011
"Clark,Earl",68,158,.430,0,5,.000,68,153,.444,27,47,.574,37,64,101,9,8,28,18,45,163,2010/2011
"Clark,Earl",12,31,.387,0,0,,12,31,.387,5,10,.500,4,13,17,4,1,2,3,6,29,2010/2011
"Clark,Earl",56,127,.441,0,5,.000,56,122,.459,22,37,.595,33,51,84,5,7,26,15,39,134,2010/2011
"Collins,Jarron",6,21,.286,0,0,,6,21,.286,7,10,.700,14,10,24,2,4,7,1,29,19,2010/2011
"Collins,Jarron",5,15,.333,0,0,,5,15,.333,7,10,.700,7,10,17,1,4,5,1,24,17,2010/2011
"Collins,Jarron",1,6,.167,0,0,,1,6,.167,0,0,,7,0,7,1,0,2,0,5,2,2010/2011
"Collins,Jason",34,71,.479,1,1,1.000,33,70,.471,27,41,.659,30,72,102,22,9,26,9,97,96,2010/2011
"Collins,Sherron",7,25,.280,2,10,.200,5,15,.333,1,1,1.000,0,5,5,8,2,4,0,2,17,2010/2011
"Collison,Darren",398,870,.457,41,124,.331,357,746,.479,202,232,.871,40,185,225,403,87,194,14,109,1039,2010/2011
"Collison,Nick",137,242,.566,0,0,,137,242,.566,55,73,.753,119,197,316,69,42,55,31,210,329,2010/2011
"Conley,Mike",423,953,.444,80,217,.369,343,736,.466,181,247,.733,32,215,247,528,144,176,18,182,1107,2010/2011
"Cook,Brian",72,170,.424,34,79,.430,38,91,.418,15,24,.625,19,77,96,15,12,25,11,75,193,2010/2011
"Cook,Daequan",79,181,.436,65,154,.422,14,27,.519,16,20,.800,8,64,72,20,14,17,1,51,239,2010/2011
"Cousin,Marcus",2,3,.667,0,0,,2,3,.667,0,0,,0,3,3,0,0,1,1,1,4,2010/2011
"Cousins,DeMarcus",432,1004,.430,3,18,.167,429,986,.435,276,402,.687,217,482,699,204,85,268,68,332,1143,2010/2011
"Crawford,Jamal",368,874,.421,119,349,.341,249,525,.474,222,260,.854,22,108,130,241,57,145,14,97,1077,2010/2011
"Crawford,Jordan",192,500,.384,33,128,.258,159,372,.427,73,84,.869,31,74,105,117,39,83,3,63,490,2010/2011
"Crawford,Jordan",27,77,.351,9,27,.333,18,50,.360,4,6,.667,9,19,28,15,3,15,0,13,67,2010/2011
"Crawford,Jordan",165,423,.390,24,101,.238,141,322,.438,69,78,.885,22,55,77,102,36,68,3,50,423,2010/2011
"Cunningham,Dante",218,472,.462,1,13,.077,217,459,.473,45,62,.726,96,181,277,43,54,51,43,177,482,2010/2011
"Cunningham,Dante",126,291,.433,0,4,.000,126,287,.439,32,45,.711,73,116,189,30,39,33,32,139,284,2010/2011
"Cunningham,Dante",92,181,.508,1,9,.111,91,172,.529,13,17,.765,23,65,88,13,15,18,11,38,198,2010/2011
"Curry,Stephen",505,1053,.480,151,342,.442,354,711,.498,212,227,.934,52,234,286,432,109,226,20,233,1373,2010/2011
"Dalembert,Samuel",268,567,.473,0,2,.000,268,565,.474,108,148,.730,212,445,657,67,36,132,116,225,644,2010/2011
"Dampier,Erick",52,89,.584,0,1,.000,52,88,.591,24,44,.545,53,124,177,22,14,32,47,82,128,2010/2011
"Daniels,Antonio",2,5,.400,0,2,.000,2,3,.667,2,2,1.000,0,5,5,2,0,1,0,0,6,2010/2011
"Daniels,Marquis",114,232,.491,4,21,.190,110,211,.521,39,57,.684,24,89,113,64,39,38,22,63,271,2010/2011
"Davis,Baron",289,693,.417,81,239,.339,208,454,.458,101,131,.771,35,121,156,391,78,146,28,143,760,2010/2011
"Davis,Baron",214,515,.416,45,152,.296,169,363,.466,79,104,.760,29,91,120,299,62,107,22,114,552,2010/2011
"Davis,Baron",75,178,.421,36,87,.414,39,91,.429,22,27,.815,6,30,36,92,16,39,6,29,208,2010/2011
"Davis,Ed",215,373,.576,0,0,,215,373,.576,71,128,.555,168,294,462,40,39,48,67,183,501,2010/2011
"Davis,Glen",359,801,.448,2,15,.133,357,786,.454,195,265,.736,101,324,425,92,78,85,30,231,915,2010/2011
"Daye,Austin",193,471,.410,69,172,.401,124,299,.415,82,108,.759,64,210,274,78,39,59,39,165,537,2010/2011
"Delfino,Carlos",200,513,.390,105,284,.370,95,229,.415,60,75,.800,24,176,200,112,76,57,8,72,565,2010/2011
"Deng,Luol",531,1155,.460,115,333,.345,416,822,.506,253,336,.753,116,360,476,230,78,156,48,162,1430,2010/2011
"DeRozan,DeMar",539,1154,.467,5,52,.096,534,1102,.485,327,402,.813,75,240,315,148,85,144,31,217,1410,2010/2011
"Diaw,Boris",381,774,.492,78,226,.345,303,548,.553,84,123,.683,105,309,414,337,74,166,46,190,924,2010/2011
"Diogu,Ike",83,148,.561,0,0,,83,148,.561,41,62,.661,41,74,115,2,3,22,3,72,207,2010/2011
"Diop,DeSagana",8,24,.333,0,0,,8,24,.333,4,11,.364,12,28,40,7,4,11,15,26,20,2010/2011
"Dooling,Keyon",206,519,.397,81,234,.346,125,285,.439,78,94,.830,12,105,117,243,54,91,4,119,571,2010/2011
"Dorsey,Joey",52,99,.525,0,0,,52,99,.525,31,65,.477,79,111,190,27,24,39,17,78,135,2010/2011
"Douglas,Toney",314,755,.416,143,383,.373,171,372,.460,85,107,.794,65,179,244,244,89,89,4,177,856,2010/2011
"Douglas-Roberts,Chris",117,273,.429,15,46,.326,102,227,.449,74,89,.831,7,81,88,50,29,35,13,73,323,2010/2011
"Dowdell,Zabian",51,125,.408,3,10,.300,48,115,.417,16,17,.941,5,15,20,51,20,29,2,30,121,2010/2011
"Dragić,Goran",192,441,.435,56,155,.361,136,286,.476,83,133,.624,36,106,142,204,50,117,10,125,523,2010/2011
"Dragić,Goran",133,316,.421,28,101,.277,105,215,.488,59,97,.608,24,62,86,149,36,96,6,90,353,2010/2011
"Dragić,Goran",59,125,.472,28,54,.519,31,71,.437,24,36,.667,12,44,56,55,14,21,4,35,170,2010/2011
"Dudley,Jared",300,629,.477,105,253,.415,195,376,.519,162,218,.743,111,207,318,108,87,77,20,139,867,2010/2011
"Duhon,Chris",49,129,.380,13,52,.250,36,77,.468,14,25,.560,9,43,52,118,16,61,2,30,125,2010/2011
"Duncan,Tim",419,838,.500,0,4,.000,419,834,.502,184,257,.716,169,509,678,203,50,122,146,119,1022,2010/2011
"Dunleavy,Mike",240,520,.462,102,254,.402,138,266,.519,100,125,.800,28,248,276,105,40,69,30,107,682,2010/2011
"Dupree,Ronald",1,4,.250,0,1,.000,1,3,.333,0,0,,0,3,3,1,0,0,0,2,2,2010/2011
"Durant,Kevin",711,1538,.462,145,414,.350,566,1124,.504,594,675,.880,57,476,533,214,88,218,76,159,2161,2010/2011
"Ebanks,Devin",21,51,.412,2,5,.400,19,46,.413,18,23,.783,15,12,27,2,4,6,5,7,62,2010/2011
"Ellington,Wayne",160,397,.403,48,121,.397,112,276,.406,42,53,.792,26,82,108,72,28,53,3,85,410,2010/2011
"Ellis,Monta",726,1611,.451,137,379,.361,589,1232,.478,340,431,.789,44,237,281,450,168,252,23,203,1929,2010/2011
"Elson,Francisco",54,113,.478,0,0,,54,113,.478,26,31,.839,35,80,115,33,21,32,14,84,134,2010/2011
"Ely,Melvin",28,51,.549,0,0,,28,51,.549,13,21,.619,27,47,74,14,4,14,11,50,69,2010/2011
"Erden,Semih",62,111,.559,0,0,,62,111,.559,39,60,.650,37,81,118,20,15,34,24,104,163,2010/2011
"Erden,Semih",58,97,.598,0,0,,58,97,.598,34,54,.630,31,76,107,19,13,32,21,92,150,2010/2011
"Erden,Semih",4,14,.286,0,0,,4,14,.286,5,6,.833,6,5,11,1,2,2,3,12,13,2010/2011
"Evans,Jeremy",76,115,.661,0,1,.000,76,114,.667,26,37,.703,36,61,97,24,17,19,17,50,178,2010/2011
"Evans,Maurice",177,424,.417,55,167,.329,122,257,.475,52,58,.897,52,104,156,45,34,33,14,129,461,2010/2011
"Evans,Maurice",79,201,.393,28,89,.315,51,112,.455,24,28,.857,23,61,84,30,16,15,5,74,210,2010/2011
"Evans,Maurice",98,223,.439,27,78,.346,71,145,.490,28,30,.933,29,43,72,15,18,18,9,55,251,2010/2011
"Evans,Reggie",42,103,.408,0,1,.000,42,102,.412,48,88,.545,119,226,345,38,29,39,6,89,132,2010/2011
"Evans,Tyreke",382,933,.409,43,148,.291,339,785,.432,205,266,.771,46,229,275,319,85,184,30,143,1012,2010/2011
"Ewing,Patrick",0,5,.000,0,2,.000,0,3,.000,3,4,.750,1,1,2,2,0,1,1,1,3,2010/2011
"Eyenga,Christian",130,306,.425,25,91,.275,105,215,.488,18,28,.643,27,96,123,35,34,47,28,78,303,2010/2011
"Farmar,Jordan",255,651,.392,109,304,.359,146,347,.421,82,100,.820,24,149,173,368,62,139,6,128,701,2010/2011
"Favors,Derrick",215,416,.517,0,0,,215,416,.517,103,173,.595,171,241,412,39,29,77,68,246,533,2010/2011
"Favors,Derrick",141,276,.511,0,0,,141,276,.511,71,116,.612,126,171,297,21,18,56,41,183,353,2010/2011
"Favors,Derrick",74,140,.529,0,0,,74,140,.529,32,57,.561,45,70,115,18,11,21,27,63,180,2010/2011
"Felton,Raymond",427,1005,.425,116,329,.353,311,676,.460,194,241,.805,48,221,269,625,125,221,11,150,1164,2010/2011
"Felton,Raymond",339,801,.423,88,268,.328,251,533,.471,157,181,.867,40,154,194,488,97,176,11,113,923,2010/2011
"Felton,Raymond",88,204,.431,28,61,.459,60,143,.420,37,60,.617,8,67,75,137,28,45,0,37,241,2010/2011
"Fernández,Rudy",213,575,.370,116,361,.321,97,214,.453,126,146,.863,37,135,172,193,87,88,14,134,668,2010/2011
"Fesenko,Kyrylo",44,100,.440,0,1,.000,44,99,.444,18,46,.391,34,74,108,18,4,25,16,90,106,2010/2011
"Fields,Landry",299,602,.497,86,219,.393,213,383,.556,113,147,.769,105,416,521,155,80,107,17,114,797,2010/2011
"Fisher,Derek",206,529,.389,63,159,.396,143,370,.386,83,103,.806,14,138,152,224,99,70,8,192,558,2010/2011
"Flynn,Jonny",108,296,.365,31,100,.310,77,196,.393,32,42,.762,12,65,77,182,34,113,3,58,279,2010/2011
"Forbes,Gary",124,273,.454,19,58,.328,105,215,.488,59,87,.678,28,88,116,49,23,46,6,77,326,2010/2011
"Ford,T.J.",91,236,.386,6,32,.188,85,204,.417,35,48,.729,17,64,81,141,35,63,8,69,223,2010/2011
"Foster,Jeff",80,167,.479,0,3,.000,80,164,.488,27,48,.563,160,190,350,46,24,26,31,127,187,2010/2011
"Foye,Randy",206,531,.388,71,217,.327,135,314,.430,133,149,.893,13,90,103,170,47,95,21,122,616,2010/2011
"Frye,Channing",358,829,.432,171,439,.390,187,390,.479,89,107,.832,65,448,513,96,46,73,79,272,976,2010/2011
"Gadzuric,Dan",54,129,.419,0,1,.000,54,128,.422,10,27,.370,71,64,135,14,13,29,29,91,118,2010/2011
"Gadzuric,Dan",37,88,.420,0,1,.000,37,87,.425,5,14,.357,53,33,86,11,10,21,18,63,79,2010/2011
"Gadzuric,Dan",17,41,.415,0,0,,17,41,.415,5,13,.385,18,31,49,3,3,8,11,28,39,2010/2011
"Gaines,Sundiata",42,105,.400,9,38,.237,33,67,.493,18,36,.500,13,25,38,42,16,27,1,25,111,2010/2011
"Gaines,Sundiata",7,22,.318,2,6,.333,5,16,.313,5,10,.500,1,5,6,6,3,6,0,4,21,2010/2011
"Gaines,Sundiata",15,35,.429,3,15,.200,12,20,.600,2,6,.333,2,6,8,11,4,8,1,10,35,2010/2011
"Gaines,Sundiata",20,48,.417,4,17,.235,16,31,.516,11,20,.550,10,14,24,25,9,13,0,11,55,2010/2011
"Gallinari,Danilo",265,640,.414,103,293,.352,162,347,.467,337,391,.862,59,246,305,104,51,83,27,144,970,2010/2011
"Gallinari,Danilo",211,509,.415,83,239,.347,128,270,.474,259,290,.893,48,181,229,82,38,58,18,117,764,2010/2011
"Gallinari,Danilo",54,131,.412,20,54,.370,34,77,.442,78,101,.772,11,65,76,22,13,25,9,27,206,2010/2011
"García,Francisco",207,475,.436,81,224,.362,126,251,.502,65,76,.855,24,109,133,71,51,45,49,126,560,2010/2011
"Garnett,Kevin",434,822,.528,1,5,.200,433,817,.530,187,217,.862,83,548,631,171,95,115,57,148,1056,2010/2011
"Gasol,Marc",364,691,.527,3,7,.429,361,684,.528,220,294,.748,154,415,569,200,74,146,136,265,951,2010/2011
"Gasol,Pau",593,1120,.529,1,3,.333,592,1117,.530,354,430,.823,268,568,836,273,48,142,130,203,1541,2010/2011
"Gay,Rudy",409,869,.471,57,144,.396,352,725,.486,194,241,.805,82,254,336,153,91,135,58,131,1069,2010/2011
"Gee,Alonzo",121,264,.458,17,51,.333,104,213,.488,72,92,.783,62,120,182,38,40,55,18,94,331,2010/2011
"Gee,Alonzo",1,3,.333,0,0,,1,3,.333,0,0,,2,1,3,0,0,3,2,3,2,2010/2011
"Gee,Alonzo",12,27,.444,0,2,.000,12,25,.480,8,12,.667,11,11,22,5,7,8,0,10,32,2010/2011
"Gee,Alonzo",108,234,.462,17,49,.347,91,185,.492,64,80,.800,49,108,157,33,33,44,16,81,297,2010/2011
"George,Paul",179,395,.453,41,138,.297,138,257,.537,77,101,.762,37,187,224,65,62,70,26,127,476,2010/2011
"Gibson,Daniel",264,660,.400,118,293,.403,146,367,.398,134,163,.822,24,153,177,201,48,80,21,154,780,2010/2011
"Gibson,Taj",234,502,.466,1,8,.125,233,494,.472,100,148,.676,162,296,458,58,39,71,106,203,569,2010/2011
"Ginóbili,Manu",441,1018,.433,154,441,.349,287,577,.497,357,410,.871,42,253,295,393,123,174,28,163,1393,2010/2011
"Gomes,Ryan",207,505,.410,72,211,.341,135,294,.459,61,85,.718,61,193,254,118,62,55,12,159,547,2010/2011
"Gooden,Drew",156,362,.431,3,20,.150,153,342,.447,81,102,.794,73,165,238,47,21,46,18,98,396,2010/2011
"Gordon,Ben",339,770,.440,107,266,.402,232,504,.460,136,160,.850,41,154,195,171,48,141,16,178,921,2010/2011
"Gordon,Eric",427,949,.450,106,291,.364,321,658,.488,287,348,.825,45,119,164,244,71,151,18,115,1247,2010/2011
"Gortat,Marcin",338,603,.561,1,4,.250,337,599,.563,140,193,.725,148,483,631,70,36,81,91,188,817,2010/2011
"Gortat,Marcin",44,81,.543,0,0,,44,81,.543,12,18,.667,38,80,118,17,7,17,21,52,100,2010/2011
"Gortat,Marcin",294,522,.563,1,4,.250,293,518,.566,128,175,.731,110,403,513,53,29,64,70,136,717,2010/2011
"Graham,Joey",82,179,.458,9,30,.300,73,149,.490,29,36,.806,8,76,84,18,6,28,7,73,202,2010/2011
"Graham,Stephen",81,200,.405,5,21,.238,76,179,.425,31,38,.816,17,106,123,40,14,38,1,106,198,2010/2011
"Granger,Danny",535,1260,.425,157,407,.386,378,853,.443,395,466,.848,87,338,425,203,89,206,62,213,1622,2010/2011
"Gray,Aaron",56,99,.566,0,0,,56,99,.566,17,34,.500,59,112,171,16,11,32,12,96,129,2010/2011
"Green,Danny",17,35,.486,7,19,.368,10,16,.625,0,0,,3,12,15,2,2,5,1,7,41,2010/2011
"Green,Jeff",368,820,.449,64,211,.303,304,609,.499,198,244,.811,73,287,360,108,53,99,37,210,998,2010/2011
"Green,Jeff",270,618,.437,56,184,.304,214,434,.493,148,181,.818,57,217,274,89,40,76,21,142,744,2010/2011
"Green,Jeff",98,202,.485,8,27,.296,90,175,.514,50,63,.794,16,70,86,19,13,23,16,68,254,2010/2011
"Green,Willie",270,609,.443,54,155,.348,216,454,.476,78,100,.780,22,139,161,74,36,67,13,143,672,2010/2011
"Greene,Donté",156,386,.404,45,154,.292,111,232,.478,43,65,.662,49,98,147,48,36,60,20,88,400,2010/2011
"Greene,Orien",1,2,.500,0,0,,1,2,.500,1,2,.500,0,0,0,1,1,0,0,0,3,2010/2011
"Griffin,Blake",696,1376,.506,7,24,.292,689,1352,.510,446,695,.642,270,719,989,312,63,223,45,252,1845,2010/2011
"Haddadi,Hamed",30,58,.517,0,1,.000,30,57,.526,15,23,.652,24,44,68,5,2,11,13,29,75,2010/2011
"Hamilton,Richard",288,671,.429,55,144,.382,233,527,.442,146,172,.849,24,102,126,171,39,88,4,95,777,2010/2011
"Hansbrough,Tyler",285,613,.465,0,2,.000,285,611,.466,197,253,.779,145,221,366,41,37,76,15,160,767,2010/2011
"Harangody,Luke",79,206,.383,16,66,.242,63,140,.450,19,26,.731,40,103,143,30,15,16,17,80,193,2010/2011
"Harangody,Luke",28,71,.394,2,10,.200,26,61,.426,5,8,.625,17,38,55,10,4,5,7,36,63,2010/2011
"Harangody,Luke",51,135,.378,14,56,.250,37,79,.468,14,18,.778,23,65,88,20,11,11,10,44,130,2010/2011
"Harden,James",298,684,.436,113,324,.349,185,360,.514,289,343,.843,42,213,255,176,92,106,24,207,998,2010/2011
"Harrington,Al",281,675,.416,117,328,.357,164,347,.473,86,117,.735,76,256,332,101,39,106,10,202,765,2010/2011
"Harris,Devin",343,813,.422,58,180,.322,285,633,.450,335,402,.833,17,152,169,503,70,207,7,163,1079,2010/2011
"Harris,Devin",260,612,.425,33,110,.300,227,502,.452,258,307,.840,11,118,129,411,57,158,5,130,811,2010/2011
"Harris,Devin",83,201,.413,25,70,.357,58,131,.443,77,95,.811,6,34,40,92,13,49,2,33,268,2010/2011
"Harris,Manny",108,289,.374,34,92,.370,74,197,.376,71,93,.763,36,104,140,85,31,63,7,65,321,2010/2011
"Harris,Mike",3,6,.500,0,0,,3,6,.500,2,4,.500,2,3,5,1,0,1,1,2,8,2010/2011
"Haslem,Udonis",44,86,.512,0,0,,44,86,.512,16,20,.800,29,77,106,6,7,14,3,39,104,2010/2011
"Hawes,Spencer",264,568,.465,9,37,.243,255,531,.480,47,88,.534,129,336,465,121,29,97,71,201,584,2010/2011
"Hayes,Chuck",244,463,.527,0,2,.000,244,461,.529,94,142,.662,219,380,599,202,79,86,49,200,582,2010/2011
"Hayward,Gordon",142,293,.485,35,74,.473,107,219,.489,69,97,.711,41,98,139,81,30,70,19,106,388,2010/2011
"Hayward,Lazar",55,154,.357,17,60,.283,38,94,.404,33,42,.786,23,47,70,28,12,19,7,44,160,2010/2011
"Haywood,Brendan",128,223,.574,0,1,.000,128,222,.577,64,177,.362,129,247,376,19,16,51,74,146,320,2010/2011
"Head,Luther",68,164,.415,25,64,.391,43,100,.430,39,50,.780,16,44,60,70,10,32,9,43,200,2010/2011
"Henderson,Gerald",259,570,.454,7,36,.194,252,534,.472,128,163,.785,49,158,207,101,50,64,32,118,653,2010/2011
"Henry,Xavier",65,160,.406,2,17,.118,63,143,.441,33,52,.635,9,28,37,18,11,13,3,48,165,2010/2011
"Hibbert,Roy",410,890,.461,0,4,.000,410,886,.463,205,275,.745,182,428,610,166,33,185,142,256,1025,2010/2011
"Hickson,J.J.",429,936,.458,0,5,.000,429,931,.461,247,367,.673,217,478,695,91,48,173,54,215,1105,2010/2011
"Hilário,Nenê",402,654,.615,1,5,.200,401,649,.618,286,402,.711,145,426,571,149,84,134,73,238,1091,2010/2011
"Hill,George",287,633,.453,77,204,.377,210,429,.490,233,270,.863,24,175,199,193,66,99,21,153,884,2010/2011
"Hill,Grant",399,825,.484,45,114,.395,354,711,.498,213,257,.829,77,261,338,200,64,134,35,184,1056,2010/2011
"Hill,Jordan",173,352,.491,0,2,.000,173,350,.494,60,85,.706,128,178,306,29,14,62,52,157,406,2010/2011
"Hinrich,Kirk",278,623,.446,75,188,.399,203,435,.467,106,126,.841,21,161,182,288,75,121,17,185,737,2010/2011
"Hinrich,Kirk",198,438,.452,43,112,.384,155,326,.475,92,105,.876,14,115,129,210,56,84,10,119,531,2010/2011
"Hinrich,Kirk",80,185,.432,32,76,.421,48,109,.440,14,21,.667,7,46,53,78,19,37,7,66,206,2010/2011
"Holiday,Jrue",446,999,.446,81,222,.365,365,777,.470,172,209,.823,68,264,332,531,120,218,29,203,1145,2010/2011
"Hollins,Ryan",131,219,.598,0,0,,131,219,.598,111,163,.681,70,116,186,26,22,67,42,199,373,2010/2011
"Horford,Al",513,921,.557,2,4,.500,511,917,.557,150,188,.798,182,536,718,266,59,119,80,193,1178,2010/2011
"House,Eddie",128,321,.399,68,175,.389,60,146,.411,38,40,.950,9,83,92,62,32,29,3,68,362,2010/2011
"Howard,Dwight",619,1044,.593,0,7,.000,619,1037,.597,546,916,.596,309,789,1098,107,107,279,186,258,1784,2010/2011
"Howard,Josh",58,162,.358,7,29,.241,51,133,.383,29,47,.617,18,56,74,24,13,20,5,34,152,2010/2011
"Howard,Juwan",55,125,.440,0,0,,55,125,.440,29,35,.829,36,86,122,23,10,25,4,61,139,2010/2011
"Hudson,Lester",6,24,.250,4,15,.267,2,9,.222,2,4,.500,1,4,5,17,4,7,1,10,18,2010/2011
"Humphries,Kris",307,583,.527,0,1,.000,307,582,.527,127,191,.665,225,546,771,84,33,103,80,168,741,2010/2011
"Ibaka,Serge",335,617,.543,0,1,.000,335,616,.544,138,184,.750,214,408,622,22,31,71,198,267,808,2010/2011
"Iguodala,Andre",338,759,.445,61,181,.337,277,578,.479,208,300,.693,61,326,387,422,101,138,38,109,945,2010/2011
"Ilgauskas,Zydrunas",162,319,.508,0,1,.000,162,318,.509,36,46,.783,108,179,287,26,23,52,58,185,360,2010/2011
"Ilunga-Mbenga,Didier",23,49,.469,0,0,,23,49,.469,13,18,.722,35,51,86,6,6,21,27,52,59,2010/2011
"İlyasova,Ersan",221,507,.436,36,121,.298,185,386,.479,93,104,.894,105,260,365,56,51,63,24,159,571,2010/2011
"Ivey,Royal",16,38,.421,7,16,.438,9,22,.409,2,2,1.000,2,14,16,7,6,5,1,17,41,2010/2011
"Jack,Jarrett",260,637,.408,33,108,.306,227,529,.429,182,214,.850,20,153,173,242,54,110,6,102,735,2010/2011
"Jack,Jarrett",48,122,.393,4,24,.167,44,98,.449,40,46,.870,6,36,42,59,14,34,0,25,140,2010/2011
"Jack,Jarrett",212,515,.412,29,84,.345,183,431,.425,142,168,.845,14,117,131,183,40,76,6,77,595,2010/2011
"Jackson,Darnell",77,158,.487,3,11,.273,74,147,.503,30,49,.612,49,45,94,14,12,23,3,61,187,2010/2011
"Jackson,Stephen",435,1059,.411,121,359,.337,314,700,.449,249,305,.816,53,251,304,241,80,209,28,161,1240,2010/2011
"James,Damion",46,103,.447,0,3,.000,46,100,.460,18,28,.643,17,68,85,20,16,25,12,36,110,2010/2011
"James,LeBron",758,1485,.510,92,279,.330,666,1206,.552,503,663,.759,80,510,590,554,124,284,50,163,2111,2010/2011
"Jamison,Antawn",374,876,.427,91,263,.346,283,613,.462,171,234,.731,86,289,375,93,50,77,30,137,1010,2010/2011
"Jeffers,Othyus",31,65,.477,1,4,.250,30,61,.492,30,46,.652,25,42,67,20,17,14,0,32,93,2010/2011
"Jeffers,Othyus",1,3,.333,0,0,,1,3,.333,0,0,,0,2,2,1,0,1,0,1,2,2010/2011
"Jeffers,Othyus",30,62,.484,1,4,.250,29,58,.500,30,46,.652,25,40,65,19,17,13,0,31,91,2010/2011
"Jefferson,Al",654,1319,.496,0,0,,654,1319,.496,220,289,.761,235,559,794,149,46,105,153,238,1528,2010/2011
"Jefferson,Richard",304,642,.474,135,307,.440,169,335,.504,148,195,.759,54,256,310,107,38,93,34,164,891,2010/2011
"Jeffries,Jared",30,86,.349,2,9,.222,28,77,.364,12,29,.414,62,54,116,36,31,21,17,75,74,2010/2011
"Jeffries,Jared",11,36,.306,1,6,.167,10,30,.333,4,10,.400,20,15,35,11,7,4,3,21,27,2010/2011
"Jeffries,Jared",19,50,.380,1,3,.333,18,47,.383,8,19,.421,42,39,81,25,24,17,14,54,47,2010/2011
"Jennings,Brandon",361,926,.390,98,303,.323,263,623,.422,199,246,.809,42,192,234,305,95,146,21,131,1019,2010/2011
"Jeter,Eugene",106,259,.409,6,30,.200,100,229,.437,37,41,.902,9,61,70,162,29,51,2,54,255,2010/2011
"Jianlian,Yi",145,347,.418,3,13,.231,142,334,.425,62,91,.681,79,169,248,25,27,51,32,115,355,2010/2011
"Johnson,Amir",281,495,.568,0,1,.000,281,494,.569,126,160,.788,189,272,461,81,53,69,88,263,688,2010/2011
"Johnson,Armon",46,101,.455,5,12,.417,41,89,.461,13,22,.591,11,25,36,45,5,38,1,31,110,2010/2011
"Johnson,Chris",9,21,.429,0,0,,9,21,.429,15,20,.750,12,20,32,3,3,10,9,21,33,2010/2011
"Johnson,Chris",7,18,.389,0,0,,7,18,.389,13,18,.722,11,16,27,2,3,8,6,18,27,2010/2011
"Johnson,Chris",2,3,.667,0,0,,2,3,.667,2,2,1.000,1,4,5,1,0,2,3,3,6,2010/2011
"Johnson,James",108,237,.456,8,34,.235,100,203,.493,47,71,.662,37,105,142,89,33,64,37,95,271,2010/2011
"Johnson,James",17,41,.415,2,9,.222,15,32,.469,6,13,.462,6,18,24,14,8,18,9,25,42,2010/2011
"Johnson,James",91,196,.464,6,25,.240,85,171,.497,41,58,.707,31,87,118,75,25,46,28,70,229,2010/2011
"Johnson,Joe",514,1161,.443,89,300,.297,425,861,.494,195,243,.802,59,232,291,338,47,146,7,131,1312,2010/2011
"Johnson,Trey",12,33,.364,1,3,.333,11,30,.367,9,10,.900,2,5,7,11,1,5,1,12,34,2010/2011
"Johnson,Trey",10,30,.333,1,3,.333,9,27,.333,7,8,.875,2,5,7,11,1,5,1,11,28,2010/2011
"Johnson,Trey",2,3,.667,0,0,,2,3,.667,2,2,1.000,0,0,0,0,0,0,0,1,6,2010/2011
"Johnson,Wesley",271,682,.397,103,289,.356,168,393,.427,64,92,.696,51,189,240,148,58,95,54,163,709,2010/2011
"Jones,Dahntay",100,214,.467,14,39,.359,86,175,.491,69,90,.767,4,61,65,33,20,31,7,70,283,2010/2011
"Jones,Dominique",14,45,.311,0,4,.000,14,41,.341,14,17,.824,6,19,25,19,5,10,3,7,42,2010/2011
"Jones,James",146,346,.422,123,287,.429,23,59,.390,60,72,.833,23,137,160,43,29,21,19,129,475,2010/2011
"Jones,Solomon",49,121,.405,0,1,.000,49,120,.408,41,62,.661,45,68,113,30,12,35,22,94,139,2010/2011
"Jordan,DeAndre",234,341,.686,0,1,.000,234,340,.688,98,217,.452,207,368,575,42,41,101,142,255,566,2010/2011
"Kaman,Chris",177,376,.471,0,0,,177,376,.471,43,57,.754,51,174,225,46,16,58,48,75,397,2010/2011
"Kapono,Jason",7,28,.250,1,8,.125,6,20,.300,1,2,.500,3,8,11,4,2,2,1,4,16,2010/2011
"Kidd,Jason",215,596,.361,133,391,.340,82,205,.400,67,77,.870,35,316,351,655,134,179,29,119,630,2010/2011
"Kirilenko,Andrei",253,542,.467,36,98,.367,217,444,.489,208,270,.770,100,227,327,192,81,117,74,113,750,2010/2011
"Kleiza,Linas",178,406,.438,39,131,.298,139,275,.505,41,65,.631,37,140,177,40,19,65,7,99,436,2010/2011
"Korver,Kyle",242,557,.434,120,289,.415,122,268,.455,77,87,.885,12,138,150,124,35,60,20,156,681,2010/2011
"Koufos,Kosta",68,150,.453,0,2,.000,68,148,.459,24,43,.558,57,73,130,7,10,31,25,59,160,2010/2011
"Koufos,Kosta",47,108,.435,0,2,.000,47,106,.443,12,24,.500,42,55,97,7,8,25,20,50,106,2010/2011
"Koufos,Kosta",21,42,.500,0,0,,21,42,.500,12,19,.632,15,18,33,0,2,6,5,9,54,2010/2011
"Krstić,Nenad",231,452,.511,0,0,,231,452,.511,113,146,.774,124,211,335,27,26,56,25,184,575,2010/2011
"Krstić,Nenad",152,305,.498,0,0,,152,305,.498,53,66,.803,77,130,207,19,18,33,17,107,357,2010/2011
"Krstić,Nenad",79,147,.537,0,0,,79,147,.537,60,80,.750,47,81,128,8,8,23,8,77,218,2010/2011
"Landry,Carl",345,687,.502,0,4,.000,345,683,.505,213,288,.740,165,182,347,63,40,109,32,196,903,2010/2011
"Landry,Carl",238,484,.492,0,3,.000,238,481,.495,155,215,.721,127,126,253,50,30,82,20,125,631,2010/2011
"Landry,Carl",107,203,.527,0,1,.000,107,202,.530,58,73,.795,38,56,94,13,10,27,12,71,272,2010/2011
"Law,Acie",81,186,.435,6,36,.167,75,150,.500,47,64,.734,12,51,63,84,32,43,0,61,215,2010/2011
"Law,Acie",3,19,.158,0,6,.000,3,13,.231,6,10,.600,3,8,11,14,4,10,0,10,12,2010/2011
"Law,Acie",78,167,.467,6,30,.200,72,137,.526,41,54,.759,9,43,52,70,28,33,0,51,203,2010/2011
"Lawal,Gani",0,0,,0,0,,0,0,,0,0,,0,0,0,0,0,0,0,1,0,2010/2011
"Lawson,Ty",346,688,.503,69,171,.404,277,517,.536,172,225,.764,67,142,209,377,80,137,4,133,933,2010/2011
"Lee,Courtney",253,576,.439,71,174,.408,182,402,.453,95,120,.792,51,158,209,100,58,68,18,102,672,2010/2011
"Lee,David",496,978,.507,1,3,.333,495,975,.508,210,267,.787,217,497,714,233,74,170,31,211,1203,2010/2011
"Lewis,Rashard",252,582,.433,87,244,.357,165,338,.488,77,96,.802,71,219,290,92,52,87,30,159,668,2010/2011
"Lewis,Rashard",113,270,.419,44,120,.367,69,150,.460,34,45,.756,23,83,106,29,22,35,10,63,304,2010/2011
"Lewis,Rashard",139,312,.446,43,124,.347,96,188,.511,43,51,.843,48,136,184,63,30,52,20,96,364,2010/2011
"Lin,Jeremy",28,72,.389,1,5,.200,27,67,.403,19,25,.760,12,22,34,42,33,18,9,31,76,2010/2011
"Livingston,Shaun",185,397,.466,1,4,.250,184,393,.468,108,125,.864,29,120,149,164,47,88,29,109,479,2010/2011
"Lopez,Brook",644,1309,.492,0,1,.000,644,1308,.492,385,489,.787,197,291,488,129,47,176,120,240,1673,2010/2011
"Lopez,Robin",179,357,.501,0,0,,179,357,.501,74,100,.740,82,134,216,8,18,48,45,143,432,2010/2011
"Love,Kevin",482,1026,.470,88,211,.417,394,815,.483,424,499,.850,330,782,1112,184,45,155,28,148,1476,2010/2011
"Lowry,Kyle",345,809,.426,129,343,.376,216,466,.464,192,251,.765,89,220,309,500,102,158,23,207,1011,2010/2011
"Lucas III,John",1,3,.333,0,1,.000,1,2,.500,0,2,.000,0,0,0,1,0,0,0,0,2,2010/2011
"Maggette,Corey",253,559,.453,28,78,.359,225,481,.468,271,325,.834,44,197,241,84,21,127,5,175,805,2010/2011
"Magloire,Jamaal",13,22,.591,0,0,,13,22,.591,9,18,.500,17,44,61,3,4,5,2,26,35,2010/2011
"Mahinmi,Ian",55,98,.561,0,2,.000,55,96,.573,63,82,.768,43,77,120,8,14,25,15,105,173,2010/2011
"Marion,Shawn",434,834,.520,5,33,.152,429,801,.536,126,164,.768,168,383,551,110,68,130,50,144,999,2010/2011
"Marks,Sean",19,44,.432,2,2,1.000,17,42,.405,5,8,.625,16,24,40,4,3,11,5,44,45,2010/2011
"Martin,Cartier",71,182,.390,39,99,.394,32,83,.386,28,40,.700,20,54,74,18,18,16,6,52,209,2010/2011
"Martin,Kenyon",185,362,.511,2,9,.222,183,353,.518,42,72,.583,67,230,297,109,43,59,35,136,414,2010/2011
"Martin,Kevin",553,1267,.436,176,459,.383,377,808,.467,594,669,.888,28,230,258,198,80,184,15,155,1876,2010/2011
"Mason,Roger",26,77,.338,16,44,.364,10,33,.303,7,10,.700,5,38,43,20,6,6,2,25,75,2010/2011
"Matthews,Wesley",440,979,.449,154,378,.407,286,601,.476,266,315,.844,48,210,258,164,102,138,9,195,1300,2010/2011
"Maxiell,Jason",93,189,.492,0,0,,93,189,.492,51,99,.515,66,107,173,17,24,44,21,92,237,2010/2011
"Maynor,Eric",134,333,.402,37,96,.385,97,237,.409,43,59,.729,25,96,121,238,35,77,6,96,348,2010/2011
"Mayo,O.J.",304,747,.407,96,264,.364,208,483,.431,99,131,.756,35,135,170,145,73,99,26,127,803,2010/2011
"Mbah a Moute,Luc",198,428,.463,0,7,.000,198,421,.470,133,188,.707,169,251,420,68,72,77,28,180,529,2010/2011
"McDyess,Antonio",169,344,.491,0,1,.000,169,343,.493,52,77,.675,122,273,395,84,36,72,39,163,390,2010/2011
"McGee,JaVale",332,604,.550,0,3,.000,332,601,.552,134,230,.583,223,411,634,38,41,102,193,232,798,2010/2011
"McGrady,Tracy",227,514,.442,30,88,.341,197,426,.462,90,129,.698,49,202,251,252,66,102,34,101,574,2010/2011
"McGuire,Dominic",72,182,.396,0,2,.000,72,180,.400,30,39,.769,63,136,199,43,10,25,33,94,174,2010/2011
"McRoberts,Josh",211,386,.547,23,60,.383,188,326,.577,88,119,.739,109,273,382,150,47,93,57,165,533,2010/2011
"Meeks,Jodie",242,570,.425,138,348,.397,104,222,.468,152,170,.894,21,150,171,78,63,60,4,97,774,2010/2011
"Mensah-Bonsu,Pops",1,3,.333,0,0,,1,3,.333,0,0,,3,8,11,2,0,2,0,11,2,2010/2011
"Miles,C.J.",366,899,.407,109,339,.322,257,560,.459,159,196,.811,54,201,255,135,74,93,38,221,1000,2010/2011
"Miličić,Darko",271,578,.469,0,0,,271,578,.469,64,115,.557,133,227,360,104,54,151,140,229,606,2010/2011
"Miller,Andre",388,844,.460,4,37,.108,384,807,.476,249,292,.853,97,205,302,566,114,197,12,171,1029,2010/2011
"Miller,Brad",132,296,.446,40,107,.374,92,189,.487,78,94,.830,44,178,222,145,28,54,21,98,382,2010/2011
"Miller,Mike",81,202,.401,43,118,.364,38,84,.452,23,34,.676,38,146,184,51,20,41,2,88,228,2010/2011
"Mills,Patty",135,328,.412,47,133,.353,88,195,.451,36,47,.766,19,32,51,109,27,62,1,63,353,2010/2011
"Millsap,Paul",525,988,.531,9,23,.391,516,965,.535,256,338,.757,164,415,579,187,103,145,69,272,1315,2010/2011
"Ming,Yao",18,37,.486,0,0,,18,37,.486,15,16,.938,7,20,27,4,0,7,8,13,51,2010/2011
"Mohammed,Nazr",234,448,.522,0,1,.000,234,447,.523,67,112,.598,140,228,368,23,30,70,56,184,535,2010/2011
"Mohammed,Nazr",159,317,.502,0,1,.000,159,316,.503,52,88,.591,94,158,252,17,14,51,46,121,370,2010/2011
"Mohammed,Nazr",75,131,.573,0,0,,75,131,.573,15,24,.625,46,70,116,6,16,19,10,63,165,2010/2011
"Monroe,Greg",303,550,.551,0,1,.000,303,549,.552,145,233,.622,248,353,601,105,93,81,45,196,751,2010/2011
"Moon,Jamario",101,248,.407,38,123,.309,63,125,.504,15,17,.882,23,142,165,52,28,22,33,65,255,2010/2011
"Moon,Jamario",76,189,.402,27,95,.284,49,94,.521,10,11,.909,14,104,118,45,25,17,27,39,189,2010/2011
"Moon,Jamario",25,59,.424,11,28,.393,14,31,.452,5,6,.833,9,38,47,7,3,5,6,26,66,2010/2011
"Morrow,Anthony",279,620,.450,110,260,.423,169,360,.469,96,107,.897,37,135,172,68,19,54,7,135,764,2010/2011
"Mozgov,Timofey",63,133,.474,0,0,,63,133,.474,37,52,.712,46,75,121,15,15,35,25,84,163,2010/2011
"Mozgov,Timofey",52,112,.464,0,0,,52,112,.464,31,44,.705,41,63,104,15,14,32,23,76,135,2010/2011
"Mozgov,Timofey",11,21,.524,0,0,,11,21,.524,6,8,.750,5,12,17,0,1,3,2,8,28,2010/2011
"Mullens,Byron",9,28,.321,0,0,,9,28,.321,7,14,.500,6,18,24,0,2,8,3,11,25,2010/2011
"Murphy,Troy",42,114,.368,5,33,.152,37,81,.457,20,30,.667,22,91,113,23,15,20,3,47,109,2010/2011
"Murphy,Troy",26,76,.342,4,23,.174,22,53,.415,9,17,.529,11,64,75,17,7,13,2,28,65,2010/2011
"Murphy,Troy",16,38,.421,1,10,.100,15,28,.536,11,13,.846,11,27,38,6,8,7,1,19,44,2010/2011
"N'Diaye,Hamady",4,5,.800,0,0,,4,5,.800,6,12,.500,2,5,7,0,2,3,5,18,14,2010/2011
"Nájera,Eduardo",26,72,.361,11,34,.324,15,38,.395,6,11,.545,14,30,44,20,11,13,6,52,69,2010/2011
"Nash,Steve",399,811,.492,81,205,.395,318,606,.525,227,249,.912,40,220,260,855,48,265,4,87,1106,2010/2011
"Neal,Gary",285,632,.451,129,308,.419,156,324,.481,84,104,.808,21,175,196,96,27,78,4,148,783,2010/2011
"Nelson,Jameer",374,838,.446,119,297,.401,255,541,.471,130,162,.802,37,189,226,456,75,194,3,209,997,2010/2011
"Noah,Joakim",211,402,.525,0,1,.000,211,401,.526,139,188,.739,182,316,498,107,48,90,72,156,561,2010/2011
"Nocioni,Andrés",118,277,.426,42,118,.356,76,159,.478,49,61,.803,19,150,169,45,14,47,15,100,327,2010/2011
"Novak,Steve",35,67,.522,26,46,.565,9,21,.429,8,8,1.000,4,24,28,3,1,4,5,14,104,2010/2011
"Novak,Steve",4,8,.500,3,4,.750,1,4,.250,0,0,,0,5,5,0,0,0,0,3,11,2010/2011
"Novak,Steve",31,59,.525,23,42,.548,8,17,.471,8,8,1.000,4,19,23,3,1,4,5,11,93,2010/2011
"Nowitzki,Dirk",610,1179,.517,66,168,.393,544,1011,.538,395,443,.892,50,463,513,190,38,137,47,172,1681,2010/2011
"O'Neal,Jermaine",50,109,.459,0,1,.000,50,108,.463,29,43,.674,25,63,88,12,2,27,30,65,129,2010/2011
"O'Neal,Shaquille",134,201,.667,0,0,,134,201,.667,73,131,.557,48,130,178,26,16,56,42,120,341,2010/2011
"Oberto,Fabricio",3,5,.600,0,0,,3,5,.600,1,2,.500,3,4,7,0,0,3,0,10,7,2010/2011
"Odom,Lamar",473,893,.530,68,178,.382,405,715,.566,166,246,.675,175,535,710,249,47,139,61,200,1180,2010/2011
"Okafor,Emeka",300,524,.573,0,1,.000,300,523,.574,145,258,.562,230,454,684,42,40,119,127,230,745,2010/2011
"Okur,Mehmet",22,62,.355,5,16,.313,17,46,.370,15,20,.750,9,21,30,19,4,7,4,18,64,2010/2011
"Outlaw,Travis",274,731,.375,76,252,.302,198,479,.413,132,171,.772,54,271,325,84,34,71,36,148,756,2010/2011
"Owens,Larry",15,32,.469,6,13,.462,9,19,.474,4,9,.444,1,14,15,8,9,5,5,18,40,2010/2011
"Owens,Larry",3,6,.500,1,3,.333,2,3,.667,2,4,.500,0,4,4,1,2,0,0,4,9,2010/2011
"Owens,Larry",12,26,.462,5,10,.500,7,16,.438,2,5,.400,1,10,11,7,7,5,5,14,31,2010/2011
"Pachulia,Zaza",107,232,.461,0,0,,107,232,.461,135,179,.754,119,214,333,58,34,69,22,184,349,2010/2011
"Parker,Anthony",220,552,.399,86,227,.379,134,325,.412,74,95,.779,33,185,218,218,67,80,10,109,600,2010/2011
"Parker,Tony",555,1069,.519,25,70,.357,530,999,.531,233,303,.769,30,208,238,513,90,200,3,135,1368,2010/2011
"Patterson,Patrick",149,267,.558,0,2,.000,149,265,.562,30,42,.714,86,114,200,41,17,31,37,77,328,2010/2011
"Paul,Chris",430,928,.463,71,183,.388,359,745,.482,337,384,.878,38,289,327,782,188,177,5,196,1268,2010/2011
"Pavlović,Sasha",29,72,.403,12,31,.387,17,41,.415,6,10,.600,1,31,32,16,10,12,7,34,76,2010/2011
"Pavlović,Sasha",15,35,.429,7,16,.438,8,19,.421,4,5,.800,0,12,12,7,5,5,3,15,41,2010/2011
"Pavlović,Sasha",2,11,.182,0,5,.000,2,6,.333,0,0,,0,6,6,6,0,1,4,4,4,2010/2011
"Pavlović,Sasha",12,26,.462,5,10,.500,7,16,.438,2,5,.400,1,13,14,3,5,6,0,15,31,2010/2011
"Peković,Nikola",136,263,.517,0,0,,136,263,.517,87,114,.763,90,103,193,27,18,91,35,181,359,2010/2011
"Perkins,Kendrick",67,130,.515,0,0,,67,130,.515,40,72,.556,62,170,232,26,9,56,26,91,174,2010/2011
"Perkins,Kendrick",32,59,.542,0,0,,32,59,.542,23,40,.575,23,74,97,10,2,25,10,37,87,2010/2011
"Perkins,Kendrick",35,71,.493,0,0,,35,71,.493,17,32,.531,39,96,135,16,7,31,16,54,87,2010/2011
"Peterson,Morris",2,5,.400,0,1,.000,2,4,.500,0,0,,0,3,3,1,0,0,0,5,4,2010/2011
"Petro,Johan",129,290,.445,0,4,.000,129,286,.451,15,28,.536,62,150,212,44,34,46,34,178,273,2010/2011
"Pierce,Paul",507,1021,.497,111,297,.374,396,724,.547,386,449,.860,34,396,430,260,80,171,51,231,1511,2010/2011
"Piétrus,Mickaël",143,365,.392,85,236,.360,58,129,.450,39,57,.684,15,111,126,33,29,39,21,101,410,2010/2011
"Piétrus,Mickaël",45,115,.391,34,87,.391,11,28,.393,3,6,.500,6,44,50,10,10,14,3,35,127,2010/2011
"Piétrus,Mickaël",98,250,.392,51,149,.342,47,101,.465,36,51,.706,9,67,76,23,19,25,18,66,283,2010/2011
"Pittman,Dexter",1,3,.333,0,0,,1,3,.333,0,0,,1,2,3,0,0,2,0,2,2,2010/2011
"Pondexter,Quincy",73,180,.406,18,50,.360,55,130,.423,24,34,.706,23,65,88,28,17,16,10,63,188,2010/2011
"Posey,James",81,241,.336,67,212,.316,14,29,.483,11,15,.733,10,137,147,34,24,24,6,103,240,2010/2011
"Powe,Leon",59,119,.496,0,2,.000,59,117,.504,40,72,.556,24,39,63,7,10,12,4,44,158,2010/2011
"Powe,Leon",29,59,.492,0,0,,29,59,.492,12,26,.462,16,22,38,2,7,5,3,20,70,2010/2011
"Powe,Leon",30,60,.500,0,2,.000,30,58,.517,28,46,.609,8,17,25,5,3,7,1,24,88,2010/2011
"Powell,Josh",94,208,.452,0,1,.000,94,207,.454,36,45,.800,49,86,135,22,5,53,5,78,224,2010/2011
"Price,A.J.",114,320,.356,41,149,.275,73,171,.427,54,81,.667,16,56,72,111,29,53,1,61,323,2010/2011
"Price,Ronnie",74,210,.352,20,69,.290,54,141,.383,29,39,.744,22,39,61,56,42,55,5,106,197,2010/2011
"Prince,Tayshaun",473,1001,.473,34,98,.347,439,903,.486,118,168,.702,78,251,329,215,30,82,41,90,1098,2010/2011
"Przybilla,Joel",25,44,.568,0,0,,25,44,.568,14,27,.519,37,108,145,13,5,29,15,79,64,2010/2011
"Przybilla,Joel",21,34,.618,0,0,,21,34,.618,13,23,.565,28,93,121,13,5,22,14,63,55,2010/2011
"Przybilla,Joel",4,10,.400,0,0,,4,10,.400,1,4,.250,9,15,24,0,0,7,1,16,9,2010/2011
"Quinn,Chris",33,91,.363,11,37,.297,22,54,.407,4,8,.500,3,22,25,42,5,12,1,29,81,2010/2011
"Radmanović,Vladimir",137,318,.431,70,173,.405,67,145,.462,30,34,.882,64,148,212,79,44,57,44,157,374,2010/2011
"Randolph,Anthony",123,264,.466,1,4,.250,122,260,.469,58,86,.674,43,117,160,33,22,53,24,62,305,2010/2011
"Randolph,Anthony",14,45,.311,1,4,.250,13,41,.317,6,12,.500,11,29,40,7,4,10,8,15,35,2010/2011
"Randolph,Anthony",109,219,.498,0,0,,109,219,.498,52,74,.703,32,88,120,26,18,43,16,47,270,2010/2011
"Randolph,Zach",598,1188,.503,8,43,.186,590,1145,.515,300,396,.758,326,588,914,163,63,151,25,175,1504,2010/2011
"Ratliff,Theo",1,6,.167,0,0,,1,6,.167,0,2,.000,6,7,13,3,2,3,5,7,2,2010/2011
"Rautins,Andy",3,7,.429,1,4,.250,2,3,.667,1,2,.500,0,1,1,3,1,7,0,0,8,2010/2011
"Redd,Michael",18,45,.400,4,17,.235,14,28,.500,4,4,1.000,0,8,8,12,2,4,1,4,44,2010/2011
"Redick,J.J.",197,447,.441,87,219,.397,110,228,.482,112,128,.875,6,107,113,102,29,53,3,80,593,2010/2011
"Richardson,Jason",472,1056,.447,189,479,.395,283,577,.490,116,159,.730,67,264,331,147,93,95,13,162,1249,2010/2011
"Richardson,Jason",183,389,.470,62,148,.419,121,241,.502,55,72,.764,33,78,111,36,27,30,3,46,483,2010/2011
"Richardson,Jason",289,667,.433,127,331,.384,162,336,.482,61,87,.701,34,186,220,111,66,65,10,116,766,2010/2011
"Richardson,Quentin",87,255,.341,42,146,.288,45,109,.413,33,44,.750,39,139,178,38,25,33,5,74,249,2010/2011
"Ridnour,Luke",319,681,.468,81,184,.440,238,497,.479,121,137,.883,37,162,199,384,89,158,10,146,840,2010/2011
"Robinson,Nate",150,376,.399,65,200,.325,85,176,.483,36,44,.818,15,75,90,111,29,68,4,115,401,2010/2011
"Robinson,Nate",146,361,.404,63,192,.328,83,169,.491,33,40,.825,15,74,89,105,29,66,4,107,388,2010/2011
"Robinson,Nate",4,15,.267,2,8,.250,2,7,.286,3,4,.750,0,1,1,6,0,2,0,8,13,2010/2011
"Rondo,Rajon",318,670,.475,10,43,.233,308,627,.491,75,132,.568,87,210,297,760,153,234,11,120,721,2010/2011
"Rose,Derrick",711,1597,.445,128,385,.332,583,1212,.481,476,555,.858,81,249,330,623,85,278,51,136,2026,2010/2011
"Ross,Quinton",26,59,.441,0,3,.000,26,56,.464,5,14,.357,10,20,30,10,3,7,6,40,57,2010/2011
"Roy,Brandon",209,523,.400,38,114,.333,171,409,.418,117,138,.848,28,93,121,129,37,55,12,76,573,2010/2011
"Rush,Brandon",217,515,.421,93,223,.417,124,292,.425,80,106,.755,33,184,217,62,41,69,35,107,607,2010/2011
"Salmons,John",373,898,.415,83,219,.379,290,679,.427,195,240,.813,27,239,266,252,72,137,28,157,1024,2010/2011
"Samuels,Samardo",110,241,.456,0,3,.000,110,238,.462,68,110,.618,75,83,158,17,15,53,18,88,288,2010/2011
"Sanders,Larry",116,268,.433,0,0,,116,268,.433,28,50,.560,59,119,178,16,22,38,72,117,260,2010/2011
"Scalabrine,Brian",10,19,.526,0,5,.000,10,14,.714,0,0,,1,7,8,6,3,5,4,18,20,2010/2011
"Scola,Luis",569,1129,.504,0,3,.000,569,1126,.505,214,290,.738,147,459,606,185,48,147,44,227,1352,2010/2011
"Sefolosha,Thabo",157,333,.471,28,102,.275,129,231,.558,59,79,.747,65,281,346,111,97,55,38,171,401,2010/2011
"Séraphin,Kevin",66,147,.449,0,0,,66,147,.449,22,31,.710,80,72,152,10,17,42,28,126,154,2010/2011
"Sessions,Ramon",362,776,.466,3,15,.200,359,761,.472,348,423,.823,46,209,255,419,60,178,8,93,1075,2010/2011
"Shakur,Mustafa",21,59,.356,1,10,.100,20,49,.408,8,15,.533,7,15,22,25,5,18,3,15,51,2010/2011
"Siler,Garret",17,31,.548,0,0,,17,31,.548,11,22,.500,16,12,28,3,1,10,4,20,45,2010/2011
"Simmons,Bobby",0,3,.000,0,3,.000,0,0,,0,0,,0,0,0,2,0,0,0,2,0,2010/2011
"Skinner,Brian",0,0,,0,0,,0,0,,0,0,,0,0,0,0,0,0,0,0,0,2010/2011
"Smith,Craig",104,188,.553,0,5,.000,104,183,.568,50,68,.735,43,74,117,31,16,33,7,84,258,2010/2011
"Smith,Ish",43,115,.374,3,10,.300,40,105,.381,12,21,.571,7,40,47,79,18,34,2,37,101,2010/2011
"Smith,Ish",32,83,.386,3,8,.375,29,75,.387,7,10,.700,6,36,42,64,13,26,2,26,74,2010/2011
"Smith,Ish",11,32,.344,0,2,.000,11,30,.367,5,11,.455,1,4,5,15,5,8,0,11,27,2010/2011
"Smith,J.R.",341,784,.435,124,318,.390,217,466,.466,163,221,.738,45,277,322,175,92,100,16,173,969,2010/2011
"Smith,Jason",136,307,.443,0,2,.000,136,305,.446,59,70,.843,89,152,241,36,26,53,32,150,331,2010/2011
"Smith,Joe",3,16,.188,0,0,,3,16,.188,2,2,1.000,3,18,21,4,0,5,4,13,8,2010/2011
"Smith,Joe",1,4,.250,0,0,,1,4,.250,0,0,,1,2,3,1,0,2,0,3,2,2010/2011
"Smith,Joe",2,12,.167,0,0,,2,12,.167,2,2,1.000,2,16,18,3,0,3,4,10,6,2010/2011
"Smith,Josh",497,1041,.477,51,154,.331,446,887,.503,229,316,.725,134,523,657,255,99,197,120,217,1274,2010/2011
"Songaila,Darius",7,15,.467,0,0,,7,15,.467,2,4,.500,2,8,10,2,0,4,0,16,16,2010/2011
"Speights,Marreese",144,291,.495,1,4,.250,143,287,.498,55,73,.753,64,146,210,30,8,40,19,120,344,2010/2011
"Splitter,Tiago",101,191,.529,0,1,.000,101,190,.532,76,140,.543,72,129,201,26,29,32,17,91,278,2010/2011
"Stackhouse,Jerry",3,12,.250,1,4,.250,2,8,.250,5,7,.714,1,6,7,3,0,2,2,3,12,2010/2011
"Stephenson,Lance",13,39,.333,0,5,.000,13,34,.382,11,14,.786,1,17,18,21,4,16,0,14,37,2010/2011
"Stevenson,DeShawn",128,330,.388,94,249,.378,34,81,.420,33,43,.767,20,86,106,77,21,44,5,71,383,2010/2011
"Stojaković,Peja",100,227,.441,57,136,.419,43,91,.473,23,25,.920,14,61,75,29,13,17,2,24,280,2010/2011
"Stojaković,Peja",14,33,.424,11,25,.440,3,8,.375,6,7,.857,0,6,6,6,2,4,0,2,45,2010/2011
"Stojaković,Peja",7,10,.700,4,6,.667,3,4,.750,2,2,1.000,0,3,3,1,0,2,0,0,20,2010/2011
"Stojaković,Peja",79,184,.429,42,105,.400,37,79,.468,15,16,.938,14,52,66,22,11,11,2,22,215,2010/2011
"Stoudemire,Amar'e",744,1482,.502,10,23,.435,734,1459,.503,473,597,.792,198,438,636,202,71,250,150,274,1971,2010/2011
"Stuckey,Rodney",363,827,.439,26,90,.289,337,737,.457,330,381,.866,70,146,216,361,76,155,10,177,1082,2010/2011
"Summers,DaJuan",28,69,.406,9,21,.429,19,48,.396,9,20,.450,2,10,12,2,3,13,1,21,74,2010/2011
"Sy,Pape",2,6,.333,0,1,.000,2,5,.400,3,3,1.000,2,1,3,2,1,3,0,1,7,2010/2011
"Taylor,Jermaine",94,196,.480,14,45,.311,80,151,.530,21,28,.750,26,36,62,32,14,46,5,39,223,2010/2011
"Taylor,Jermaine",16,32,.500,2,5,.400,14,27,.519,5,6,.833,1,8,9,2,2,6,2,4,39,2010/2011
"Taylor,Jermaine",78,164,.476,12,40,.300,66,124,.532,16,22,.727,25,28,53,30,12,40,3,35,184,2010/2011
"Teague,Jeff",133,304,.438,18,48,.375,115,256,.449,77,97,.794,11,91,102,138,45,64,25,82,361,2010/2011
"Telfair,Sebastian",97,241,.402,28,78,.359,69,163,.423,44,60,.733,17,37,54,111,25,64,3,64,266,2010/2011
"Temple,Garrett",20,68,.294,10,37,.270,10,31,.323,7,17,.412,1,22,23,32,11,23,6,24,57,2010/2011
"Temple,Garrett",1,5,.200,0,1,.000,1,4,.250,0,2,.000,1,1,2,2,1,1,1,2,2,2010/2011
"Temple,Garrett",7,21,.333,3,10,.300,4,11,.364,0,4,.000,0,6,6,6,1,2,1,8,17,2010/2011
"Temple,Garrett",12,42,.286,7,26,.269,5,16,.313,7,11,.636,0,15,15,24,9,20,4,14,38,2010/2011
"Terry,Jason",492,1091,.451,127,351,.362,365,740,.493,182,214,.850,24,129,153,334,93,167,13,140,1293,2010/2011
"Thabeet,Hasheem",17,40,.425,0,0,,17,40,.425,19,35,.543,24,51,75,4,9,17,16,76,53,2010/2011
"Thabeet,Hasheem",17,39,.436,0,0,,17,39,.436,19,35,.543,24,51,75,4,9,17,15,73,53,2010/2011
"Thabeet,Hasheem",0,1,.000,0,0,,0,1,.000,0,0,,0,0,0,0,0,0,1,3,0,2010/2011
"Thomas,Etan",10,21,.476,0,0,,10,21,.476,12,15,.800,6,17,23,2,1,5,4,11,32,2010/2011
"Thomas,Kurt",95,186,.511,1,1,1.000,94,185,.508,20,32,.625,75,226,301,60,32,42,42,164,211,2010/2011
"Thomas,Tyrus",156,331,.471,0,3,.000,156,328,.476,107,136,.787,65,159,224,29,30,65,66,113,419,2010/2011
"Thompson,Jason",271,534,.507,0,3,.000,271,531,.510,121,200,.605,144,310,454,88,28,99,44,212,663,2010/2011
"Thornton,Al",205,431,.476,4,26,.154,201,405,.496,110,142,.775,56,157,213,62,35,64,12,143,524,2010/2011
"Thornton,Al",154,327,.471,4,25,.160,150,302,.497,81,107,.757,46,110,156,51,28,44,9,103,393,2010/2011
"Thornton,Al",51,104,.490,0,1,.000,51,103,.495,29,35,.829,10,47,57,11,7,20,3,40,131,2010/2011
"Thornton,Marcus",350,807,.434,88,240,.367,262,567,.462,145,184,.788,61,197,258,135,64,93,9,110,933,2010/2011
"Thornton,Marcus",137,334,.410,35,93,.376,102,241,.423,50,66,.758,25,106,131,43,19,37,4,50,359,2010/2011
"Thornton,Marcus",213,473,.450,53,147,.361,160,326,.491,95,118,.805,36,91,127,92,45,56,5,60,574,2010/2011
"Tolliver,Anthony",141,313,.450,47,115,.409,94,198,.475,105,131,.802,92,203,295,82,28,49,28,145,434,2010/2011
"Turiaf,Ronny",103,163,.632,0,0,,103,163,.632,61,98,.622,64,143,207,92,35,41,73,160,267,2010/2011
"Türkoğlu,Hedo",322,722,.446,127,310,.410,195,412,.473,106,156,.679,45,311,356,343,72,132,34,247,877,2010/2011
"Türkoğlu,Hedo",85,193,.440,41,97,.423,44,96,.458,26,36,.722,20,80,100,58,18,31,14,77,237,2010/2011
"Türkoğlu,Hedo",237,529,.448,86,213,.404,151,316,.478,80,120,.667,25,231,256,285,54,101,20,170,640,2010/2011
"Turner,Evan",225,529,.425,14,44,.318,211,485,.435,101,125,.808,42,264,306,159,49,80,14,138,565,2010/2011
"Udoh,Ekpe",97,222,.437,0,0,,97,222,.437,42,64,.656,80,101,181,40,22,48,86,144,236,2010/2011
"Udoka,Ime",5,21,.238,0,8,.000,5,13,.385,4,8,.500,5,14,19,13,8,5,1,14,14,2010/2011
"Udrih,Beno",412,824,.500,65,182,.357,347,642,.540,197,228,.864,41,224,265,386,94,141,9,181,1086,2010/2011
"Uzoh,Ben",61,144,.424,3,8,.375,58,136,.426,33,56,.589,30,31,61,69,13,25,8,29,158,2010/2011
"Varejão,Anderson",114,216,.528,0,2,.000,114,214,.533,54,81,.667,98,203,301,45,27,40,38,87,282,2010/2011
"Vásquez,Greivis",95,233,.408,25,86,.291,70,147,.476,34,44,.773,12,61,73,151,22,70,4,83,249,2010/2011
"Villanueva,Charlie",313,708,.442,125,323,.387,188,385,.488,89,116,.767,50,245,295,48,42,66,42,175,840,2010/2011
"Vujačić,Sasha",239,595,.402,97,262,.370,142,333,.426,81,96,.844,30,156,186,132,54,66,5,136,656,2010/2011
"Vujačić,Sasha",8,23,.348,3,7,.429,5,16,.313,1,2,.500,1,3,4,5,1,5,0,7,20,2010/2011
"Vujačić,Sasha",231,572,.404,94,255,.369,137,317,.432,80,94,.851,29,153,182,127,53,61,5,129,636,2010/2011
"Wade,Dwyane",692,1384,.500,63,206,.306,629,1178,.534,494,652,.758,123,362,485,346,111,237,87,197,1941,2010/2011
"Wafer,Von",67,159,.421,18,67,.269,49,92,.533,32,38,.842,7,42,49,35,18,20,5,39,184,2010/2011
"Walker,Henry",104,236,.441,59,153,.386,45,83,.542,31,44,.705,16,106,122,34,21,37,6,81,298,2010/2011
"Wall,John",398,972,.409,34,115,.296,364,857,.425,301,393,.766,35,282,317,574,121,261,35,175,1131,2010/2011
"Wallace,Ben",67,149,.450,1,2,.500,66,147,.449,19,57,.333,129,221,350,72,54,44,54,81,154,2010/2011
"Wallace,Gerald",386,851,.454,62,186,.333,324,665,.487,279,374,.746,111,458,569,173,105,152,63,183,1113,2010/2011
"Wallace,Gerald",252,582,.433,35,106,.330,217,476,.456,210,284,.739,72,322,394,116,59,100,48,120,749,2010/2011
"Wallace,Gerald",134,269,.498,27,80,.338,107,189,.566,69,90,.767,39,136,175,57,46,52,15,63,364,2010/2011
"Walton,Luke",38,116,.328,8,34,.235,30,82,.366,7,10,.700,9,58,67,62,9,31,4,38,91,2010/2011
"Warren,Willie",13,35,.371,5,15,.333,8,20,.400,6,8,.750,1,11,12,27,6,8,0,16,37,2010/2011
"Warrick,Hakim",228,446,.511,1,11,.091,227,435,.522,212,294,.721,88,208,296,69,32,79,9,100,669,2010/2011
"Watson,C.J.",146,394,.371,44,112,.393,102,282,.362,69,93,.742,16,78,94,186,55,73,11,82,405,2010/2011
"Watson,Earl",126,307,.410,36,107,.336,90,200,.450,55,82,.671,52,130,182,278,61,116,17,146,343,2010/2011
"Weaver,Kyle",9,25,.360,3,7,.429,6,18,.333,7,8,.875,2,8,10,7,2,7,2,3,28,2010/2011
"Webster,Martell",152,340,.447,55,132,.417,97,208,.466,94,122,.770,36,111,147,53,28,58,9,101,453,2010/2011
"Weems,Sonny",228,513,.444,17,61,.279,211,452,.467,72,94,.766,39,114,153,104,34,86,2,87,545,2010/2011
"West,David",528,1040,.508,2,9,.222,526,1031,.510,264,327,.807,155,374,529,164,67,142,62,202,1322,2010/2011
"West,Delonte",55,120,.458,12,33,.364,43,87,.494,13,15,.867,6,31,37,64,20,30,10,29,135,2010/2011
"West,Mario",9,21,.429,1,4,.250,8,17,.471,3,5,.600,2,9,11,10,7,2,0,13,22,2010/2011
"Westbrook,Russell",614,1390,.442,34,103,.330,580,1287,.451,531,631,.842,121,258,379,670,155,316,30,207,1793,2010/2011
"White,D.J.",111,219,.507,0,2,.000,111,217,.512,46,64,.719,43,115,158,19,12,14,20,77,268,2010/2011
"White,D.J.",30,65,.462,0,0,,30,65,.462,5,10,.500,12,40,52,4,6,7,8,31,65,2010/2011
"White,D.J.",81,154,.526,0,2,.000,81,152,.533,41,54,.759,31,75,106,15,6,7,12,46,203,2010/2011
"Whiteside,Hassan",0,0,,0,0,,0,0,,0,0,,0,0,0,0,0,0,0,2,0,2010/2011
"Wilcox,Chris",187,322,.581,0,1,.000,187,321,.583,50,89,.562,95,176,271,43,29,43,17,145,424,2010/2011
"Wilkins,Damien",69,137,.504,2,10,.200,67,127,.528,40,56,.714,23,67,90,41,27,21,9,72,180,2010/2011
"Williams,Deron",428,975,.439,105,317,.331,323,658,.491,348,412,.845,40,220,260,667,79,230,15,190,1309,2010/2011
"Williams,Deron",369,806,.458,89,258,.345,280,548,.511,302,354,.853,32,173,205,514,64,187,12,152,1129,2010/2011
"Williams,Deron",59,169,.349,16,59,.271,43,110,.391,46,58,.793,8,47,55,153,15,43,3,38,180,2010/2011
"Williams,Jason",22,67,.328,10,38,.263,12,29,.414,0,0,,3,27,30,52,11,18,1,8,54,2010/2011
"Williams,Jason",13,38,.342,7,23,.304,6,15,.400,0,0,,3,19,22,24,8,11,0,6,33,2010/2011
"Williams,Jason",9,29,.310,3,15,.200,6,14,.429,0,0,,0,8,8,28,3,7,1,2,21,2010/2011
"Williams,Jawad",41,126,.325,13,45,.289,28,81,.346,9,12,.750,7,41,48,22,9,16,3,34,104,2010/2011
"Williams,Lou",323,795,.406,88,253,.348,235,542,.434,293,356,.823,32,117,149,252,47,102,17,128,1027,2010/2011
"Williams,Marvin",246,537,.458,37,110,.336,209,427,.489,147,174,.845,68,245,313,88,34,62,23,104,676,2010/2011
"Williams,Mo",291,730,.399,79,244,.324,212,486,.436,151,177,.853,21,132,153,380,53,171,10,150,812,2010/2011
"Williams,Mo",178,462,.385,36,136,.265,142,326,.436,85,102,.833,15,82,97,257,33,105,10,91,477,2010/2011
"Williams,Mo",113,268,.422,43,108,.398,70,160,.438,66,75,.880,6,50,56,123,20,66,0,59,335,2010/2011
"Williams,Reggie",268,572,.469,102,241,.423,166,331,.502,100,134,.746,45,171,216,121,28,57,3,124,738,2010/2011
"Williams,Shawne",164,385,.426,85,212,.401,79,173,.457,41,49,.837,60,179,239,47,39,46,51,164,454,2010/2011
"Williams,Shelden",103,220,.468,0,0,,103,220,.468,58,75,.773,93,180,273,32,23,43,26,126,264,2010/2011
"Williams,Shelden",82,181,.453,0,0,,82,181,.453,34,46,.739,74,149,223,19,18,37,22,92,198,2010/2011
"Williams,Shelden",21,39,.538,0,0,,21,39,.538,24,29,.828,19,31,50,13,5,6,4,34,66,2010/2011
"Williams,Terrence",43,115,.374,6,22,.273,37,93,.398,14,21,.667,4,47,51,38,9,33,0,25,106,2010/2011
"Williams,Terrence",29,73,.397,4,12,.333,25,61,.410,5,10,.500,3,33,36,31,5,25,0,21,67,2010/2011
"Williams,Terrence",14,42,.333,2,10,.200,12,32,.375,9,11,.818,1,14,15,7,4,8,0,4,39,2010/2011
"World Peace,Metta",261,658,.397,83,233,.356,178,425,.419,92,136,.676,100,167,267,175,124,90,36,181,697,2010/2011
"Wright,Antoine",1,8,.125,0,4,.000,1,4,.250,0,0,,2,1,3,0,1,1,0,3,2,2010/2011
"Wright,Brandan",60,117,.513,0,0,,60,117,.513,21,31,.677,31,58,89,12,11,14,17,34,141,2010/2011
"Wright,Brandan",38,63,.603,0,0,,38,63,.603,7,14,.500,14,27,41,5,3,10,10,19,83,2010/2011
"Wright,Brandan",22,54,.407,0,0,,22,54,.407,14,17,.824,17,31,48,7,8,4,7,15,58,2010/2011
"Wright,Dorell",485,1146,.423,194,516,.376,291,630,.462,180,228,.789,88,343,431,242,124,133,63,171,1344,2010/2011
"Wright,Julian",82,160,.513,2,10,.200,80,150,.533,22,43,.512,47,71,118,58,39,43,20,45,188,2010/2011
"Young,Nick",412,935,.441,105,271,.387,307,664,.462,186,228,.816,26,148,174,75,45,90,17,144,1115,2010/2011
"Young,Sam",233,494,.472,17,50,.340,216,444,.486,89,116,.767,40,147,187,71,68,61,23,120,572,2010/2011
"Young,Thaddeus",458,847,.541,6,22,.273,452,825,.548,123,174,.707,153,281,434,82,90,99,26,170,1045,2010/2011
"Adrien,Jeff",7,16,.438,0,0,,7,16,.438,7,12,.583,5,17,22,1,0,2,2,13,21,2011/2012
"Afflalo,Arron",329,699,.471,88,221,.398,241,478,.504,197,247,.798,40,157,197,149,36,85,13,134,943,2011/2012
"Ahearn,Blake",4,14,.286,2,9,.222,2,5,.400,0,0,,0,2,2,1,0,5,0,4,10,2011/2012
"Alabi,Solomon",13,36,.361,0,0,,13,36,.361,7,8,.875,15,32,47,3,2,5,9,11,33,2011/2012
"Aldrich,Cole",22,42,.524,0,0,,22,42,.524,13,14,.929,13,35,48,3,8,9,16,22,57,2011/2012
"Aldridge,LaMarcus",483,943,.512,2,11,.182,481,932,.516,223,274,.814,150,292,442,134,51,111,45,153,1191,2011/2012
"Allen,Lavoy",79,167,.473,0,0,,79,167,.473,11,14,.786,47,124,171,34,13,20,18,73,169,2011/2012
"Allen,Ray",226,493,.458,106,234,.453,120,259,.463,97,106,.915,14,128,142,109,49,68,8,83,655,2011/2012
"Allen,Tony",210,448,.469,8,26,.308,202,422,.479,140,175,.800,98,135,233,79,104,94,33,142,568,2011/2012
"Almond,Morris",6,17,.353,1,3,.333,5,14,.357,1,3,.333,1,7,8,2,7,1,0,6,14,2011/2012
"Aminu,Al-Farouq",150,365,.411,13,47,.277,137,318,.431,86,114,.754,95,213,308,66,59,91,34,136,399,2011/2012
"Amundson,Lou",89,207,.430,0,0,,89,207,.430,35,82,.427,94,128,222,14,27,45,44,125,213,2011/2012
"Andersen,Chris",59,108,.546,0,0,,59,108,.546,50,82,.610,48,100,148,6,19,17,46,52,168,2011/2012
"Anderson,Alan",55,142,.387,24,61,.393,31,81,.383,29,34,.853,8,26,34,26,5,25,3,35,163,2011/2012
"Anderson,James",66,174,.379,19,68,.279,47,106,.443,39,52,.750,16,63,79,41,8,30,2,35,190,2011/2012
"Anderson,Ryan",332,757,.439,166,422,.393,166,335,.496,150,171,.877,224,247,471,54,50,57,26,146,980,2011/2012
"Anthony,Carmelo",441,1025,.430,68,203,.335,373,822,.454,295,367,.804,88,256,344,200,62,144,24,156,1245,2011/2012
"Anthony,Joel",85,152,.559,0,0,,85,152,.559,49,71,.690,100,150,250,9,36,45,84,126,219,2011/2012
"Arenas,Gilbert",26,64,.406,13,39,.333,13,25,.520,7,10,.700,2,16,18,18,11,12,1,35,72,2011/2012
"Ariza,Trevor",168,403,.417,29,87,.333,139,316,.440,79,102,.775,41,174,215,135,69,76,25,73,444,2011/2012
"Aşık,Ömer",79,156,.506,0,0,,79,156,.506,47,103,.456,127,223,350,32,30,68,68,121,205,2011/2012
"Augustin,D.J.",183,487,.376,61,179,.341,122,308,.396,105,120,.875,24,85,109,307,36,110,1,65,532,2011/2012
"Ayón,Gustavo",140,261,.536,0,1,.000,140,260,.538,39,63,.619,86,179,265,74,53,46,46,118,319,2011/2012
"Ayres,Jeff",15,36,.417,0,0,,15,36,.417,4,7,.571,12,21,33,4,3,2,2,16,34,2011/2012
"Azubuike,Kelenna",3,8,.375,1,3,.333,2,5,.400,0,0,,0,0,0,0,1,4,0,1,7,2011/2012
"Babbitt,Luke",71,173,.410,43,100,.430,28,73,.384,17,20,.850,16,79,95,16,10,27,4,46,202,2011/2012
"Balkman,Renaldo",16,32,.500,2,9,.222,14,23,.609,8,11,.727,6,20,26,5,4,6,3,14,42,2011/2012
"Barbosa,Leandro",271,637,.425,65,170,.382,206,467,.441,101,124,.815,33,95,128,96,56,94,7,135,708,2011/2012
"Barbosa,Leandro",198,454,.436,40,111,.360,158,343,.461,76,91,.835,21,58,79,63,36,68,7,101,512,2011/2012
"Barbosa,Leandro",73,183,.399,25,59,.424,48,124,.387,25,33,.758,12,37,49,33,20,26,0,34,196,2011/2012
"Barea,J.J.",167,418,.400,53,143,.371,114,275,.415,76,98,.776,14,100,114,232,21,103,0,61,463,2011/2012
"Bargnani,Andrea",209,484,.432,34,115,.296,175,369,.474,151,173,.873,24,148,172,61,18,69,15,52,603,2011/2012
"Barnes,Matt",175,387,.452,46,138,.333,129,249,.518,95,128,.742,97,247,344,126,35,73,48,152,491,2011/2012
"Barron,Earl",2,4,.500,0,0,,2,4,.500,0,0,,1,0,1,0,0,0,0,5,4,2011/2012
"Bass,Brandon",303,632,.479,0,0,,303,632,.479,132,163,.810,95,270,365,55,34,65,54,135,738,2011/2012
"Battie,Tony",19,51,.373,0,1,.000,19,50,.380,4,4,1.000,8,59,67,16,4,4,6,26,42,2011/2012
"Battier,Shane",113,292,.387,62,183,.339,51,109,.468,23,37,.622,56,100,156,82,64,37,33,105,311,2011/2012
"Batum,Nicolas",289,641,.451,107,274,.391,182,367,.496,133,159,.836,81,190,271,84,57,90,60,105,818,2011/2012
"Bayless,Jerryd",117,276,.424,44,104,.423,73,172,.424,75,88,.852,8,58,66,118,24,53,4,70,353,2011/2012
"Beasley,Michael",221,497,.445,38,101,.376,183,396,.462,61,95,.642,39,168,207,45,18,80,19,83,541,2011/2012
"Beaubois,Rodrigue",188,445,.422,38,132,.288,150,313,.479,58,69,.841,19,132,151,152,56,70,28,98,472,2011/2012
"Belinelli,Marco",286,686,.417,107,284,.377,179,402,.445,101,129,.783,19,153,172,101,48,69,5,115,780,2011/2012
"Bell,Raja",81,174,.466,34,87,.391,47,87,.540,21,25,.840,6,43,49,38,13,21,2,78,217,2011/2012
"Benson,Keith",0,1,.000,0,0,,0,1,.000,0,0,,2,1,3,0,0,0,0,0,0,2011/2012
"Bibby,Mike",35,124,.282,27,85,.318,8,39,.205,6,8,.750,5,54,59,80,21,20,3,45,103,2011/2012
"Biedriņš,Andris",39,64,.609,0,0,,39,64,.609,1,9,.111,45,131,176,16,23,14,45,125,79,2011/2012
"Billups,Chauncey",83,228,.364,48,125,.384,35,103,.340,85,95,.895,4,46,50,80,9,38,3,40,299,2011/2012
"Biyombo,Bismack",129,278,.464,0,0,,129,278,.464,69,143,.483,113,255,368,27,20,71,115,145,327,2011/2012
"Blair,DeJuan",269,504,.534,0,1,.000,269,503,.535,73,119,.613,154,197,351,78,59,92,12,168,611,2011/2012
"Blake,Steve",101,268,.377,53,158,.335,48,110,.436,21,27,.778,9,76,85,175,39,72,2,75,276,2011/2012
"Blatche,Andray",93,245,.380,2,7,.286,91,238,.382,33,49,.673,42,108,150,28,20,37,17,54,221,2011/2012
"Bledsoe,Eric",49,126,.389,6,30,.200,43,96,.448,28,44,.636,22,43,65,66,31,47,14,58,132,2011/2012
"Bogans,Keith",8,21,.381,3,12,.250,5,9,.556,2,5,.400,5,6,11,3,2,3,0,15,21,2011/2012
"Bogut,Andrew",61,136,.449,0,1,.000,61,135,.452,14,23,.609,22,78,100,31,12,24,24,36,136,2011/2012
"Bonner,Matt",154,350,.440,105,250,.420,49,100,.490,16,21,.762,29,185,214,61,15,14,21,68,429,2011/2012
"Booker,Trevor",181,341,.531,1,2,.500,180,339,.531,56,93,.602,119,206,325,40,48,58,43,138,419,2011/2012
"Boozer,Carlos",448,842,.532,0,1,.000,448,841,.533,95,137,.693,114,450,564,125,63,115,24,168,991,2011/2012
"Bosh,Chris",393,807,.487,10,35,.286,383,772,.496,229,279,.821,94,358,452,103,51,117,45,128,1025,2011/2012
"Boykins,Earl",12,36,.333,2,9,.222,10,27,.370,13,15,.867,0,11,11,17,1,7,0,5,39,2011/2012
"Brackins,Craig",9,33,.273,3,9,.333,6,24,.250,1,2,.500,5,10,15,8,0,4,1,6,22,2011/2012
"Bradley,Avery",200,402,.498,22,54,.407,178,348,.511,62,78,.795,34,81,115,87,43,75,12,109,484,2011/2012
"Brand,Elton",287,581,.494,0,1,.000,287,580,.495,85,116,.733,145,284,429,97,58,65,97,176,659,2011/2012
"Brewer,Corey",201,463,.434,33,127,.260,168,336,.500,90,130,.692,43,107,150,88,72,56,17,113,525,2011/2012
"Brewer,Ronnie",190,445,.427,19,69,.275,171,376,.455,56,100,.560,72,159,231,137,72,59,21,64,455,2011/2012
"Brockman,Jon",15,45,.333,0,1,.000,15,44,.341,7,15,.467,33,42,75,9,4,10,1,33,37,2011/2012
"Brooks,MarShon",274,640,.428,47,150,.313,227,490,.463,113,148,.764,70,130,200,131,52,118,15,116,708,2011/2012
"Brown,Derrick",212,409,.518,6,24,.250,206,385,.535,94,141,.667,95,141,236,67,48,55,12,96,524,2011/2012
"Brown,Kwame",21,40,.525,0,0,,21,40,.525,15,34,.441,16,41,57,4,8,14,0,21,57,2011/2012
"Brown,Shannon",251,598,.420,68,188,.362,183,410,.446,80,99,.808,38,119,157,69,44,64,15,66,650,2011/2012
"Bryant,Kobe",574,1336,.430,87,287,.303,487,1049,.464,381,451,.845,66,247,313,264,69,204,18,105,1616,2011/2012
"Budinger,Chase",208,471,.442,88,219,.402,120,252,.476,54,70,.771,38,179,217,74,29,55,7,65,558,2011/2012
"Burks,Alec",153,357,.429,15,45,.333,138,312,.442,104,143,.727,57,75,132,55,27,51,5,84,425,2011/2012
"Butler,Caron",287,705,.407,92,257,.358,195,448,.435,87,107,.813,44,186,230,78,52,77,9,123,753,2011/2012
"Butler,Jimmy",32,79,.405,2,11,.182,30,68,.441,43,56,.768,23,33,56,14,11,14,5,20,109,2011/2012
"Butler,Rasual",41,133,.308,21,77,.273,20,56,.357,7,12,.583,6,60,66,19,7,15,5,39,110,2011/2012
"Byars,Derrick",3,11,.273,0,6,.000,3,5,.600,4,4,1.000,6,5,11,1,2,0,0,2,10,2011/2012
"Bynum,Andrew",444,796,.558,1,5,.200,443,791,.560,234,338,.692,192,517,709,85,27,152,116,104,1123,2011/2012
"Bynum,Will",74,194,.381,7,29,.241,67,165,.406,49,64,.766,10,46,56,66,23,54,3,61,204,2011/2012
"Calderón,José",218,477,.457,59,159,.371,159,318,.500,60,68,.882,19,141,160,468,47,104,3,94,555,2011/2012
"Camby,Marcus",128,287,.446,2,5,.400,126,282,.447,29,64,.453,157,373,530,107,50,57,85,126,287,2011/2012
"Camby,Marcus",67,161,.416,0,0,,67,161,.416,18,38,.474,105,249,354,75,33,47,56,88,152,2011/2012
"Camby,Marcus",61,126,.484,2,5,.400,59,121,.488,11,26,.423,52,124,176,32,17,10,29,38,135,2011/2012
"Cardinal,Brian",14,55,.255,10,49,.204,4,6,.667,5,6,.833,4,30,34,16,8,8,2,38,43,2011/2012
"Carroll,DeMarre",43,105,.410,7,19,.368,36,86,.419,14,16,.875,28,25,53,18,12,11,1,37,107,2011/2012
"Carroll,DeMarre",6,6,1.000,0,0,,6,6,1.000,0,0,,0,3,3,3,0,2,0,1,12,2011/2012
"Carroll,DeMarre",37,99,.374,7,19,.368,30,80,.375,14,16,.875,28,22,50,15,12,9,1,36,95,2011/2012
"Carroll,Matt",52,157,.331,8,43,.186,44,114,.386,30,38,.789,8,50,58,38,16,24,7,52,142,2011/2012
"Carter,Anthony",17,53,.321,5,17,.294,12,36,.333,8,10,.800,5,28,33,34,8,17,4,20,47,2011/2012
"Carter,Vince",223,542,.411,74,205,.361,149,337,.442,95,115,.826,32,173,205,139,56,84,25,134,615,2011/2012
"Casspi,Omri",166,412,.403,53,168,.315,113,244,.463,74,108,.685,63,165,228,66,37,64,21,115,459,2011/2012
"Chalmers,Mario",223,498,.448,101,260,.388,122,238,.513,80,101,.792,16,155,171,222,97,142,11,166,627,2011/2012
"Chandler,Tyson",241,355,.679,0,2,.000,241,353,.683,217,315,.689,212,400,612,56,56,102,89,186,699,2011/2012
"Chandler,Wilson",31,79,.392,3,12,.250,28,67,.418,10,12,.833,6,35,41,17,6,18,6,18,75,2011/2012
"Childress,Josh",48,99,.485,4,24,.167,44,75,.587,0,2,.000,31,64,95,34,14,9,6,38,100,2011/2012
"Clark,Earl",51,139,.367,0,0,,51,139,.367,21,29,.724,35,89,124,18,12,25,32,72,123,2011/2012
"Cole,Norris",177,450,.393,21,76,.276,156,374,.417,66,85,.776,21,70,91,133,44,105,2,124,441,2011/2012
"Collins,Jason",16,40,.400,0,0,,16,40,.400,7,15,.467,12,36,48,10,4,10,3,34,39,2011/2012
"Collison,Darren",230,523,.440,34,94,.362,196,429,.457,127,153,.830,30,157,187,287,49,114,14,101,621,2011/2012
"Collison,Nick",120,201,.597,0,1,.000,120,200,.600,44,62,.710,119,155,274,82,33,61,28,153,284,2011/2012
"Conley,Mike",296,684,.433,60,159,.377,236,525,.450,136,158,.861,22,134,156,404,136,125,11,133,788,2011/2012
"Cook,Brian",31,98,.316,10,50,.200,21,48,.438,9,10,.900,10,53,63,10,6,11,5,48,81,2011/2012
"Cook,Brian",11,49,.224,5,27,.185,6,22,.273,4,4,1.000,4,19,23,2,2,4,4,26,31,2011/2012
"Cook,Brian",20,49,.408,5,23,.217,15,26,.577,5,6,.833,6,34,40,8,4,7,1,22,50,2011/2012
"Cook,Daequan",109,296,.368,79,228,.346,30,68,.441,14,22,.636,12,110,122,15,22,16,11,69,311,2011/2012
"Cousins,DeMarcus",448,999,.448,2,14,.143,446,985,.453,262,373,.702,265,438,703,102,93,170,75,257,1160,2011/2012
"Crawford,Jamal",283,737,.384,80,260,.308,203,477,.426,191,206,.927,16,102,118,191,55,111,14,74,837,2011/2012
"Crawford,Jordan",349,872,.400,79,273,.289,270,599,.451,161,203,.793,44,124,168,190,59,141,5,111,938,2011/2012
"Cunningham,Dante",144,279,.516,0,2,.000,144,277,.520,45,69,.652,91,155,246,37,42,29,34,98,333,2011/2012
"Curry,Eddy",12,26,.462,0,0,,12,26,.462,6,8,.750,4,8,12,1,0,10,2,17,30,2011/2012
"Curry,Stephen",145,296,.490,55,121,.455,90,175,.514,38,47,.809,15,73,88,138,39,65,8,62,383,2011/2012
"Dalembert,Samuel",200,395,.506,0,1,.000,200,394,.508,90,113,.796,158,298,456,33,37,82,111,162,490,2011/2012
"Dampier,Erick",1,8,.125,0,0,,1,8,.125,0,0,,10,15,25,4,1,3,4,9,2,2011/2012
"Daniels,Marquis",52,143,.364,0,10,.000,52,133,.391,17,23,.739,16,50,66,47,21,28,9,36,121,2011/2012
"Davis,Baron",68,184,.370,26,85,.306,42,99,.424,16,24,.667,13,43,56,135,34,76,3,61,178,2011/2012
"Davis,Ed",172,335,.513,0,1,.000,172,334,.515,71,106,.670,134,304,438,60,40,67,63,156,415,2011/2012
"Davis,Glen",225,534,.421,2,14,.143,223,520,.429,114,167,.683,107,224,331,47,43,75,19,106,566,2011/2012
"Davis,Josh",10,27,.370,4,13,.308,6,14,.429,4,8,.500,16,11,27,6,7,3,1,19,28,2011/2012
"Dawson,Eric",7,12,.583,0,0,,7,12,.583,1,2,.500,5,5,10,0,1,3,2,6,15,2011/2012
"Daye,Austin",73,227,.322,13,62,.210,60,165,.364,35,43,.814,14,77,91,33,22,40,21,62,194,2011/2012
"Delfino,Carlos",182,453,.402,86,239,.360,96,214,.449,38,48,.792,20,188,208,123,79,66,10,99,488,2011/2012
"Deng,Luol",311,755,.412,79,215,.367,232,540,.430,127,165,.770,77,273,350,157,56,96,36,81,828,2011/2012
"Dentmon,Justin",10,28,.357,2,14,.143,8,14,.571,4,6,.667,0,8,8,10,2,7,0,10,26,2011/2012
"Dentmon,Justin",2,6,.333,0,4,.000,2,2,1.000,0,0,,0,1,1,1,1,1,0,2,4,2011/2012
"Dentmon,Justin",8,22,.364,2,10,.200,6,12,.500,4,6,.667,0,7,7,9,1,6,0,8,22,2011/2012
"DeRozan,DeMar",381,903,.422,24,92,.261,357,811,.440,268,331,.810,40,171,211,128,48,123,17,162,1054,2011/2012
"Diaw,Boris",156,351,.444,31,99,.313,125,252,.496,22,35,.629,70,210,280,205,34,112,25,125,365,2011/2012
"Diaw,Boris",116,283,.410,23,86,.267,93,197,.472,17,27,.630,47,148,195,158,20,84,19,71,272,2011/2012
"Diaw,Boris",40,68,.588,8,13,.615,32,55,.582,5,8,.625,23,62,85,47,14,28,6,54,93,2011/2012
"Diogu,Ike",0,2,.000,0,0,,0,2,.000,2,2,1.000,0,1,1,0,0,1,0,1,2,2011/2012
"Diop,DeSagana",15,42,.357,0,0,,15,42,.357,1,6,.167,33,52,85,23,6,19,13,36,31,2011/2012
"Dooling,Keyon",66,163,.405,27,81,.333,39,82,.476,23,31,.742,3,36,39,51,13,34,2,57,182,2011/2012
"Douglas,Toney",94,290,.324,27,117,.231,67,173,.387,22,26,.846,16,56,72,77,29,56,1,55,237,2011/2012
"Dragić,Goran",277,600,.462,68,202,.337,209,398,.525,153,190,.805,53,115,168,351,85,157,10,166,775,2011/2012
"Dudley,Jared",312,643,.485,80,209,.383,232,434,.535,119,164,.726,95,206,301,112,49,72,19,107,823,2011/2012
"Duhon,Chris",85,203,.419,50,119,.420,35,84,.417,17,21,.810,14,88,102,151,35,81,9,71,237,2011/2012
"Duncan,Tim",361,733,.492,0,4,.000,361,729,.495,173,249,.695,110,410,520,132,38,97,88,98,895,2011/2012
"Dunleavy,Mike",239,504,.474,83,208,.399,156,296,.527,116,143,.811,29,175,204,117,28,58,8,87,677,2011/2012
"Durant,Kevin",643,1297,.496,133,344,.387,510,953,.535,431,501,.860,40,487,527,231,88,248,77,133,1850,2011/2012
"Dyson,Jerome",19,48,.396,1,8,.125,18,40,.450,28,36,.778,2,17,19,18,11,20,2,19,67,2011/2012
"Ebanks,Devin",37,89,.416,0,9,.000,37,80,.463,23,35,.657,26,28,54,12,11,18,6,26,97,2011/2012
"Ellington,Wayne",122,302,.404,35,108,.324,87,194,.448,32,40,.800,14,85,99,33,26,26,10,56,311,2011/2012
"Ellis,Monta",450,1040,.433,62,201,.308,388,839,.462,219,275,.796,20,180,200,346,85,177,18,136,1181,2011/2012
"Ellis,Monta",305,704,.433,50,156,.321,255,548,.465,151,186,.812,16,111,127,223,56,123,12,84,811,2011/2012
"Ellis,Monta",145,336,.432,12,45,.267,133,291,.457,68,89,.764,4,69,73,123,29,54,6,52,370,2011/2012
"Elson,Francisco",1,3,.333,0,0,,1,3,.333,0,0,,0,1,1,1,1,1,1,0,2,2011/2012
"Emmett,Andre",4,7,.571,0,1,.000,4,6,.667,5,8,.625,2,4,6,1,2,2,1,2,13,2011/2012
"Erden,Semih",39,74,.527,0,0,,39,74,.527,21,41,.512,20,52,72,9,10,16,5,60,99,2011/2012
"Evans,Jeremy",27,42,.643,0,1,.000,27,41,.659,8,16,.500,19,31,50,13,6,5,24,23,62,2011/2012
"Evans,Maurice",45,112,.402,17,45,.378,28,67,.418,10,13,.769,8,16,24,9,14,10,0,36,117,2011/2012
"Evans,Reggie",34,72,.472,0,0,,34,72,.472,36,71,.507,100,171,271,17,31,44,6,118,104,2011/2012
"Evans,Tyreke",408,900,.453,20,99,.202,388,801,.484,201,258,.779,64,225,289,283,84,171,29,136,1037,2011/2012
"Eyenga,Christian",6,25,.240,1,3,.333,5,22,.227,4,8,.500,4,10,14,5,3,3,5,7,17,2011/2012
"Eyenga,Christian",3,19,.158,1,2,.500,2,17,.118,2,6,.333,3,9,12,4,3,2,4,7,9,2011/2012
"Eyenga,Christian",3,6,.500,0,1,.000,3,5,.600,2,2,1.000,1,1,2,1,0,1,1,0,8,2011/2012
"Faried,Kenneth",181,309,.586,0,0,,181,309,.586,109,164,.665,142,210,352,36,34,54,47,116,471,2011/2012
"Farmar,Jordan",147,315,.467,55,125,.440,92,190,.484,57,63,.905,7,54,61,129,24,68,2,49,406,2011/2012
"Favors,Derrick",222,445,.499,0,0,,222,445,.499,126,194,.649,158,267,425,43,38,103,65,145,570,2011/2012
"Felton,Raymond",261,642,.407,62,203,.305,199,439,.453,100,124,.806,27,122,149,390,78,170,10,122,684,2011/2012
"Fernández,Rudy",99,225,.440,40,122,.328,59,103,.573,30,43,.698,9,56,65,75,31,40,3,37,268,2011/2012
"Fesenko,Kyrylo",2,5,.400,0,0,,2,5,.400,4,6,.667,2,7,9,1,2,0,0,2,8,2011/2012
"Fields,Landry",236,513,.460,31,121,.256,205,392,.523,77,137,.562,59,219,278,169,79,102,17,99,580,2011/2012
"Fisher,Derek",129,348,.371,35,109,.321,94,239,.393,57,67,.851,12,109,121,170,51,73,4,117,350,2011/2012
"Fisher,Derek",92,240,.383,24,74,.324,68,166,.410,44,53,.830,10,82,92,142,40,58,3,85,252,2011/2012
"Fisher,Derek",37,108,.343,11,35,.314,26,73,.356,13,14,.929,2,27,29,28,11,15,1,32,98,2011/2012
"Flynn,Jonny",46,131,.351,10,34,.294,36,97,.371,29,39,.744,8,31,39,96,6,36,2,23,131,2011/2012
"Flynn,Jonny",12,41,.293,2,9,.222,10,32,.313,11,14,.786,1,7,8,28,3,9,1,8,37,2011/2012
"Flynn,Jonny",34,90,.378,8,25,.320,26,65,.400,18,25,.720,7,24,31,68,3,27,1,15,94,2011/2012
"Foote,Jeff",2,6,.333,0,0,,2,6,.333,0,0,,1,5,6,0,0,2,1,5,4,2011/2012
"Forbes,Gary",112,271,.413,29,83,.349,83,188,.441,66,91,.725,27,75,102,54,24,54,4,56,319,2011/2012
"Ford,T.J.",19,43,.442,2,8,.250,17,35,.486,11,14,.786,3,15,18,45,9,23,2,23,51,2011/2012
"Fortson,Courtney",11,32,.344,3,13,.231,8,19,.421,10,15,.667,6,9,15,10,3,10,0,5,35,2011/2012
"Fortson,Courtney",5,12,.417,1,4,.250,4,8,.500,6,9,.667,4,4,8,5,0,5,0,3,17,2011/2012
"Fortson,Courtney",6,20,.300,2,9,.222,4,11,.364,4,6,.667,2,5,7,5,3,5,0,2,18,2011/2012
"Foster,Jeff",9,18,.500,1,1,1.000,8,17,.471,6,9,.667,18,24,42,4,8,7,1,26,25,2011/2012
"Foye,Randy",256,644,.398,127,329,.386,129,315,.410,73,85,.859,25,113,138,146,46,73,24,130,712,2011/2012
"Fredette,Jimmer",172,446,.386,78,216,.361,94,230,.409,40,48,.833,17,56,73,108,30,67,3,73,462,2011/2012
"Frye,Channing",255,613,.416,91,263,.346,164,350,.469,73,82,.890,71,308,379,88,42,63,70,176,674,2011/2012
"Gadzuric,Dan",0,2,.000,0,0,,0,2,.000,0,2,.000,1,4,5,0,1,1,1,4,0,2011/2012
"Gaines,Sundiata",102,271,.376,28,82,.341,74,189,.392,59,96,.615,27,81,108,126,55,52,2,58,291,2011/2012
"Gallinari,Danilo",193,466,.414,60,183,.328,133,283,.470,182,209,.871,28,174,202,116,42,68,23,86,628,2011/2012
"García,Francisco",86,229,.376,38,131,.290,48,98,.490,24,30,.800,11,88,99,31,36,22,37,73,234,2011/2012
"Garnett,Kevin",391,777,.503,3,9,.333,388,768,.505,162,189,.857,66,428,494,175,56,107,61,141,947,2011/2012
"Gasol,Marc",357,740,.482,1,12,.083,356,728,.489,237,317,.748,120,459,579,204,62,121,121,201,952,2011/2012
"Gasol,Pau",459,917,.501,7,27,.259,452,890,.508,204,261,.782,183,495,678,237,37,142,88,127,1129,2011/2012
"Gay,Rudy",485,1067,.455,54,173,.312,431,894,.482,208,263,.791,130,287,417,147,95,161,55,138,1232,2011/2012
"Gee,Alonzo",227,551,.412,44,137,.321,183,414,.442,167,212,.788,101,221,322,113,83,114,17,149,665,2011/2012
"George,Paul",281,639,.440,90,234,.385,191,405,.472,146,182,.802,56,314,370,158,108,117,38,191,798,2011/2012
"Gibson,Daniel",87,248,.351,55,139,.396,32,109,.294,34,43,.791,11,90,101,76,26,45,16,69,263,2011/2012
"Gibson,Taj",200,404,.495,0,0,,200,404,.495,84,135,.622,135,197,332,47,27,60,81,131,484,2011/2012
"Ginóbili,Manu",150,285,.526,52,126,.413,98,159,.616,88,101,.871,18,98,116,151,24,64,12,56,440,2011/2012
"Gladness,Mickell",25,59,.424,0,0,,25,59,.424,6,12,.500,14,44,58,5,4,7,20,32,56,2011/2012
"Gladness,Mickell",1,3,.333,0,0,,1,3,.333,0,0,,1,10,11,2,1,3,1,8,2,2011/2012
"Gladness,Mickell",24,56,.429,0,0,,24,56,.429,6,12,.500,13,34,47,3,3,4,19,24,54,2011/2012
"Gomes,Ryan",31,95,.326,4,29,.138,27,66,.409,8,11,.727,14,47,61,12,16,15,0,34,74,2011/2012
"Gooden,Drew",287,657,.437,16,55,.291,271,602,.450,176,208,.846,130,233,363,144,46,109,34,112,766,2011/2012
"Gordon,Ben",234,530,.442,63,147,.429,171,383,.446,117,136,.860,14,107,121,127,34,115,11,114,648,2011/2012
"Gordon,Eric",63,140,.450,10,40,.250,53,100,.530,49,65,.754,2,23,25,31,13,24,4,20,185,2011/2012
"Gortat,Marcin",427,769,.555,0,2,.000,427,767,.557,163,251,.649,185,474,659,59,48,90,99,142,1017,2011/2012
"Goudelock,Andrew",68,174,.391,28,75,.373,40,99,.404,11,12,.917,5,26,31,20,4,21,0,32,175,2011/2012
"Granger,Danny",391,941,.416,123,323,.381,268,618,.434,254,291,.873,79,228,307,109,62,110,40,144,1159,2011/2012
"Gray,Aaron",83,161,.516,0,0,,83,161,.516,25,47,.532,83,198,281,27,22,51,17,127,191,2011/2012
"Green,Danny",211,477,.442,102,234,.436,109,243,.449,79,100,.790,54,174,228,86,58,67,46,107,603,2011/2012
"Green,Gerald",154,320,.481,43,110,.391,111,210,.529,49,65,.754,15,93,108,34,28,55,17,80,400,2011/2012
"Green,Willie",153,325,.471,50,113,.442,103,212,.486,48,56,.857,15,65,80,40,23,33,6,74,404,2011/2012
"Greene,Donté",108,266,.406,25,105,.238,83,161,.516,44,55,.800,19,114,133,34,18,32,29,67,285,2011/2012
"Griffin,Blake",561,1022,.549,2,16,.125,559,1006,.556,244,468,.521,218,499,717,210,54,150,48,216,1368,2011/2012
"Haddadi,Hamed",26,48,.542,0,1,.000,26,47,.553,18,26,.692,28,43,71,8,1,21,26,43,70,2011/2012
"Hamilton,Jordan",48,111,.432,17,47,.362,31,64,.484,2,5,.400,11,51,62,20,4,16,3,15,115,2011/2012
"Hamilton,Richard",140,310,.452,17,46,.370,123,264,.466,29,37,.784,20,46,66,84,12,49,1,56,326,2011/2012
"Hansbrough,Tyler",194,479,.405,0,1,.000,194,478,.406,226,278,.813,113,177,290,30,54,65,9,159,614,2011/2012
"Harangody,Luke",23,65,.354,5,21,.238,18,44,.409,9,12,.750,20,33,53,6,6,4,3,17,60,2011/2012
"Harden,James",309,629,.491,114,292,.390,195,337,.579,312,369,.846,30,222,252,229,62,137,15,150,1044,2011/2012
"Harper,Justin",9,31,.290,2,13,.154,7,18,.389,0,1,.000,3,9,12,2,2,6,3,5,20,2011/2012
"Harrellson,Josh",63,149,.423,20,59,.339,43,90,.478,16,26,.615,47,97,144,11,23,20,20,48,162,2011/2012
"Harrington,Al",345,773,.446,101,303,.333,244,470,.519,119,176,.676,72,318,390,88,58,112,12,181,910,2011/2012
"Harris,Devin",241,542,.445,77,213,.362,164,329,.498,156,209,.746,12,100,112,316,64,122,13,136,715,2011/2012
"Harris,Manny",60,150,.400,12,36,.333,48,114,.421,41,59,.695,11,59,70,31,13,27,6,28,173,2011/2012
"Harris,Terrel",29,83,.349,8,39,.205,21,44,.477,14,21,.667,18,33,51,26,9,25,2,34,80,2011/2012
"Harris,Tobias",79,169,.467,6,23,.261,73,146,.500,44,54,.815,30,71,101,22,13,31,7,45,208,2011/2012
"Haslem,Udonis",151,357,.423,0,0,,151,357,.423,83,102,.814,117,353,470,42,35,60,24,142,385,2011/2012
"Hawes,Spencer",156,319,.489,3,12,.250,153,307,.498,40,55,.727,78,192,270,98,16,55,48,100,355,2011/2012
"Hayes,Chuck",73,170,.429,0,2,.000,73,168,.435,26,39,.667,72,162,234,77,36,50,17,111,172,2011/2012
"Hayward,Gordon",267,586,.456,55,159,.346,212,427,.496,193,232,.832,59,171,230,207,53,109,41,106,782,2011/2012
"Hayward,Lazar",13,38,.342,4,14,.286,9,24,.375,7,12,.583,2,14,16,4,3,9,1,18,37,2011/2012
"Haywood,Brendan",118,228,.518,0,0,,118,228,.518,45,96,.469,139,185,324,19,24,46,54,121,281,2011/2012
"Henderson,Gerald",332,723,.459,11,47,.234,321,676,.475,155,204,.760,64,161,225,126,49,100,20,128,830,2011/2012
"Henry,Xavier",90,228,.395,7,17,.412,83,211,.393,52,85,.612,24,82,106,35,26,35,8,59,239,2011/2012
"Hibbert,Roy",332,668,.497,0,1,.000,332,667,.498,170,239,.711,213,359,572,108,32,128,128,195,834,2011/2012
"Hickson,J.J.",183,392,.467,0,2,.000,183,390,.469,86,134,.642,133,202,335,45,30,70,35,85,452,2011/2012
"Hickson,J.J.",64,173,.370,0,1,.000,64,172,.372,37,58,.638,67,110,177,22,18,39,17,44,165,2011/2012
"Hickson,J.J.",119,219,.543,0,1,.000,119,218,.546,49,76,.645,66,92,158,23,12,31,18,41,287,2011/2012
"Higgins,Cory",52,160,.325,4,20,.200,48,140,.343,42,60,.700,7,28,35,36,5,39,6,40,150,2011/2012
"Hilário,Nenê",211,393,.537,0,4,.000,211,389,.542,113,168,.673,63,228,291,80,42,96,38,95,535,2011/2012
"Hilário,Nenê",143,281,.509,0,2,.000,143,279,.513,90,133,.677,43,165,208,61,36,77,25,69,376,2011/2012
"Hilário,Nenê",68,112,.607,0,2,.000,68,110,.618,23,35,.657,20,63,83,19,6,19,13,26,159,2011/2012
"Hill,George",168,380,.442,54,147,.367,114,233,.489,91,117,.778,31,120,151,145,42,52,17,98,481,2011/2012
"Hill,Grant",201,451,.446,14,53,.264,187,398,.470,83,109,.761,29,142,171,107,41,65,29,88,499,2011/2012
"Hill,Jordan",82,165,.497,0,3,.000,82,162,.506,30,47,.638,61,125,186,16,14,31,27,71,194,2011/2012
"Hill,Jordan",68,135,.504,0,3,.000,68,132,.515,25,39,.641,47,108,155,14,9,24,21,60,161,2011/2012
"Hill,Jordan",14,30,.467,0,0,,14,30,.467,5,8,.625,14,17,31,2,5,7,6,11,33,2011/2012
"Hinrich,Kirk",122,295,.414,47,136,.346,75,159,.472,25,32,.781,11,90,101,132,38,58,11,100,316,2011/2012
"Hobson,Darington",2,13,.154,0,6,.000,2,7,.286,0,0,,0,3,3,6,0,2,0,1,4,2011/2012
"Holiday,Jrue",360,834,.432,65,171,.380,295,663,.445,94,120,.783,57,155,212,290,103,135,18,137,879,2011/2012
"Hollins,Ryan",46,84,.548,0,0,,46,84,.548,39,75,.520,34,48,82,9,5,35,17,78,131,2011/2012
"Hollins,Ryan",28,56,.500,0,0,,28,56,.500,33,55,.600,25,31,56,6,4,24,12,55,89,2011/2012
"Hollins,Ryan",18,28,.643,0,0,,18,28,.643,6,20,.300,9,17,26,3,1,11,5,23,42,2011/2012
"Honeycutt,Tyler",8,24,.333,1,3,.333,7,21,.333,3,5,.600,3,11,14,7,4,2,3,3,20,2011/2012
"Horford,Al",57,103,.553,0,1,.000,57,102,.559,22,30,.733,26,51,77,24,10,16,14,21,136,2011/2012
"Horner,Dennis",1,4,.250,0,1,.000,1,3,.333,3,4,.750,2,3,5,0,0,1,0,1,5,2011/2012
"Howard,Dwight",416,726,.573,0,7,.000,416,719,.579,281,572,.491,200,585,785,104,81,175,116,159,1113,2011/2012
"Howard,Josh",144,361,.399,9,37,.243,135,324,.417,75,97,.773,39,119,158,50,32,53,10,91,372,2011/2012
"Howard,Juwan",17,55,.309,0,0,,17,55,.309,8,10,.800,18,29,47,10,4,20,1,18,42,2011/2012
"Hudson,Lester",62,162,.383,16,64,.250,46,98,.469,34,41,.829,7,39,46,36,14,32,3,26,174,2011/2012
"Hudson,Lester",59,151,.391,15,61,.246,44,90,.489,32,38,.842,7,39,46,35,14,30,3,26,165,2011/2012
"Hudson,Lester",3,11,.273,1,3,.333,2,8,.250,2,3,.667,0,0,0,1,0,2,0,0,9,2011/2012
"Hughes,Larry",5,22,.227,1,7,.143,4,15,.267,1,2,.500,1,4,5,7,2,12,0,10,12,2011/2012
"Humphries,Kris",323,671,.481,0,0,,323,671,.481,209,278,.752,233,448,681,90,50,119,74,173,855,2011/2012
"Ibaka,Serge",262,490,.535,1,3,.333,261,487,.536,78,118,.661,193,305,498,28,33,79,241,179,603,2011/2012
"Iguodala,Andre",287,632,.454,76,193,.394,211,439,.481,121,196,.617,56,325,381,339,107,115,30,92,771,2011/2012
"İlyasova,Ersan",294,597,.492,51,112,.455,243,485,.501,143,183,.781,196,333,529,71,42,76,44,133,782,2011/2012
"Irving,Kyrie",350,747,.469,73,183,.399,277,564,.491,171,196,.872,44,147,191,275,54,160,20,110,944,2011/2012
"Ivey,Royal",26,73,.356,18,53,.340,8,20,.400,1,8,.125,1,23,24,10,14,9,0,36,71,2011/2012
"Jack,Jarrett",266,583,.456,39,112,.348,227,471,.482,129,148,.872,23,153,176,285,31,106,9,93,700,2011/2012
"Jackson,Reggie",51,159,.321,13,62,.210,38,97,.392,25,29,.862,14,39,53,71,25,36,1,31,140,2011/2012
"Jackson,Stephen",159,425,.374,49,170,.288,110,255,.431,94,114,.825,22,141,163,118,54,103,13,99,461,2011/2012
"Jackson,Stephen",97,272,.357,30,108,.278,67,164,.409,50,60,.833,16,66,82,77,26,66,6,61,274,2011/2012
"Jackson,Stephen",62,153,.405,19,62,.306,43,91,.473,44,54,.815,6,75,81,41,28,37,7,38,187,2011/2012
"James,Damion",13,35,.371,0,1,.000,13,34,.382,8,12,.667,7,26,33,3,7,12,7,17,34,2011/2012
"James,LeBron",621,1169,.531,54,149,.362,567,1020,.556,387,502,.771,94,398,492,387,115,213,50,96,1683,2011/2012
"James,Mike",20,49,.408,6,10,.600,14,39,.359,7,8,.875,2,8,10,29,4,14,2,20,53,2011/2012
"Jamison,Antawn",421,1044,.403,91,267,.341,330,777,.425,185,271,.683,123,285,408,131,51,90,43,164,1118,2011/2012
"Jefferson,Al",516,1048,.492,1,4,.250,515,1044,.493,137,177,.774,133,452,585,134,47,62,101,155,1170,2011/2012
"Jefferson,Richard",203,488,.416,113,269,.420,90,219,.411,59,85,.694,26,193,219,88,37,50,19,121,578,2011/2012
"Jefferson,Richard",132,319,.414,80,190,.421,52,129,.403,35,50,.700,18,125,143,55,25,32,12,83,379,2011/2012
"Jefferson,Richard",71,169,.420,33,79,.418,38,90,.422,24,35,.686,8,68,76,33,12,18,7,38,199,2011/2012
"Jeffries,Jared",59,144,.410,3,16,.188,56,128,.438,49,72,.681,69,83,152,26,29,29,25,89,170,2011/2012
"Jenkins,Charles",130,291,.447,3,20,.150,127,271,.469,34,39,.872,8,60,68,170,33,60,6,85,297,2011/2012
"Jennings,Brandon",469,1121,.418,129,388,.332,340,733,.464,193,239,.808,49,177,226,365,104,146,22,114,1260,2011/2012
"Jerebko,Jonas",212,453,.468,32,106,.302,180,347,.519,100,124,.806,96,212,308,43,41,66,21,162,556,2011/2012
"Jianlian,Yi",31,82,.378,3,10,.300,28,72,.389,14,21,.667,12,37,49,5,7,14,8,23,79,2011/2012
"Johnson,Amir",196,340,.576,2,5,.400,194,335,.579,58,84,.690,149,259,408,79,33,94,69,209,452,2011/2012
"Johnson,Armon",20,43,.465,1,3,.333,19,40,.475,6,6,1.000,1,12,13,11,5,6,0,9,47,2011/2012
"Johnson,Armon",1,1,1.000,0,0,,1,1,1.000,0,0,,0,1,1,0,1,1,0,0,2,2011/2012
"Johnson,Armon",19,42,.452,1,3,.333,18,39,.462,6,6,1.000,1,11,12,11,4,5,0,9,45,2011/2012
"Johnson,Carldell",11,35,.314,4,15,.267,7,20,.350,1,3,.333,1,8,9,22,8,7,0,11,27,2011/2012
"Johnson,Chris",20,41,.488,0,0,,20,41,.488,15,19,.789,15,25,40,2,6,15,9,33,55,2011/2012
"Johnson,Chris",11,23,.478,0,0,,11,23,.478,10,12,.833,8,10,18,1,1,7,8,20,32,2011/2012
"Johnson,Chris",9,18,.500,0,0,,9,18,.500,5,7,.714,7,15,22,1,5,8,1,13,23,2011/2012
"Johnson,Ivan",141,275,.513,2,6,.333,139,269,.517,72,100,.720,65,161,226,32,43,69,18,116,356,2011/2012
"Johnson,JaJuan",54,121,.446,0,0,,54,121,.446,6,9,.667,20,38,58,6,5,14,14,25,114,2011/2012
"Johnson,James",233,518,.450,19,60,.317,214,458,.467,81,115,.704,74,218,292,122,71,101,84,177,566,2011/2012
"Johnson,Joe",423,931,.454,125,322,.388,298,609,.489,158,186,.849,53,168,221,232,48,116,13,75,1129,2011/2012
"Johnson,Trey",8,14,.571,0,0,,8,14,.571,5,5,1.000,3,9,12,4,1,5,0,10,21,2011/2012
"Johnson,Wesley",158,397,.398,53,169,.314,105,228,.461,24,34,.706,24,153,177,59,35,60,48,115,393,2011/2012
"Jones,Dahntay",115,281,.409,33,77,.429,82,204,.402,83,99,.838,23,94,117,63,23,46,11,119,346,2011/2012
"Jones,Dominique",29,73,.397,1,8,.125,28,65,.431,29,37,.784,9,35,44,42,10,28,5,28,88,2011/2012
"Jones,James",57,150,.380,46,114,.404,11,36,.306,25,30,.833,6,43,49,19,17,10,9,45,185,2011/2012
"Jones,Solomon",24,61,.393,0,0,,24,61,.393,19,23,.826,32,26,58,9,9,18,11,43,67,2011/2012
"Jones,Solomon",1,8,.125,0,0,,1,8,.125,4,5,.800,11,6,17,2,4,5,5,12,6,2011/2012
"Jones,Solomon",23,53,.434,0,0,,23,53,.434,15,18,.833,21,20,41,7,5,13,6,31,61,2011/2012
"Jordan,DeAndre",206,326,.632,0,1,.000,206,325,.634,74,141,.525,202,344,546,17,30,74,134,189,486,2011/2012
"Jordan,Jerome",17,33,.515,0,0,,17,33,.515,8,10,.800,14,13,27,4,1,2,6,15,42,2011/2012
"Joseph,Cory",22,70,.314,3,15,.200,19,55,.345,11,17,.647,5,20,25,34,7,12,3,16,58,2011/2012
"Kaman,Chris",266,597,.446,0,0,,266,597,.446,84,107,.785,89,275,364,101,25,129,77,106,616,2011/2012
"Kanter,Enes",117,236,.496,0,1,.000,117,235,.498,70,105,.667,107,171,278,8,18,54,23,87,304,2011/2012
"Kapono,Jason",21,55,.382,8,27,.296,13,28,.464,4,4,1.000,2,12,14,11,3,6,0,21,54,2011/2012
"Kennedy,D.J.",5,12,.417,2,4,.500,3,8,.375,0,2,.000,1,6,7,3,2,3,0,7,12,2011/2012
"Kidd,Jason",99,273,.363,79,223,.354,20,50,.400,22,28,.786,15,183,198,264,82,91,10,83,299,2011/2012
"Kleiza,Linas",165,410,.402,62,179,.346,103,231,.446,81,100,.810,42,157,199,46,23,64,4,119,473,2011/2012
"Knight,Brandon",319,769,.415,105,276,.380,214,493,.434,104,137,.759,33,178,211,251,49,171,10,154,847,2011/2012
"Korver,Kyle",178,412,.432,118,271,.435,60,141,.426,55,66,.833,26,133,159,112,36,53,15,110,529,2011/2012
"Koufos,Kosta",115,192,.599,0,0,,115,192,.599,33,55,.600,95,163,258,15,24,33,41,96,263,2011/2012
"Landry,Carl",182,362,.503,0,3,.000,182,359,.507,147,184,.799,78,136,214,38,13,64,12,89,511,2011/2012
"Lawson,Ty",374,767,.488,73,200,.365,301,567,.531,178,216,.824,54,173,227,401,82,149,6,94,999,2011/2012
"Lee,Courtney",251,580,.433,87,217,.401,164,363,.452,71,86,.826,26,133,159,88,68,64,22,106,660,2011/2012
"Lee,David",464,922,.503,0,5,.000,464,917,.506,219,280,.782,171,374,545,162,54,149,22,179,1147,2011/2012
"Lee,Malcolm",23,59,.390,2,10,.200,21,49,.429,14,17,.824,9,17,26,31,8,17,4,22,62,2011/2012
"Leonard,Kawhi",199,404,.493,41,109,.376,158,295,.536,68,88,.773,104,223,327,70,85,44,24,88,507,2011/2012
"Leslie,Travis",5,14,.357,0,0,,5,14,.357,4,9,.444,6,3,9,5,2,2,2,4,14,2011/2012
"Leuer,Jon",97,191,.508,3,9,.333,94,182,.516,21,28,.750,45,75,120,25,14,18,17,67,218,2011/2012
"Lewis,Rashard",85,221,.385,16,67,.239,69,154,.448,31,37,.838,34,75,109,27,23,32,10,49,217,2011/2012
"Liggins,DeAndre",12,25,.480,0,4,.000,12,21,.571,9,19,.474,6,9,15,5,6,10,0,6,33,2011/2012
"Lin,Jeremy",171,383,.446,24,75,.320,147,308,.477,146,183,.798,18,89,107,216,55,126,9,78,512,2011/2012
"Livingston,Shaun",127,271,.469,2,3,.667,125,268,.466,62,79,.785,39,84,123,122,27,66,20,79,318,2011/2012
"Lopez,Brook",38,77,.494,0,0,,38,77,.494,20,32,.625,8,10,18,6,1,6,4,8,96,2011/2012
"Lopez,Robin",124,269,.461,0,0,,124,269,.461,100,140,.714,90,119,209,20,18,43,60,128,348,2011/2012
"Love,Kevin",474,1059,.448,105,282,.372,369,777,.475,379,460,.824,226,508,734,111,47,128,28,152,1432,2011/2012
"Lowry,Kyle",210,513,.409,79,211,.374,131,302,.434,171,198,.864,37,176,213,310,73,130,14,133,670,2011/2012
"Lucas III,John",143,358,.399,55,140,.393,88,218,.404,28,32,.875,22,54,76,108,19,42,1,42,369,2011/2012
"Mack,Shelvin",88,220,.400,12,42,.286,76,178,.427,42,59,.712,12,80,92,131,28,48,2,50,230,2011/2012
"Macklin,Vernon",19,35,.543,0,0,,19,35,.543,8,14,.571,14,20,34,5,4,3,4,9,46,2011/2012
"Maggette,Corey",139,373,.373,24,66,.364,115,307,.375,178,208,.856,21,104,125,39,23,59,1,83,480,2011/2012
"Magloire,Jamaal",17,45,.378,0,0,,17,45,.378,7,27,.259,25,88,113,6,4,22,10,66,41,2011/2012
"Mahinmi,Ian",130,238,.546,0,1,.000,130,237,.549,94,147,.639,108,181,289,12,38,50,31,176,354,2011/2012
"Marion,Shawn",288,646,.446,20,68,.294,268,578,.464,74,93,.796,145,320,465,132,67,98,36,87,670,2011/2012
"Martin,Cartier",59,134,.440,29,75,.387,30,59,.508,11,19,.579,12,46,58,10,11,13,2,35,158,2011/2012
"Martin,Kenyon",97,220,.441,3,13,.231,94,207,.454,20,54,.370,49,132,181,18,44,32,43,103,217,2011/2012
"Martin,Kevin",222,537,.413,78,225,.347,144,312,.462,160,179,.894,13,93,106,110,28,70,3,70,682,2011/2012
"Mason,Roger",103,258,.399,59,154,.383,44,104,.423,21,27,.778,7,62,69,47,13,32,5,33,286,2011/2012
"Matthews,Wesley",314,763,.412,129,337,.383,185,426,.434,147,171,.860,56,168,224,113,96,73,15,148,904,2011/2012
"Maxiell,Jason",183,383,.478,0,2,.000,183,381,.480,58,106,.547,126,207,333,41,32,71,50,151,424,2011/2012
"Maynor,Eric",14,39,.359,6,17,.353,8,22,.364,4,4,1.000,3,10,13,22,5,11,0,13,38,2011/2012
"Mayo,O.J.",300,736,.408,100,275,.364,200,461,.434,133,172,.773,30,180,210,169,71,124,23,137,833,2011/2012
"Mbah a Moute,Luc",133,261,.510,1,4,.250,132,257,.514,66,103,.641,77,150,227,29,40,39,22,93,333,2011/2012
"McGee,JaVale",307,552,.556,0,0,,307,552,.556,77,167,.461,163,314,477,31,35,87,132,166,691,2011/2012
"McGee,JaVale",214,400,.535,0,0,,214,400,.535,58,116,.500,127,235,362,25,25,68,101,118,486,2011/2012
"McGee,JaVale",93,152,.612,0,0,,93,152,.612,19,51,.373,36,79,115,6,10,19,31,48,205,2011/2012
"McGrady,Tracy",101,231,.437,15,33,.455,86,198,.434,56,83,.675,23,131,154,110,16,53,15,35,273,2011/2012
"McGuire,Dominic",94,210,.448,0,4,.000,94,206,.456,39,53,.736,73,173,246,110,44,56,36,104,227,2011/2012
"McRoberts,Josh",56,118,.475,3,7,.429,53,111,.477,23,36,.639,61,110,171,51,15,31,18,74,138,2011/2012
"Meeks,Jodie",191,467,.409,97,266,.365,94,201,.468,77,85,.906,17,144,161,54,40,29,3,82,556,2011/2012
"Miles,C.J.",177,465,.381,46,150,.307,131,315,.416,108,136,.794,27,89,116,69,46,53,18,122,508,2011/2012
"Miličić,Darko",59,130,.454,0,0,,59,130,.454,16,37,.432,35,62,97,17,9,32,25,59,134,2011/2012
"Miller,Andre",242,552,.438,18,83,.217,224,469,.478,137,169,.811,53,168,221,441,63,177,9,133,639,2011/2012
"Miller,Brad",9,27,.333,7,15,.467,2,12,.167,10,12,.833,4,15,19,24,4,12,2,10,35,2011/2012
"Miller,Mike",91,209,.435,53,117,.453,38,92,.413,2,5,.400,22,106,128,42,14,30,6,58,237,2011/2012
"Mills,Patty",63,130,.485,24,56,.429,39,74,.527,15,15,1.000,4,24,28,39,10,26,1,14,165,2011/2012
"Millsap,Paul",426,861,.495,7,31,.226,419,830,.505,202,255,.792,180,383,563,150,118,112,52,222,1061,2011/2012
"Mohammed,Nazr",79,169,.467,0,1,.000,79,168,.470,13,23,.565,59,111,170,14,20,26,37,101,171,2011/2012
"Monroe,Greg",407,781,.521,0,1,.000,407,780,.522,201,272,.739,239,398,637,152,83,161,46,180,1015,2011/2012
"Moon,Jamario",7,24,.292,2,10,.200,5,14,.357,2,2,1.000,2,20,22,5,1,8,5,5,18,2011/2012
"Moore,E'Twaun",43,113,.381,17,45,.378,26,68,.382,7,7,1.000,4,29,33,34,11,21,3,33,110,2011/2012
"Moore,Mikki",9,20,.450,0,0,,9,20,.450,6,7,.857,7,15,22,5,3,7,3,24,24,2011/2012
"Morris,Darius",18,42,.429,4,9,.444,14,33,.424,6,9,.667,2,14,16,21,2,19,0,16,46,2011/2012
"Morris,Marcus",16,54,.296,2,17,.118,14,37,.378,6,8,.750,5,11,16,3,2,4,2,12,40,2011/2012
"Morris,Markieff",174,436,.399,43,124,.347,131,312,.420,76,106,.717,69,210,279,65,41,70,42,179,467,2011/2012
"Morrow,Anthony",272,658,.413,106,286,.371,166,372,.446,97,104,.933,31,96,127,61,46,70,9,86,747,2011/2012
"Mozgov,Timofey",100,190,.526,0,0,,100,190,.526,39,57,.684,53,126,179,22,15,53,42,86,239,2011/2012
"Mullens,Byron",251,591,.425,12,51,.235,239,540,.443,92,112,.821,96,231,327,57,21,74,52,137,606,2011/2012
"Murphy,Troy",77,171,.450,28,67,.418,49,104,.471,6,9,.667,40,151,191,51,15,26,16,98,188,2011/2012
"N'Diaye,Hamady",0,1,.000,0,0,,0,1,.000,0,0,,0,0,0,0,0,0,0,0,0,2011/2012
"Nájera,Eduardo",24,64,.375,8,29,.276,16,35,.457,2,4,.500,11,39,50,12,19,7,4,40,58,2011/2012
"Nash,Steve",295,555,.532,55,141,.390,240,414,.580,127,142,.894,26,160,186,664,38,229,8,53,772,2011/2012
"Neal,Gary",212,486,.436,83,198,.419,129,288,.448,50,64,.781,12,106,118,117,27,60,2,75,557,2011/2012
"Nelson,Jameer",259,606,.427,87,231,.377,172,375,.459,71,88,.807,29,152,181,325,38,135,5,130,676,2011/2012
"Noah,Joakim",249,490,.508,0,1,.000,249,489,.509,154,206,.748,242,387,629,160,41,92,92,162,652,2011/2012
"Nocioni,Andrés",5,20,.250,1,6,.167,4,14,.286,6,11,.545,1,13,14,1,1,5,1,4,17,2011/2012
"Novak,Steve",161,337,.478,133,282,.472,28,55,.509,22,26,.846,9,95,104,12,16,21,9,59,477,2011/2012
"Nowitzki,Dirk",473,1034,.457,78,212,.368,395,822,.481,318,355,.896,46,372,418,136,42,117,30,129,1342,2011/2012
"O'Neal,Jermaine",52,120,.433,0,0,,52,120,.433,21,31,.677,37,98,135,10,8,21,43,80,125,2011/2012
"Odom,Lamar",123,349,.352,28,111,.252,95,238,.399,58,98,.592,36,172,208,83,20,52,18,97,332,2011/2012
"Okafor,Emeka",114,214,.533,0,0,,114,214,.533,38,74,.514,70,143,213,24,16,37,26,73,266,2011/2012
"Okur,Mehmet",52,139,.374,23,72,.319,29,67,.433,3,5,.600,22,59,81,30,9,25,5,45,130,2011/2012
"Orton,Daniel",17,30,.567,0,1,.000,17,29,.586,11,25,.440,19,20,39,5,8,7,9,30,45,2011/2012
"Outlaw,Travis",60,175,.343,16,60,.267,44,115,.383,31,46,.674,19,42,61,16,19,20,21,34,167,2011/2012
"Owens,Larry",4,11,.364,2,5,.400,2,6,.333,3,4,.750,2,11,13,4,0,2,1,10,13,2011/2012
"Pachulia,Zaza",169,339,.499,0,0,,169,339,.499,117,158,.741,154,303,457,79,55,81,29,172,455,2011/2012
"Pargo,Jannero",105,253,.415,53,138,.384,52,115,.452,19,20,.950,9,64,73,96,20,49,2,64,282,2011/2012
"Pargo,Jeremy",50,150,.333,10,38,.263,40,112,.357,16,27,.593,12,25,37,55,15,46,0,46,126,2011/2012
"Parker,Anthony",141,326,.433,50,138,.362,91,188,.484,35,56,.625,10,128,138,120,38,50,7,65,367,2011/2012
"Parker,Tony",427,890,.480,14,61,.230,413,829,.498,227,284,.799,22,149,171,463,57,153,5,75,1095,2011/2012
"Parsons,Chandler",248,549,.452,60,178,.337,188,371,.507,43,78,.551,90,210,300,134,73,81,29,142,599,2011/2012
"Patterson,Patrick",225,511,.440,0,3,.000,225,508,.443,40,57,.702,112,174,286,53,27,49,36,113,490,2011/2012
"Paul,Chris",425,890,.478,79,213,.371,346,677,.511,260,302,.861,42,171,213,543,152,124,4,138,1189,2011/2012
"Pavlović,Sasha",50,128,.391,17,58,.293,33,70,.471,3,8,.375,4,68,72,18,20,20,15,54,120,2011/2012
"Peković,Nikola",256,454,.564,0,0,,256,454,.564,139,187,.743,181,165,346,31,29,87,31,98,651,2011/2012
"Perkins,Kendrick",128,262,.489,0,0,,128,262,.489,73,112,.652,120,306,426,78,25,118,73,189,329,2011/2012
"Petro,Johan",109,260,.419,1,1,1.000,108,259,.417,31,37,.838,68,156,224,45,21,38,23,122,250,2011/2012
"Pierce,Paul",394,890,.443,100,273,.366,294,617,.476,293,344,.852,37,280,317,274,70,173,26,147,1181,2011/2012
"Piétrus,Mickaël",104,270,.385,61,182,.335,43,88,.489,20,31,.645,18,112,130,25,21,33,10,81,289,2011/2012
"Pittman,Dexter",44,94,.468,0,0,,44,94,.468,18,28,.643,27,44,71,9,8,17,8,73,106,2011/2012
"Pondexter,Quincy",108,239,.452,22,73,.301,86,166,.518,33,53,.623,55,71,126,27,27,30,5,90,271,2011/2012
"Price,A.J.",59,174,.339,26,88,.295,33,86,.384,28,35,.800,13,48,61,86,20,32,2,30,172,2011/2012
"Price,Ronnie",49,130,.377,13,44,.295,36,86,.419,20,25,.800,18,38,56,67,34,46,3,72,131,2011/2012
"Prince,Tayshaun",336,798,.421,37,104,.356,299,694,.431,89,115,.774,72,209,281,153,27,74,32,77,798,2011/2012
"Przybilla,Joel",22,48,.458,0,0,,22,48,.458,11,18,.611,29,109,138,6,4,22,16,66,55,2011/2012
"Radmanović,Vladimir",74,197,.376,50,135,.370,24,62,.387,22,29,.759,34,109,143,54,21,35,15,62,220,2011/2012
"Randolph,Anthony",94,200,.470,0,1,.000,94,199,.472,64,84,.762,42,81,123,19,13,40,35,56,252,2011/2012
"Randolph,Zach",132,285,.463,2,8,.250,130,277,.469,58,88,.659,78,147,225,48,21,40,4,57,324,2011/2012
"Redd,Michael",144,360,.400,42,132,.318,102,228,.447,88,111,.793,14,63,77,33,13,37,0,29,418,2011/2012
"Redick,J.J.",248,584,.425,112,268,.418,136,316,.430,143,157,.911,18,132,150,164,27,68,6,92,751,2011/2012
"Reid,Ryan",4,5,.800,0,0,,4,5,.800,0,0,,1,1,2,0,0,1,0,1,8,2011/2012
"Richardson,Jason",243,596,.408,102,277,.368,141,319,.442,41,69,.594,36,158,194,107,53,60,22,91,629,2011/2012
"Richardson,Quentin",74,197,.376,42,121,.347,32,76,.421,25,30,.833,15,108,123,38,28,29,6,74,215,2011/2012
"Ridnour,Luke",242,550,.440,49,152,.322,193,398,.485,106,119,.891,19,122,141,252,56,96,16,136,639,2011/2012
"Robinson,Nate",205,484,.424,66,181,.365,139,303,.459,94,113,.832,15,85,100,231,59,75,2,118,570,2011/2012
"Rondo,Rajon",256,572,.448,10,42,.238,246,530,.464,108,181,.597,62,195,257,620,95,193,3,99,630,2011/2012
"Rose,Derrick",302,695,.435,54,173,.312,248,522,.475,194,239,.812,26,105,131,307,35,119,28,52,852,2011/2012
"Rubio,Ricky",139,389,.357,32,94,.340,107,295,.363,126,157,.803,21,150,171,336,91,131,8,97,436,2011/2012
"Rush,Brandon",235,469,.501,99,219,.452,136,250,.544,65,82,.793,33,218,251,88,35,68,58,64,634,2011/2012
"Russell,Walker",33,95,.347,4,13,.308,29,82,.354,14,22,.636,7,19,26,58,18,33,1,29,84,2011/2012
"Salmons,John",141,345,.409,33,112,.295,108,233,.464,29,45,.644,20,114,134,93,37,45,7,77,344,2011/2012
"Samuels,Samardo",105,231,.455,0,0,,105,231,.455,82,117,.701,63,117,180,20,20,56,20,113,292,2011/2012
"Sanders,Larry",84,184,.457,0,2,.000,84,182,.462,18,38,.474,62,98,160,33,32,43,76,133,186,2011/2012
"Scalabrine,Brian",14,30,.467,1,7,.143,13,23,.565,3,6,.500,8,13,21,15,5,9,6,9,32,2011/2012
"Scola,Luis",436,888,.491,0,3,.000,436,885,.493,153,198,.773,122,306,428,140,35,153,24,214,1025,2011/2012
"Sefolosha,Thabo",67,155,.432,31,71,.437,36,84,.429,38,43,.884,21,107,128,47,37,40,17,78,203,2011/2012
"Selby,Josh",25,72,.347,2,15,.133,23,57,.404,11,14,.786,2,13,15,30,7,29,0,17,63,2011/2012
"Séraphin,Kevin",203,382,.531,0,1,.000,203,381,.533,47,70,.671,103,177,280,33,19,66,76,133,453,2011/2012
"Sessions,Ramon",242,565,.428,43,97,.443,199,468,.425,194,248,.782,33,181,214,354,44,141,3,100,721,2011/2012
"Sessions,Ramon",141,354,.398,26,62,.419,115,292,.394,122,147,.830,19,108,127,212,27,82,1,63,430,2011/2012
"Sessions,Ramon",101,211,.479,17,35,.486,84,176,.477,72,101,.713,14,73,87,142,17,59,2,37,291,2011/2012
"Shumpert,Iman",214,534,.401,48,157,.306,166,377,.440,87,109,.798,42,144,186,164,101,111,8,173,563,2011/2012
"Silas,Xavier",4,15,.267,1,6,.167,3,9,.333,2,3,.667,2,2,4,3,0,3,0,5,11,2011/2012
"Simmons,Bobby",28,90,.311,20,60,.333,8,30,.267,4,7,.571,17,38,55,11,15,10,3,41,80,2011/2012
"Singleton,Chris",116,312,.372,44,127,.346,72,185,.389,30,44,.682,43,190,233,49,70,38,30,176,306,2011/2012
"Singleton,James",41,75,.547,2,9,.222,39,66,.591,14,15,.933,25,56,81,15,9,10,8,27,98,2011/2012
"Skinner,Brian",0,1,.000,0,0,,0,1,.000,0,0,,0,0,0,0,0,0,0,1,0,2011/2012
"Sloan,Donald",79,198,.399,2,25,.080,77,173,.445,23,30,.767,18,49,67,105,13,49,3,37,183,2011/2012
"Sloan,Donald",3,8,.375,0,1,.000,3,7,.429,0,0,,1,4,5,5,1,2,0,3,6,2011/2012
"Sloan,Donald",5,14,.357,0,2,.000,5,12,.417,2,4,.500,2,1,3,8,2,5,0,2,12,2011/2012
"Sloan,Donald",71,176,.403,2,22,.091,69,154,.448,21,26,.808,15,44,59,92,10,42,3,32,165,2011/2012
"Smith,Craig",59,117,.504,0,1,.000,59,116,.509,38,53,.717,33,77,110,19,16,24,5,55,156,2011/2012
"Smith,Greg",7,11,.636,0,0,,7,11,.636,0,0,,5,15,20,1,2,1,5,17,14,2011/2012
"Smith,Ish",31,81,.383,3,9,.333,28,72,.389,7,10,.700,7,28,35,41,15,13,2,15,72,2011/2012
"Smith,Ish",12,30,.400,2,5,.400,10,25,.400,1,2,.500,2,7,9,9,4,1,0,4,27,2011/2012
"Smith,Ish",19,51,.373,1,4,.250,18,47,.383,6,8,.750,5,21,26,32,11,12,2,11,45,2011/2012
"Smith,J.R.",165,405,.407,67,193,.347,98,212,.462,39,55,.709,29,107,136,84,54,46,6,87,436,2011/2012
"Smith,Jason",181,348,.520,1,9,.111,180,339,.531,33,47,.702,72,124,196,34,21,40,41,102,396,2011/2012
"Smith,Jerry",3,14,.214,1,6,.167,2,8,.250,0,0,,2,5,7,4,5,0,0,5,7,2011/2012
"Smith,Josh",504,1101,.458,28,109,.257,476,992,.480,203,322,.630,136,496,632,257,93,164,115,172,1239,2011/2012
"Smith,Nolan",67,180,.372,13,45,.289,54,135,.400,20,28,.714,17,39,56,62,18,42,3,55,167,2011/2012
"Speights,Marreese",221,488,.453,0,3,.000,221,485,.456,84,109,.771,133,241,374,48,21,74,29,147,526,2011/2012
"Splitter,Tiago",212,343,.618,0,0,,212,343,.618,125,181,.691,93,213,306,65,21,87,47,134,549,2011/2012
"Stackhouse,Jerry",37,100,.370,13,38,.342,24,62,.387,21,23,.913,6,17,23,14,10,13,3,12,108,2011/2012
"Stephenson,Lance",47,125,.376,4,30,.133,43,95,.453,8,17,.471,12,41,53,46,21,36,5,30,106,2011/2012
"Stevenson,DeShawn",49,172,.285,41,145,.283,8,27,.296,9,16,.563,7,94,101,41,19,19,4,59,148,2011/2012
"Stiemsma,Greg",66,121,.545,0,0,,66,121,.545,29,41,.707,48,129,177,28,37,33,85,144,161,2011/2012
"Stone,Julyan",13,31,.419,2,11,.182,11,20,.550,8,11,.727,5,20,25,37,8,11,6,18,36,2011/2012
"Stoudemire,Amar'e",316,654,.483,5,21,.238,311,633,.491,186,243,.765,106,261,367,52,38,112,45,138,823,2011/2012
"Stuckey,Rodney",256,597,.429,33,104,.317,223,493,.452,267,320,.834,38,104,142,210,44,106,10,124,812,2011/2012
"Summers,DaJuan",28,65,.431,5,16,.313,23,49,.469,7,9,.778,8,15,23,10,7,8,0,31,68,2011/2012
"Teague,Jeff",320,672,.476,51,149,.342,269,523,.514,140,185,.757,21,138,159,321,106,134,37,145,831,2011/2012
"Telfair,Sebastian",141,342,.412,33,105,.314,108,237,.456,53,67,.791,20,71,91,138,41,68,12,120,368,2011/2012
"Terry,Jason",357,830,.430,138,365,.378,219,465,.471,98,111,.883,16,133,149,226,73,127,11,69,950,2011/2012
"Thabeet,Hasheem",11,21,.524,0,0,,11,21,.524,13,20,.650,16,26,42,0,1,8,10,20,35,2011/2012
"Thabeet,Hasheem",3,3,1.000,0,0,,3,3,1.000,0,0,,1,6,7,0,0,0,2,5,6,2011/2012
"Thabeet,Hasheem",8,18,.444,0,0,,8,18,.444,13,20,.650,15,20,35,0,1,8,8,15,29,2011/2012
"Thomas,Isaiah",256,571,.448,83,219,.379,173,352,.491,154,185,.832,48,120,168,266,53,105,8,121,749,2011/2012
"Thomas,Kurt",73,157,.465,0,0,,73,157,.465,14,20,.700,39,149,188,46,24,31,31,123,160,2011/2012
"Thomas,Lance",57,126,.452,0,1,.000,57,125,.456,52,62,.839,49,77,126,12,10,24,7,78,166,2011/2012
"Thomas,Malcolm",0,3,.000,0,0,,0,3,.000,1,2,.500,1,2,3,1,1,0,1,0,1,2011/2012
"Thomas,Tyrus",120,327,.367,1,3,.333,119,324,.367,63,83,.759,49,151,200,35,36,53,60,144,304,2011/2012
"Thompkins,Trey",24,61,.393,4,13,.308,20,48,.417,5,7,.714,4,20,24,3,3,6,3,10,57,2011/2012
"Thompson,Jason",237,443,.535,0,2,.000,237,441,.537,109,181,.602,166,277,443,79,43,68,44,149,583,2011/2012
"Thompson,Klay",318,718,.443,111,268,.414,207,450,.460,79,91,.868,24,137,161,133,49,103,20,155,826,2011/2012
"Thompson,Mychel",7,24,.292,4,11,.364,3,13,.231,0,0,,0,5,5,7,2,5,1,8,18,2011/2012
"Thompson,Tristan",194,442,.439,0,2,.000,194,440,.441,106,192,.552,187,202,389,27,27,81,62,134,494,2011/2012
"Thornton,Marcus",352,803,.438,107,310,.345,245,493,.497,141,163,.865,84,104,188,98,71,84,12,111,952,2011/2012
"Tinsley,Jamaal",57,141,.404,10,37,.270,47,104,.452,13,17,.765,6,39,45,123,17,52,8,47,137,2011/2012
"Tolliver,Anthony",71,182,.390,25,101,.248,46,81,.568,41,55,.745,50,103,153,22,18,35,19,86,208,2011/2012
"Turiaf,Ronny",19,33,.576,0,1,.000,19,32,.594,13,22,.591,20,50,70,10,14,14,17,39,51,2011/2012
"Turiaf,Ronny",3,3,1.000,0,0,,3,3,1.000,0,0,,1,11,12,5,6,6,3,7,6,2011/2012
"Turiaf,Ronny",16,30,.533,0,1,.000,16,29,.552,13,22,.591,19,39,58,5,8,8,14,32,45,2011/2012
"Türkoğlu,Hedo",209,504,.415,91,258,.353,118,246,.480,67,95,.705,24,175,199,233,45,142,17,139,576,2011/2012
"Turner,Evan",263,590,.446,11,49,.224,252,541,.466,73,108,.676,27,349,376,180,40,105,20,117,610,2011/2012
"Tyler,Jeremy",88,209,.421,0,1,.000,88,208,.423,29,52,.558,54,86,140,16,16,36,20,84,205,2011/2012
"Ubiles,Edwin",5,18,.278,1,5,.200,4,13,.308,3,3,1.000,2,8,10,1,1,1,1,1,14,2011/2012
"Udoh,Ekpe",127,295,.431,0,2,.000,127,293,.433,86,114,.754,100,154,254,57,40,53,102,174,340,2011/2012
"Udoh,Ekpe",82,185,.443,0,0,,82,185,.443,46,64,.719,58,89,147,31,25,35,65,115,210,2011/2012
"Udoh,Ekpe",45,110,.409,0,2,.000,45,108,.417,40,50,.800,42,65,107,26,15,18,37,59,130,2011/2012
"Udrih,Beno",146,332,.440,17,59,.288,129,273,.473,39,55,.709,26,76,102,227,37,77,1,69,348,2011/2012
"Uzoh,Ben",35,99,.354,0,1,.000,35,98,.357,11,19,.579,19,48,67,61,17,19,3,31,81,2011/2012
"Uzoh,Ben",2,5,.400,0,0,,2,5,.400,0,0,,2,2,4,2,1,0,0,1,4,2011/2012
"Uzoh,Ben",33,94,.351,0,1,.000,33,93,.355,11,19,.579,17,46,63,59,16,19,3,30,77,2011/2012
"Varejão,Anderson",114,222,.514,0,4,.000,114,218,.523,43,64,.672,109,178,287,43,35,45,17,62,271,2011/2012
"Vásquez,Greivis",225,523,.430,43,135,.319,182,388,.469,96,117,.821,23,150,173,359,60,148,8,126,589,2011/2012
"Veselý,Jan",117,218,.537,0,1,.000,117,217,.539,33,62,.532,101,148,249,47,39,60,32,156,267,2011/2012
"Villanueva,Charlie",35,91,.385,15,45,.333,20,46,.435,6,7,.857,9,39,48,6,7,7,5,25,91,2011/2012
"Vučević,Nikola",131,291,.450,3,8,.375,128,283,.452,18,34,.529,88,158,246,31,20,33,34,111,283,2011/2012
"Wade,Dwyane",416,837,.497,15,56,.268,401,781,.513,235,297,.791,73,164,237,225,82,129,63,110,1082,2011/2012
"Wafer,Von",71,157,.452,14,39,.359,57,118,.483,38,54,.704,6,39,45,29,10,35,3,26,194,2011/2012
"Walker,Henry",68,171,.398,36,113,.319,32,58,.552,17,20,.850,9,71,80,37,19,35,7,84,189,2011/2012
"Walker,Kemba",281,767,.366,69,226,.305,212,541,.392,168,213,.789,30,204,234,289,60,119,20,79,799,2011/2012
"Wall,John",378,894,.423,3,42,.071,375,852,.440,317,402,.789,48,252,300,530,95,255,57,137,1076,2011/2012
"Wallace,Ben",34,86,.395,1,4,.250,33,82,.402,16,47,.340,81,188,269,43,47,34,51,60,85,2011/2012
"Wallace,Gerald",287,632,.454,46,150,.307,241,482,.500,180,225,.800,87,299,386,164,85,111,36,145,800,2011/2012
"Wallace,Gerald",203,430,.472,26,98,.265,177,332,.533,125,161,.776,63,214,277,115,62,84,25,107,557,2011/2012
"Wallace,Gerald",84,202,.416,20,52,.385,64,150,.427,55,64,.859,24,85,109,49,23,27,11,38,243,2011/2012
"Walton,Luke",24,65,.369,7,20,.350,17,45,.378,0,0,,13,36,49,35,5,27,1,41,55,2011/2012
"Walton,Luke",6,14,.429,0,4,.000,6,10,.600,0,0,,6,8,14,5,2,2,0,9,12,2011/2012
"Walton,Luke",18,51,.353,7,16,.438,11,35,.314,0,0,,7,28,35,30,3,25,1,32,43,2011/2012
"Warrick,Hakim",74,180,.411,1,10,.100,73,170,.429,76,99,.768,31,61,92,30,8,36,3,35,225,2011/2012
"Watkins,Darryl",7,14,.500,0,0,,7,14,.500,9,18,.500,8,19,27,3,5,8,4,14,23,2011/2012
"Watson,C.J.",161,437,.368,68,173,.393,93,264,.352,84,104,.808,21,84,105,200,45,97,8,103,474,2011/2012
"Watson,Earl",54,160,.338,10,52,.192,44,108,.407,31,46,.674,30,91,121,217,54,85,22,105,149,2011/2012
"Webster,Martell",115,272,.423,37,109,.339,78,163,.479,57,72,.792,42,126,168,40,31,46,17,86,324,2011/2012
"West,David",349,716,.487,2,9,.222,347,707,.491,142,176,.807,118,315,433,140,52,93,46,160,842,2011/2012
"West,Delonte",166,360,.461,27,76,.355,139,284,.489,62,70,.886,13,88,101,139,58,76,11,67,421,2011/2012
"Westbrook,Russell",578,1266,.457,62,196,.316,516,1070,.482,340,413,.823,96,205,301,362,112,239,21,147,1558,2011/2012
"White,D.J.",174,353,.493,1,1,1.000,173,352,.491,43,61,.705,50,159,209,47,17,43,23,94,392,2011/2012
"Whiteside,Hassan",12,27,.444,0,0,,12,27,.444,5,12,.417,16,23,39,0,3,5,15,12,29,2011/2012
"Wilcox,Chris",64,107,.598,0,0,,64,107,.598,24,39,.615,38,84,122,12,11,30,9,64,152,2011/2012
"Wilkins,Damien",76,193,.394,7,23,.304,69,170,.406,34,54,.630,22,78,100,44,29,30,13,85,193,2011/2012
"Williams,Deron",391,961,.407,115,342,.336,276,619,.446,257,305,.843,23,160,183,481,67,219,20,121,1154,2011/2012
"Williams,Derrick",205,498,.412,37,138,.268,168,360,.467,136,195,.697,77,234,311,38,30,77,31,95,583,2011/2012
"Williams,Elliot",37,74,.500,8,27,.296,29,47,.617,6,18,.333,7,12,19,6,6,5,3,18,88,2011/2012
"Williams,Jordan",77,152,.507,0,0,,77,152,.507,43,66,.652,66,90,156,11,21,23,15,61,197,2011/2012
"Williams,Lou",318,782,.407,83,229,.362,235,553,.425,237,292,.812,30,125,155,221,53,71,18,90,956,2011/2012
"Williams,Marvin",203,470,.432,58,149,.389,145,321,.452,115,146,.788,76,218,294,71,47,39,18,84,579,2011/2012
"Williams,Mo",260,611,.426,93,239,.389,167,372,.449,72,80,.900,23,76,99,160,51,86,7,103,685,2011/2012
"Williams,Reggie",106,255,.416,33,107,.308,73,148,.493,29,40,.725,27,66,93,60,20,33,3,34,274,2011/2012
"Williams,Sean",14,22,.636,0,0,,14,22,.636,12,13,.923,13,12,25,5,4,10,8,18,40,2011/2012
"Williams,Sean",12,16,.750,0,0,,12,16,.750,5,6,.833,9,4,13,2,1,7,5,14,29,2011/2012
"Williams,Sean",2,6,.333,0,0,,2,6,.333,7,7,1.000,4,8,12,3,3,3,3,4,11,2011/2012
"Williams,Shawne",42,147,.286,21,87,.241,21,60,.350,8,11,.727,20,48,68,16,10,13,11,44,113,2011/2012
"Williams,Shelden",96,201,.478,0,0,,96,201,.478,76,104,.731,141,209,350,35,47,66,39,149,268,2011/2012
"Williams,Terrence",85,198,.429,16,46,.348,69,152,.454,27,46,.587,13,89,102,65,20,43,7,35,213,2011/2012
"Williams,Terrence",20,57,.351,8,19,.421,12,38,.316,6,12,.500,2,26,28,10,4,10,1,16,54,2011/2012
"Williams,Terrence",65,141,.461,8,27,.296,57,114,.500,21,34,.618,11,63,74,55,16,33,6,19,159,2011/2012
"World Peace,Metta",183,465,.394,56,189,.296,127,276,.460,71,115,.617,71,147,218,140,69,69,27,137,493,2011/2012
"Wright,Brandan",144,233,.618,0,1,.000,144,232,.621,52,82,.634,62,112,174,13,22,21,63,61,340,2011/2012
"Wright,Chris",23,45,.511,0,0,,23,45,.511,24,31,.774,19,26,45,4,7,8,13,22,70,2011/2012
"Wright,Dorell",222,526,.422,105,292,.360,117,234,.500,80,98,.816,60,218,278,94,58,51,26,97,629,2011/2012
"Young,Nick",316,784,.403,103,282,.365,213,502,.424,144,169,.852,31,102,133,56,44,83,17,141,879,2011/2012
"Young,Nick",240,591,.406,73,197,.371,167,394,.424,112,130,.862,20,77,97,46,30,59,11,90,665,2011/2012
"Young,Nick",76,193,.394,30,85,.353,46,108,.426,32,39,.821,11,25,36,10,14,24,6,51,214,2011/2012
"Young,Sam",45,127,.354,5,17,.294,40,110,.364,19,26,.731,20,42,62,15,17,16,6,23,114,2011/2012
"Young,Sam",32,83,.386,0,9,.000,32,74,.432,10,12,.833,14,27,41,9,11,9,2,12,74,2011/2012
"Young,Sam",13,44,.295,5,8,.625,8,36,.222,9,14,.643,6,15,21,6,6,7,4,11,40,2011/2012
"Young,Thaddeus",348,687,.507,1,4,.250,347,683,.508,111,144,.771,137,188,325,74,64,55,41,127,808,2011/2012
"Acy,Quincy",42,75,.560,1,2,.500,41,73,.562,31,38,.816,30,47,77,11,13,17,15,53,116,2012/2013
"Adrien,Jeff",72,168,.429,0,2,.000,72,166,.434,65,100,.650,68,128,196,36,18,32,27,80,209,2012/2013
"Afflalo,Arron",397,905,.439,72,240,.300,325,665,.489,191,223,.857,29,210,239,206,40,138,11,137,1057,2012/2013
"Akognon,Josh",2,4,.500,1,2,.500,1,2,.500,0,0,,0,1,1,1,0,0,0,3,5,2012/2013
"Aldrich,Cole",44,80,.550,0,0,,44,80,.550,12,20,.600,30,90,120,9,5,23,23,60,100,2012/2013
"Aldrich,Cole",23,43,.535,0,0,,23,43,.535,4,9,.444,12,45,57,6,3,14,9,41,50,2012/2013
"Aldrich,Cole",21,37,.568,0,0,,21,37,.568,8,11,.727,18,45,63,3,2,9,14,19,50,2012/2013
"Aldridge,LaMarcus",638,1318,.484,2,14,.143,636,1304,.488,282,348,.810,175,495,670,192,62,143,91,187,1560,2012/2013
"Allen,Lavoy",206,454,.454,0,1,.000,206,453,.455,43,60,.717,159,236,395,73,24,55,55,180,455,2012/2013
"Allen,Ray",292,651,.449,139,332,.419,153,319,.480,140,158,.886,40,177,217,135,67,103,15,129,863,2012/2013
"Allen,Tony",284,638,.445,3,24,.125,281,614,.458,134,187,.717,121,242,363,98,119,94,44,211,705,2012/2013
"Aminu,Al-Farouq",225,474,.475,4,19,.211,221,455,.486,101,137,.737,139,446,585,103,92,116,51,153,555,2012/2013
"Amundson,Lou",32,81,.395,0,0,,32,81,.395,12,36,.333,48,58,106,11,16,19,12,53,76,2012/2013
"Amundson,Lou",14,38,.368,0,0,,14,38,.368,4,20,.200,23,24,47,3,7,11,6,26,32,2012/2013
"Amundson,Lou",0,1,.000,0,0,,0,1,.000,0,0,,1,0,1,0,0,0,0,0,0,2012/2013
"Amundson,Lou",18,42,.429,0,0,,18,42,.429,8,16,.500,24,34,58,8,9,8,6,27,44,2012/2013
"Andersen,Chris",71,123,.577,2,3,.667,69,120,.575,63,93,.677,57,115,172,17,16,24,44,89,207,2012/2013
"Anderson,Alan",236,616,.383,95,285,.333,141,331,.426,126,147,.857,34,114,148,103,48,80,7,131,693,2012/2013
"Anderson,James",52,126,.413,21,60,.350,31,66,.470,24,28,.857,18,54,72,42,15,25,5,25,149,2012/2013
"Anderson,James",11,25,.440,5,11,.455,6,14,.429,7,9,.778,3,11,14,9,3,7,2,7,34,2012/2013
"Anderson,James",41,101,.406,16,49,.327,25,52,.481,17,19,.895,15,43,58,33,12,18,3,18,115,2012/2013
"Anderson,Ryan",472,1115,.423,213,557,.382,259,558,.464,152,180,.844,191,328,519,97,42,97,31,179,1309,2012/2013
"Anthony,Carmelo",669,1489,.449,157,414,.379,512,1075,.476,425,512,.830,134,326,460,171,52,175,32,205,1920,2012/2013
"Anthony,Joel",35,68,.515,0,0,,35,68,.515,17,28,.607,45,70,115,13,13,22,42,49,87,2012/2013
"Ariza,Trevor",188,451,.417,76,209,.364,112,242,.463,78,95,.821,44,222,266,113,72,84,20,72,530,2012/2013
"Arthur,Darrell",162,359,.451,5,18,.278,157,341,.460,33,46,.717,68,101,169,33,24,43,33,126,362,2012/2013
"Aşık,Ömer",332,614,.541,0,1,.000,332,613,.542,168,299,.562,275,681,956,75,46,173,87,223,832,2012/2013
"Augustin,D.J.",103,294,.350,67,190,.353,36,104,.346,83,99,.838,20,71,91,170,34,68,3,64,356,2012/2013
"Ayón,Gustavo",92,167,.551,0,0,,92,167,.551,20,50,.400,60,139,199,71,22,47,17,107,204,2012/2013
"Ayón,Gustavo",67,125,.536,0,0,,67,125,.536,19,38,.500,40,100,140,59,13,38,13,83,153,2012/2013
"Ayón,Gustavo",25,42,.595,0,0,,25,42,.595,1,12,.083,20,39,59,12,9,9,4,24,51,2012/2013
"Ayres,Jeff",61,126,.484,2,4,.500,59,122,.484,21,23,.913,29,75,104,15,6,23,12,44,145,2012/2013
"Babbitt,Luke",86,234,.368,62,178,.348,24,56,.429,10,13,.769,15,122,137,29,14,22,5,82,244,2012/2013
"Barbosa,Leandro",83,193,.430,18,47,.383,65,146,.445,31,41,.756,8,38,46,58,17,21,6,51,215,2012/2013
"Barea,J.J.",316,758,.417,97,280,.346,219,478,.458,105,134,.784,34,173,207,294,32,145,0,131,834,2012/2013
"Bargnani,Andrea",170,426,.399,38,123,.309,132,303,.436,65,77,.844,26,102,128,38,21,54,23,64,443,2012/2013
"Barnes,Harrison",276,628,.439,52,145,.359,224,483,.464,144,190,.758,53,280,333,98,52,101,14,140,748,2012/2013
"Barnes,Matt",312,675,.462,111,325,.342,201,350,.574,87,117,.744,111,255,366,123,82,90,63,233,822,2012/2013
"Barron,Earl",18,51,.353,0,0,,18,51,.353,3,7,.429,22,39,61,5,5,11,6,24,39,2012/2013
"Barron,Earl",13,37,.351,0,0,,13,37,.351,2,5,.400,16,27,43,3,5,10,5,23,28,2012/2013
"Barron,Earl",5,14,.357,0,0,,5,14,.357,1,2,.500,6,12,18,2,0,1,1,1,11,2012/2013
"Barton,Will",118,309,.382,9,65,.138,109,244,.447,50,65,.769,36,109,145,58,34,60,9,56,295,2012/2013
"Bass,Brandon",286,589,.486,0,2,.000,286,587,.487,129,150,.860,129,296,425,84,44,80,64,188,701,2012/2013
"Battier,Shane",152,362,.420,136,316,.430,16,46,.348,32,38,.842,37,128,165,72,41,34,55,149,472,2012/2013
"Batum,Nicolas",352,833,.423,165,444,.372,187,389,.481,178,210,.848,97,315,412,360,91,190,83,139,1047,2012/2013
"Bayless,Jerryd",260,621,.419,71,201,.353,189,420,.450,102,122,.836,22,154,176,264,59,120,17,168,693,2012/2013
"Baynes,Aron",18,36,.500,0,1,.000,18,35,.514,7,12,.583,12,20,32,5,1,11,6,23,43,2012/2013
"Bazemore,Kent",43,116,.371,10,34,.294,33,82,.402,27,44,.614,5,17,22,22,17,18,4,27,123,2012/2013
"Beal,Bradley",282,687,.410,91,236,.386,191,451,.424,125,159,.786,43,168,211,137,50,90,29,113,780,2012/2013
"Beasley,Michael",310,766,.405,45,144,.313,265,622,.426,94,126,.746,52,230,282,111,31,144,34,107,759,2012/2013
"Beaubois,Rodrigue",65,176,.369,21,72,.292,44,104,.423,30,38,.789,9,48,57,84,19,33,4,54,181,2012/2013
"Belinelli,Marco",241,610,.395,79,221,.357,162,389,.416,141,168,.839,13,127,140,148,44,82,6,140,702,2012/2013
"Beverley,Patrick",79,189,.418,36,96,.375,43,93,.462,34,41,.829,45,64,109,117,37,44,21,83,228,2012/2013
"Biedriņš,Andris",10,21,.476,0,0,,10,21,.476,4,13,.308,34,119,153,14,15,14,42,101,24,2012/2013
"Billups,Chauncey",53,132,.402,33,90,.367,20,42,.476,45,48,.938,2,30,32,49,12,26,1,25,184,2012/2013
"Biyombo,Bismack",156,346,.451,0,0,,156,346,.451,74,142,.521,194,388,582,35,28,82,143,195,386,2012/2013
"Blair,DeJuan",142,271,.524,0,1,.000,142,270,.526,44,70,.629,66,164,230,45,37,49,10,112,328,2012/2013
"Blake,Steve",114,270,.422,72,171,.421,42,99,.424,27,35,.771,21,111,132,173,34,62,6,83,327,2012/2013
"Blatche,Andray",346,676,.512,3,22,.136,343,654,.524,148,216,.685,161,256,417,85,86,123,54,163,843,2012/2013
"Bledsoe,Eric",253,568,.445,31,78,.397,222,490,.453,106,134,.791,78,147,225,233,109,137,55,112,643,2012/2013
"Bogans,Keith",108,284,.380,84,245,.343,24,39,.615,11,17,.647,16,104,120,76,28,49,4,108,311,2012/2013
"Bogut,Andrew",83,184,.451,1,1,1.000,82,183,.448,19,38,.500,68,177,245,67,20,35,55,85,186,2012/2013
"Bonner,Matt",112,230,.487,53,120,.442,59,110,.536,11,15,.733,25,104,129,36,17,16,19,86,288,2012/2013
"Booker,Trevor",108,220,.491,0,5,.000,108,215,.502,40,72,.556,98,141,239,40,32,31,16,95,256,2012/2013
"Boozer,Carlos",544,1140,.477,0,2,.000,544,1138,.478,193,264,.731,175,596,771,179,66,176,28,239,1281,2012/2013
"Bosh,Chris",485,907,.535,21,74,.284,464,833,.557,241,302,.798,131,370,501,123,66,128,101,168,1232,2012/2013
"Bradley,Avery",192,478,.402,40,126,.317,152,352,.432,37,49,.755,30,81,111,104,64,72,19,129,461,2012/2013
"Brand,Elton",226,478,.473,0,1,.000,226,477,.474,66,93,.710,130,300,430,70,50,57,90,192,518,2012/2013
"Brewer,Corey",375,883,.425,91,307,.296,284,576,.493,149,216,.690,55,180,235,124,118,102,23,154,990,2012/2013
"Brewer,Ronnie",70,198,.354,23,76,.303,47,122,.385,16,39,.410,42,98,140,50,43,18,6,33,179,2012/2013
"Brewer,Ronnie",64,175,.366,22,71,.310,42,104,.404,16,39,.410,29,71,100,40,34,14,6,27,166,2012/2013
"Brewer,Ronnie",6,23,.261,1,5,.200,5,18,.278,0,0,,13,27,40,10,9,4,0,6,13,2012/2013
"Brooks,Aaron",143,316,.453,50,134,.373,93,182,.511,40,52,.769,13,67,80,114,30,67,10,94,376,2012/2013
"Brooks,Aaron",139,303,.459,48,127,.378,91,176,.517,40,52,.769,12,66,78,108,29,63,7,89,366,2012/2013
"Brooks,Aaron",4,13,.308,2,7,.286,2,6,.333,0,0,,1,1,2,6,1,4,3,5,10,2012/2013
"Brooks,MarShon",155,335,.463,15,55,.273,140,280,.500,69,94,.734,32,72,104,76,34,69,16,93,394,2012/2013
"Brown,Kwame",17,37,.459,0,0,,17,37,.459,7,19,.368,23,51,74,9,6,8,10,37,41,2012/2013
"Brown,Shannon",240,571,.420,39,141,.277,201,430,.467,98,125,.784,44,105,149,108,59,74,15,92,617,2012/2013
"Bryant,Kobe",738,1595,.463,132,407,.324,606,1188,.510,525,626,.839,66,367,433,469,106,287,25,173,2133,2012/2013
"Budinger,Chase",79,191,.414,26,81,.321,53,110,.482,32,42,.762,15,56,71,25,14,23,7,29,216,2012/2013
"Burks,Alec",163,388,.420,33,92,.359,130,296,.439,92,129,.713,37,108,145,92,35,74,13,114,451,2012/2013
"Butler,Caron",305,720,.424,128,330,.388,177,390,.454,75,90,.833,41,182,223,78,51,72,11,139,813,2012/2013
"Butler,Jimmy",239,512,.467,40,105,.381,199,407,.489,187,233,.803,136,192,328,115,78,62,31,97,705,2012/2013
"Bynum,Will",253,540,.469,24,76,.316,229,464,.494,106,131,.809,28,69,97,231,45,125,5,128,636,2012/2013
"Calderón,José",312,635,.491,130,282,.461,182,353,.516,72,80,.900,20,156,176,518,58,126,8,99,826,2012/2013
"Calderón,José",187,398,.470,79,184,.429,108,214,.505,47,52,.904,14,92,106,333,28,75,6,58,500,2012/2013
"Calderón,José",125,237,.527,51,98,.520,74,139,.532,25,28,.893,6,64,70,185,30,51,2,41,326,2012/2013
"Camby,Marcus",17,53,.321,0,0,,17,53,.321,8,19,.421,24,56,80,14,7,15,14,28,42,2012/2013
"Carroll,DeMarre",149,324,.460,20,70,.286,129,254,.508,75,98,.765,87,101,188,61,58,34,24,119,393,2012/2013
"Carroll,Matt",0,0,,0,0,,0,0,,0,0,,0,0,0,1,0,0,0,1,0,2012/2013
"Carter,Vince",372,855,.435,162,399,.406,210,456,.461,182,223,.816,58,276,334,194,74,106,44,226,1088,2012/2013
"Casspi,Omri",63,160,.394,25,76,.329,38,84,.452,22,41,.537,20,94,114,28,25,22,12,45,173,2012/2013
"Chalmers,Mario",227,529,.429,123,301,.409,104,228,.456,89,112,.795,19,152,171,273,118,119,12,196,666,2012/2013
"Chandler,Tyson",255,400,.638,0,0,,255,400,.638,179,258,.694,269,434,703,62,42,87,75,188,689,2012/2013
"Chandler,Wilson",210,455,.462,52,126,.413,158,329,.480,88,111,.793,45,173,218,58,45,60,12,119,560,2012/2013
"Childress,Josh",6,21,.286,1,3,.333,5,18,.278,1,2,.500,6,9,15,5,2,0,2,3,14,2012/2013
"Clark,Earl",170,386,.440,35,104,.337,135,282,.479,53,76,.697,82,243,325,65,36,62,44,102,428,2012/2013
"Claver,Victor",74,189,.392,25,87,.287,49,102,.480,14,30,.467,31,88,119,43,26,43,12,75,187,2012/2013
"Cole,Norris",179,425,.421,35,98,.357,144,327,.440,52,80,.650,18,112,130,164,57,104,7,155,445,2012/2013
"Collins,Jason",9,29,.310,0,0,,9,29,.310,23,32,.719,22,38,60,8,12,18,10,85,41,2012/2013
"Collins,Jason",8,23,.348,0,0,,8,23,.348,21,30,.700,21,31,52,6,10,16,6,74,37,2012/2013
"Collins,Jason",1,6,.167,0,0,,1,6,.167,2,2,1.000,1,7,8,2,2,2,4,11,4,2012/2013
"Collison,Darren",341,724,.471,48,136,.353,293,588,.498,242,275,.880,31,188,219,415,100,173,8,139,972,2012/2013
"Collison,Nick",176,296,.595,0,4,.000,176,292,.603,60,78,.769,123,210,333,121,51,69,30,197,412,2012/2013
"Conley,Mike",414,940,.440,106,293,.362,308,647,.476,234,282,.830,43,182,225,487,174,189,24,171,1168,2012/2013
"Conroy,Will",0,9,.000,0,3,.000,0,6,.000,1,2,.500,1,0,1,0,0,0,0,1,1,2012/2013
"Cook,Daequan",51,167,.305,26,91,.286,25,76,.329,9,12,.750,7,54,61,19,8,15,7,26,137,2012/2013
"Cook,Daequan",21,59,.356,11,30,.367,10,29,.345,2,3,.667,5,13,18,10,6,6,2,13,55,2012/2013
"Cook,Daequan",30,108,.278,15,61,.246,15,47,.319,7,9,.778,2,41,43,9,2,9,5,13,82,2012/2013
"Copeland,Chris",182,380,.479,59,140,.421,123,240,.513,63,83,.759,34,85,119,27,16,50,12,104,486,2012/2013
"Cousins,DeMarcus",482,1036,.465,4,22,.182,478,1014,.471,312,423,.738,222,524,746,199,108,225,55,269,1280,2012/2013
"Crawford,Jamal",445,1016,.438,149,396,.376,296,620,.477,216,248,.871,22,106,128,193,79,146,13,71,1255,2012/2013
"Crawford,Jordan",301,725,.415,83,246,.337,218,479,.455,129,159,.811,44,165,209,225,39,141,7,106,814,2012/2013
"Crawford,Jordan",211,508,.415,59,171,.345,152,337,.451,87,106,.821,31,104,135,157,27,97,5,61,568,2012/2013
"Crawford,Jordan",90,217,.415,24,75,.320,66,142,.465,42,53,.792,13,61,74,68,12,44,2,45,246,2012/2013
"Crowder,Jae",141,367,.384,63,192,.328,78,175,.446,47,73,.644,35,152,187,94,63,49,17,128,392,2012/2013
"Cunningham,Dante",314,671,.468,0,6,.000,314,665,.472,67,103,.650,142,266,408,67,84,56,38,153,695,2012/2013
"Cunningham,Jared",6,14,.429,2,3,.667,4,11,.364,2,2,1.000,1,2,3,1,1,2,0,3,16,2012/2013
"Curry,Eddy",4,8,.500,0,0,,4,8,.500,1,4,.250,2,2,4,0,0,3,0,7,9,2012/2013
"Curry,Stephen",626,1388,.451,272,600,.453,354,788,.449,262,291,.900,59,255,314,539,126,240,12,198,1786,2012/2013
"Dalembert,Samuel",137,253,.542,1,1,1.000,136,252,.540,38,55,.691,105,171,276,21,17,51,53,90,313,2012/2013
"Daniels,Marquis",132,351,.376,20,72,.278,112,279,.401,40,54,.741,48,102,150,65,51,45,10,77,324,2012/2013
"Davis,Anthony",349,676,.516,0,6,.000,349,670,.521,169,225,.751,165,357,522,63,75,89,112,158,867,2012/2013
"Davis,Ed",260,482,.539,0,0,,260,482,.539,103,167,.617,152,308,460,63,38,63,85,191,623,2012/2013
"Davis,Ed",186,339,.549,0,0,,186,339,.549,66,102,.647,95,205,300,55,25,45,38,111,438,2012/2013
"Davis,Ed",74,143,.517,0,0,,74,143,.517,37,65,.569,57,103,160,8,13,18,47,80,185,2012/2013
"Davis,Glen",214,478,.448,0,2,.000,214,476,.450,84,117,.718,55,191,246,70,32,64,21,88,512,2012/2013
"Daye,Austin",90,208,.433,41,98,.418,49,110,.445,26,34,.765,16,107,123,42,14,29,22,82,247,2012/2013
"Daye,Austin",43,97,.443,21,40,.525,22,57,.386,15,18,.833,10,53,63,21,5,13,8,43,122,2012/2013
"Daye,Austin",47,111,.423,20,58,.345,27,53,.509,11,16,.688,6,54,60,21,9,16,14,39,125,2012/2013
"De Colo,Nando",105,241,.436,31,82,.378,74,159,.465,35,44,.795,23,115,138,138,41,81,6,87,276,2012/2013
"Delfino,Carlos",251,620,.405,158,421,.375,93,199,.467,48,56,.857,18,202,220,135,68,72,9,114,708,2012/2013
"Deng,Luol",466,1093,.426,75,233,.322,391,860,.455,230,282,.816,162,314,476,222,81,144,32,105,1237,2012/2013
"Dentmon,Justin",0,2,.000,0,0,,0,2,.000,0,0,,0,0,0,0,0,0,0,0,0,2012/2013
"DeRozan,DeMar",548,1231,.445,34,120,.283,514,1111,.463,355,427,.831,48,272,320,204,76,151,24,173,1485,2012/2013
"Diaw,Boris",179,332,.539,30,78,.385,149,254,.587,47,65,.723,66,188,254,180,52,84,27,143,435,2012/2013
"Diop,DeSagana",8,27,.296,0,1,.000,8,26,.308,0,1,.000,10,41,51,13,5,8,16,19,16,2012/2013
"Dooling,Keyon",10,21,.476,5,12,.417,5,9,.556,6,7,.857,0,1,1,8,1,5,0,8,31,2012/2013
"Douglas,Toney",188,466,.403,82,216,.380,106,250,.424,76,84,.905,34,104,138,151,71,81,3,145,534,2012/2013
"Douglas,Toney",139,352,.395,61,162,.377,78,190,.411,60,68,.882,23,67,90,93,40,56,2,103,399,2012/2013
"Douglas,Toney",49,114,.430,21,54,.389,28,60,.467,16,16,1.000,11,37,48,58,31,25,1,42,135,2012/2013
"Douglas-Roberts,Chris",5,14,.357,0,4,.000,5,10,.500,7,10,.700,0,5,5,4,2,1,0,4,17,2012/2013
"Dragić,Goran",401,906,.443,88,276,.319,313,630,.497,244,326,.748,60,178,238,569,124,212,26,214,1134,2012/2013
"Drummond,Andre",208,342,.608,1,2,.500,207,340,.609,59,159,.371,169,288,457,30,59,57,95,144,476,2012/2013
"Dudley,Jared",313,669,.468,106,271,.391,207,398,.520,129,162,.796,79,166,245,203,75,101,8,128,861,2012/2013
"Duhon,Chris",47,123,.382,33,91,.363,14,32,.438,6,13,.462,11,57,68,133,20,40,1,56,133,2012/2013
"Duncan,Tim",490,976,.502,2,7,.286,488,969,.504,245,300,.817,124,562,686,184,50,147,183,117,1227,2012/2013
"Dunleavy,Mike",276,624,.442,128,299,.428,148,325,.455,105,128,.820,31,260,291,145,39,90,35,135,785,2012/2013
"Durant,Kevin",731,1433,.510,139,334,.416,592,1099,.539,679,750,.905,46,594,640,374,116,280,105,143,2280,2012/2013
"Ebanks,Devin",24,73,.329,6,22,.273,18,51,.353,11,14,.786,10,31,41,10,3,11,1,23,65,2012/2013
"Ellington,Wayne",226,529,.427,94,240,.392,132,289,.457,68,75,.907,25,141,166,104,45,57,3,81,614,2012/2013
"Ellington,Wayne",81,199,.407,41,97,.423,40,102,.392,15,16,.938,5,47,52,42,16,24,1,38,218,2012/2013
"Ellington,Wayne",145,330,.439,53,143,.371,92,187,.492,53,59,.898,20,94,114,62,29,33,2,43,396,2012/2013
"Ellis,Monta",597,1436,.416,94,328,.287,503,1108,.454,289,374,.773,45,271,316,496,169,254,36,164,1577,2012/2013
"English,Kim",42,112,.375,14,50,.280,28,62,.452,21,29,.724,8,29,37,26,16,19,3,46,119,2012/2013
"Evans,Jeremy",27,44,.614,0,1,.000,27,43,.628,21,33,.636,26,32,58,11,8,8,13,30,75,2012/2013
"Evans,Reggie",125,261,.479,0,0,,125,261,.479,113,222,.509,260,628,888,43,74,111,13,199,363,2012/2013
"Evans,Tyreke",366,765,.478,45,133,.338,321,632,.508,210,271,.775,56,231,287,229,90,128,27,133,987,2012/2013
"Ezeli,Festus",74,169,.438,0,0,,74,169,.438,43,81,.531,141,172,313,22,23,63,74,157,191,2012/2013
"Faried,Kenneth",380,689,.552,0,0,,380,689,.552,163,266,.613,260,474,734,77,81,113,83,234,923,2012/2013
"Favors,Derrick",274,568,.482,0,5,.000,274,563,.487,179,260,.688,184,362,546,75,67,129,130,247,727,2012/2013
"Felton,Raymond",377,882,.427,93,258,.360,284,624,.455,101,128,.789,51,143,194,372,94,155,14,130,948,2012/2013
"Fields,Landry",102,223,.457,2,14,.143,100,209,.478,34,53,.642,59,149,208,60,32,42,8,63,240,2012/2013
"Fisher,Derek",55,161,.342,30,80,.375,25,81,.309,35,38,.921,2,35,37,47,19,30,3,55,175,2012/2013
"Fisher,Derek",23,65,.354,10,23,.435,13,42,.310,21,23,.913,0,15,15,31,5,18,2,24,77,2012/2013
"Fisher,Derek",32,96,.333,20,57,.351,12,39,.308,14,15,.933,2,20,22,16,14,12,1,31,98,2012/2013
"Fournier,Evan",75,152,.493,22,54,.407,53,98,.541,30,39,.769,6,29,35,44,19,32,1,65,202,2012/2013
"Foye,Randy",293,738,.397,178,434,.410,115,304,.378,118,144,.819,17,110,127,167,66,92,27,190,882,2012/2013
"Fredette,Jimmer",172,409,.421,65,156,.417,107,253,.423,85,99,.859,19,52,71,92,31,68,3,64,494,2012/2013
"Freeland,Joel",58,142,.408,0,0,,58,142,.408,18,27,.667,40,79,119,13,13,19,11,67,134,2012/2013
"Gallinari,Danilo",364,871,.418,135,362,.373,229,509,.450,286,348,.822,65,302,367,176,64,111,36,130,1149,2012/2013
"García,Francisco",118,300,.393,67,179,.374,51,121,.421,18,21,.857,8,83,91,63,46,32,38,88,321,2012/2013
"García,Francisco",77,205,.376,40,109,.367,37,96,.385,12,14,.857,7,61,68,43,32,20,31,66,206,2012/2013
"García,Francisco",41,95,.432,27,70,.386,14,25,.560,6,7,.857,1,22,23,20,14,12,7,22,115,2012/2013
"Garnett,Kevin",422,850,.496,2,16,.125,420,834,.504,158,201,.786,75,455,530,159,78,110,62,154,1004,2012/2013
"Garrett,Diante",16,49,.327,3,15,.200,13,34,.382,5,10,.500,5,10,15,31,10,16,0,5,40,2012/2013
"Gasol,Marc",429,869,.494,1,14,.071,428,855,.501,268,316,.848,184,438,622,318,80,157,139,255,1127,2012/2013
"Gasol,Pau",270,579,.466,8,28,.286,262,551,.475,125,178,.702,111,310,421,200,24,104,61,93,673,2012/2013
"Gay,Rudy",521,1253,.416,84,260,.323,437,993,.440,240,295,.814,99,362,461,202,113,198,53,182,1366,2012/2013
"Gay,Rudy",281,688,.408,40,129,.310,241,559,.431,121,156,.776,56,193,249,108,56,104,31,87,723,2012/2013
"Gay,Rudy",240,565,.425,44,131,.336,196,434,.452,119,139,.856,43,169,212,94,57,94,22,95,643,2012/2013
"Gee,Alonzo",305,744,.410,69,219,.315,236,525,.450,163,205,.795,75,245,320,133,107,132,29,199,842,2012/2013
"Gelabale,Mickaël",72,139,.518,16,52,.308,56,87,.644,21,24,.875,32,67,99,26,16,16,4,47,181,2012/2013
"George,Paul",493,1176,.419,170,469,.362,323,707,.457,221,274,.807,88,515,603,327,143,233,51,227,1377,2012/2013
"Gibson,Daniel",84,247,.340,56,163,.344,28,84,.333,26,37,.703,5,55,60,82,30,31,4,89,250,2012/2013
"Gibson,Taj",214,441,.485,0,4,.000,214,437,.490,89,131,.679,125,220,345,61,27,76,90,166,517,2012/2013
"Ginóbili,Manu",229,539,.425,83,235,.353,146,304,.480,164,206,.796,30,171,201,274,80,132,13,114,705,2012/2013
"Gooden,Drew",20,61,.328,1,5,.200,19,56,.339,11,16,.688,13,18,31,6,5,9,6,21,52,2012/2013
"Gordon,Ben",310,760,.408,113,292,.387,197,468,.421,107,127,.843,18,112,130,141,35,136,16,134,840,2012/2013
"Gordon,Eric",235,584,.402,56,173,.324,179,411,.436,187,222,.842,10,67,77,137,45,117,8,75,713,2012/2013
"Gortat,Marcin",295,566,.521,0,3,.000,295,563,.524,90,138,.652,128,388,516,75,40,99,98,127,680,2012/2013
"Goudelock,Andrew",0,2,.000,0,0,,0,2,.000,0,0,,1,0,1,0,0,0,0,0,0,2012/2013
"Granger,Danny",10,35,.286,2,10,.200,8,25,.320,5,8,.625,3,6,9,3,2,4,1,6,27,2012/2013
"Gray,Aaron",48,90,.533,0,0,,48,90,.533,23,44,.523,48,85,133,33,7,36,5,85,119,2012/2013
"Green,Danny",297,663,.448,177,413,.429,120,250,.480,67,79,.848,36,208,244,141,92,94,54,124,838,2012/2013
"Green,Draymond",84,257,.327,14,67,.209,70,190,.368,45,55,.818,58,202,260,53,42,51,25,159,227,2012/2013
"Green,Gerald",155,424,.366,59,188,.314,96,236,.407,52,65,.800,31,110,141,50,19,53,23,64,421,2012/2013
"Green,Jeff",376,806,.467,70,182,.385,306,624,.490,214,265,.808,55,263,318,128,56,132,68,175,1036,2012/2013
"Green,Willie",178,386,.461,71,166,.428,107,220,.486,23,32,.719,17,80,97,55,29,31,12,96,450,2012/2013
"Griffin,Blake",577,1072,.538,5,28,.179,572,1044,.548,281,426,.660,186,476,662,299,97,185,50,231,1440,2012/2013
"Haddadi,Hamed",35,82,.427,0,0,,35,82,.427,14,27,.519,43,68,111,12,6,31,27,60,84,2012/2013
"Haddadi,Hamed",7,21,.333,0,0,,7,21,.333,1,2,.500,10,14,24,4,1,4,6,15,15,2012/2013
"Haddadi,Hamed",28,61,.459,0,0,,28,61,.459,13,25,.520,33,54,87,8,5,27,21,45,69,2012/2013
"Hamilton,Jordan",84,201,.418,27,73,.370,57,128,.445,13,26,.500,32,63,95,23,15,19,8,24,208,2012/2013
"Hamilton,Richard",204,475,.429,16,52,.308,188,423,.444,66,77,.857,16,67,83,119,24,84,5,93,490,2012/2013
"Hansbrough,Ben",15,45,.333,6,23,.261,9,22,.409,21,27,.778,2,16,18,21,7,18,2,23,57,2012/2013
"Hansbrough,Tyler",176,407,.432,0,3,.000,176,404,.436,216,300,.720,161,212,373,36,29,78,18,152,568,2012/2013
"Harden,James",585,1337,.438,179,486,.368,406,851,.477,674,792,.851,62,317,379,455,142,295,38,178,2023,2012/2013
"Harkless,Maurice",260,564,.461,32,117,.274,228,447,.510,73,128,.570,122,213,335,50,88,69,62,144,625,2012/2013
"Harrellson,Josh",4,9,.444,1,5,.200,3,4,.750,1,2,.500,3,4,7,0,1,3,1,4,10,2012/2013
"Harrington,Al",20,57,.351,8,30,.267,12,27,.444,3,4,.750,6,21,27,10,4,7,1,18,51,2012/2013
"Harris,Devin",194,443,.438,77,230,.335,117,213,.549,112,154,.727,6,110,116,197,64,88,13,103,577,2012/2013
"Harris,Terrel",4,27,.148,0,8,.000,4,19,.211,7,10,.700,4,22,26,9,2,17,3,17,15,2012/2013
"Harris,Terrel",2,8,.250,0,1,.000,2,7,.286,6,8,.750,4,5,9,2,0,4,0,3,10,2012/2013
"Harris,Terrel",2,19,.105,0,7,.000,2,12,.167,1,2,.500,0,17,17,7,2,13,3,14,5,2012/2013
"Harris,Tobias",233,512,.455,34,108,.315,199,404,.493,103,137,.752,73,214,287,69,32,66,44,120,603,2012/2013
"Harris,Tobias",53,115,.461,7,21,.333,46,94,.489,23,26,.885,17,40,57,13,8,18,7,31,136,2012/2013
"Harris,Tobias",180,397,.453,27,87,.310,153,310,.494,80,111,.721,56,174,230,56,24,48,37,89,467,2012/2013
"Haslem,Udonis",129,251,.514,0,0,,129,251,.514,32,45,.711,97,307,404,38,30,45,15,173,290,2012/2013
"Hawes,Spencer",376,811,.464,31,87,.356,345,724,.477,122,157,.777,173,417,590,183,24,131,113,233,905,2012/2013
"Hayes,Chuck",84,190,.442,0,1,.000,84,189,.444,30,48,.625,113,186,299,112,31,44,18,114,198,2012/2013
"Hayward,Gordon",336,773,.435,102,246,.415,234,527,.444,243,294,.827,51,174,225,213,58,120,38,125,1017,2012/2013
"Hayward,Lazar",2,10,.200,0,4,.000,2,6,.333,6,6,1.000,0,4,4,3,2,0,0,3,10,2012/2013
"Haywood,Brendan",93,216,.431,0,1,.000,93,215,.433,30,66,.455,125,165,290,29,16,50,49,125,216,2012/2013
"Henderson,Gerald",382,855,.447,33,100,.330,349,755,.462,258,313,.824,55,195,250,177,68,108,34,149,1055,2012/2013
"Henry,Xavier",66,161,.410,4,11,.364,62,150,.413,58,92,.630,21,69,90,13,16,31,5,72,194,2012/2013
"Henson,John",162,336,.482,0,3,.000,162,333,.486,56,105,.533,116,181,297,31,19,47,42,83,380,2012/2013
"Hibbert,Roy",385,859,.448,1,4,.250,384,855,.449,166,224,.741,296,360,656,113,39,162,206,279,937,2012/2013
"Hickson,J.J.",418,744,.562,0,2,.000,418,742,.563,182,268,.679,266,562,828,88,48,145,51,160,1018,2012/2013
"Higgins,Cory",6,19,.316,1,5,.200,5,14,.357,1,2,.500,1,2,3,5,3,0,0,5,14,2012/2013
"Hilário,Nenê",285,594,.480,0,1,.000,285,593,.481,196,269,.729,101,306,407,177,55,139,37,171,766,2012/2013
"Hill,George",386,871,.443,130,353,.368,256,518,.494,174,213,.817,47,237,284,355,81,116,26,134,1076,2012/2013
"Hill,Grant",38,98,.388,3,11,.273,35,87,.402,14,24,.583,6,43,49,26,11,25,7,39,93,2012/2013
"Hill,Jordan",77,155,.497,0,2,.000,77,153,.503,40,61,.656,82,84,166,13,8,26,19,55,194,2012/2013
"Hinrich,Kirk",159,422,.377,71,182,.390,88,240,.367,70,98,.714,16,142,158,314,63,99,25,192,459,2012/2013
"Holiday,Jrue",555,1288,.431,91,247,.368,464,1041,.446,182,242,.752,89,240,329,625,123,292,32,170,1383,2012/2013
"Holiday,Justin",16,48,.333,4,16,.250,12,32,.375,6,8,.750,0,14,14,15,3,9,6,7,42,2012/2013
"Hollins,Ryan",70,114,.614,0,0,,70,114,.614,66,88,.750,50,89,139,11,6,44,34,133,206,2012/2013
"Honeycutt,Tyler",3,11,.273,0,2,.000,3,9,.333,2,2,1.000,3,7,10,2,0,5,1,2,8,2012/2013
"Horford,Al",576,1060,.543,3,6,.500,573,1054,.544,134,208,.644,195,562,757,240,78,147,78,163,1289,2012/2013
"Howard,Dwight",470,813,.578,1,6,.167,469,807,.581,355,721,.492,251,694,945,108,84,225,186,291,1296,2012/2013
"Howard,Josh",31,77,.403,5,16,.313,26,61,.426,7,12,.583,9,27,36,4,10,10,3,18,74,2012/2013
"Howard,Juwan",10,19,.526,0,0,,10,19,.526,1,1,1.000,0,8,8,6,0,4,0,9,21,2012/2013
"Humphries,Kris",139,310,.448,0,2,.000,139,308,.451,97,123,.789,126,239,365,32,16,57,33,127,375,2012/2013
"Ibaka,Serge",446,778,.573,20,57,.351,426,721,.591,143,191,.749,222,395,617,43,28,125,242,213,1055,2012/2013
"Iguodala,Andre",396,879,.451,91,287,.317,305,592,.515,155,270,.574,82,341,423,433,139,206,52,127,1038,2012/2013
"İlyasova,Ersan",371,803,.462,95,214,.444,276,589,.469,125,157,.796,154,366,520,117,68,75,36,185,962,2012/2013
"Irving,Kyrie",484,1070,.452,109,279,.391,375,791,.474,248,290,.855,34,182,216,350,89,191,21,146,1325,2012/2013
"Ivey,Royal",62,144,.431,37,88,.420,25,56,.446,9,16,.563,16,41,57,32,23,20,3,73,170,2012/2013
"Jack,Jarrett",387,857,.452,82,203,.404,305,654,.466,167,198,.843,21,222,243,439,60,157,11,134,1023,2012/2013
"Jackson,Reggie",149,325,.458,24,104,.231,125,221,.566,52,62,.839,21,145,166,122,29,53,13,84,374,2012/2013
"Jackson,Stephen",123,330,.373,46,170,.271,77,160,.481,49,70,.700,22,133,155,80,37,77,14,89,341,2012/2013
"James,Bernard",53,103,.515,0,2,.000,53,101,.525,25,41,.610,52,79,131,6,12,18,38,64,131,2012/2013
"James,Damion",0,0,,0,0,,0,0,,0,0,,0,1,1,0,0,0,0,0,0,2012/2013
"James,LeBron",765,1354,.565,103,254,.406,662,1100,.602,403,535,.753,97,513,610,551,129,226,67,110,2036,2012/2013
"James,Mike",101,271,.373,48,125,.384,53,146,.363,23,29,.793,9,63,72,139,26,55,3,95,273,2012/2013
"Jamison,Antawn",267,575,.464,84,233,.361,183,342,.535,94,136,.691,109,253,362,50,30,53,22,124,712,2012/2013
"Jefferson,Al",611,1236,.494,2,17,.118,609,1219,.500,167,217,.770,156,564,720,164,80,105,89,170,1391,2012/2013
"Jefferson,Richard",62,136,.456,14,45,.311,48,91,.527,38,53,.717,5,79,84,31,14,23,7,45,176,2012/2013
"Jeffries,Jared",16,54,.296,0,2,.000,16,52,.308,12,23,.522,26,34,60,14,6,17,6,58,44,2012/2013
"Jenkins,Charles",49,121,.405,1,2,.500,48,119,.403,12,22,.545,8,24,32,44,15,21,2,22,111,2012/2013
"Jenkins,Charles",35,83,.422,1,2,.500,34,81,.420,10,18,.556,5,16,21,28,9,19,1,18,81,2012/2013
"Jenkins,Charles",14,38,.368,0,0,,14,38,.368,2,4,.500,3,8,11,16,6,2,1,4,30,2012/2013
"Jenkins,John",131,294,.446,53,138,.384,78,156,.500,59,70,.843,17,77,94,56,12,40,10,37,374,2012/2013
"Jennings,Brandon",497,1247,.399,173,461,.375,324,786,.412,230,281,.819,59,187,246,521,125,203,10,155,1397,2012/2013
"Jerebko,Jonas",142,316,.449,25,83,.301,117,233,.502,68,88,.773,68,117,185,43,38,42,8,90,377,2012/2013
"Johnson,Amir",336,606,.554,5,13,.385,331,593,.558,136,187,.727,227,384,611,122,81,117,110,301,813,2012/2013
"Johnson,Chris",48,75,.640,0,0,,48,75,.640,21,34,.618,20,40,60,8,7,13,28,49,117,2012/2013
"Johnson,Chris",11,25,.440,6,18,.333,5,7,.714,1,2,.500,5,6,11,2,4,3,0,5,29,2012/2013
"Johnson,Ivan",185,356,.520,1,13,.077,184,343,.536,81,131,.618,76,190,266,46,56,71,14,131,452,2012/2013
"Johnson,James",117,283,.413,2,21,.095,115,262,.439,40,67,.597,49,96,145,58,41,68,50,99,276,2012/2013
"Johnson,Joe",445,1052,.423,148,395,.375,297,657,.452,132,161,.820,53,165,218,253,49,123,14,99,1170,2012/2013
"Johnson,Orlando",72,180,.400,36,94,.383,36,86,.419,23,32,.719,20,90,110,47,11,29,9,51,203,2012/2013
"Johnson,Wesley",161,396,.407,50,155,.323,111,241,.461,27,35,.771,21,102,123,34,22,48,18,56,399,2012/2013
"Johnson-Odom,Darius",0,4,.000,0,1,.000,0,3,.000,0,0,,1,3,4,1,0,0,0,0,0,2012/2013
"Jones,Dahntay",82,222,.369,11,49,.224,71,173,.410,87,113,.770,24,77,101,48,22,38,6,119,262,2012/2013
"Jones,Dahntay",50,140,.357,8,37,.216,42,103,.408,66,82,.805,13,57,70,28,10,22,5,73,174,2012/2013
"Jones,Dahntay",32,82,.390,3,12,.250,29,70,.414,21,31,.677,11,20,31,20,12,16,1,46,88,2012/2013
"Jones,DeQuan",95,218,.436,9,35,.257,86,183,.470,34,51,.667,17,88,105,16,19,30,22,55,233,2012/2013
"Jones,Dominique",40,109,.367,1,9,.111,39,100,.390,35,53,.660,18,27,45,83,14,38,2,29,116,2012/2013
"Jones,James",21,61,.344,16,53,.302,5,8,.625,2,4,.500,0,22,22,13,2,3,6,16,60,2012/2013
"Jones,Kevin",43,107,.402,0,0,,43,107,.402,9,15,.600,38,40,78,10,9,8,5,25,95,2012/2013
"Jones,Perry",39,99,.394,0,2,.000,39,97,.402,10,15,.667,12,50,62,10,5,15,6,23,88,2012/2013
"Jones,Solomon",0,1,.000,0,0,,0,1,.000,0,0,,1,2,3,0,0,3,1,3,0,2012/2013
"Jones,Terrence",43,94,.457,5,19,.263,38,75,.507,13,17,.765,28,37,65,15,12,13,19,21,104,2012/2013
"Jordan,DeAndre",314,488,.643,0,0,,314,488,.643,96,249,.386,210,384,594,28,48,100,112,192,724,2012/2013
"Joseph,Cory",51,110,.464,6,21,.286,45,89,.506,18,21,.857,12,40,52,53,15,21,4,25,126,2012/2013
"Joseph,Kris",2,14,.143,0,3,.000,2,11,.182,5,8,.625,1,6,7,1,3,2,0,3,9,2012/2013
"Joseph,Kris",2,11,.182,0,2,.000,2,9,.222,3,4,.750,1,4,5,1,0,2,0,2,7,2012/2013
"Joseph,Kris",0,3,.000,0,1,.000,0,2,.000,2,4,.500,0,2,2,0,3,0,0,1,2,2012/2013
"Kaman,Chris",313,617,.507,0,1,.000,313,616,.508,67,85,.788,97,275,372,51,29,103,52,141,693,2012/2013
"Kanter,Enes",206,379,.544,1,1,1.000,205,378,.542,93,117,.795,135,169,304,31,28,101,32,116,506,2012/2013
"Kidd,Jason",152,409,.372,114,325,.351,38,84,.452,40,48,.833,50,273,323,249,125,76,25,125,458,2012/2013
"Kidd-Gilchrist,Michael",281,613,.458,2,9,.222,279,604,.462,140,187,.749,131,324,455,117,54,101,70,164,704,2012/2013
"Kirilenko,Andrei",284,560,.507,35,120,.292,249,440,.566,188,250,.752,102,260,362,177,96,119,62,82,791,2012/2013
"Kleiza,Linas",48,144,.333,20,66,.303,28,78,.359,32,38,.842,10,42,52,16,4,14,2,45,148,2012/2013
"Knight,Brandon",357,878,.407,120,327,.367,237,551,.430,165,225,.733,54,193,247,303,58,205,8,157,999,2012/2013
"Korver,Kyle",277,601,.461,189,414,.457,88,187,.471,67,78,.859,23,270,293,146,70,70,37,170,810,2012/2013
"Koufos,Kosta",295,508,.581,0,1,.000,295,507,.582,58,104,.558,211,351,562,32,44,53,103,246,648,2012/2013
"Kravtsov,Viacheslav",33,46,.717,0,0,,33,46,.717,11,37,.297,24,21,45,9,5,14,9,32,77,2012/2013
"Lamb,Doron",60,163,.368,14,37,.378,46,126,.365,20,34,.588,8,38,46,32,13,26,0,52,154,2012/2013
"Lamb,Doron",33,95,.347,4,16,.250,29,79,.367,8,15,.533,3,14,17,20,7,16,0,27,78,2012/2013
"Lamb,Doron",27,68,.397,10,21,.476,17,47,.362,12,19,.632,5,24,29,12,6,10,0,25,76,2012/2013
"Lamb,Jeremy",24,68,.353,9,30,.300,15,38,.395,14,14,1.000,5,13,18,5,2,6,2,13,71,2012/2013
"Landry,Carl",325,602,.540,1,3,.333,324,599,.541,223,273,.817,180,303,483,65,35,115,31,190,874,2012/2013
"Lawson,Ty",448,971,.461,85,232,.366,363,739,.491,235,311,.756,36,162,198,501,107,182,8,135,1216,2012/2013
"Lee,Courtney",246,530,.464,58,156,.372,188,374,.503,62,72,.861,31,159,190,143,89,84,21,139,612,2012/2013
"Lee,David",602,1160,.519,0,4,.000,602,1156,.521,255,320,.797,218,668,886,279,67,207,22,246,1459,2012/2013
"Lee,Malcolm",29,76,.382,8,24,.333,21,52,.404,12,20,.600,15,24,39,20,12,10,6,30,78,2012/2013
"Leonard,Kawhi",260,526,.494,65,174,.374,195,352,.554,104,126,.825,63,283,346,93,97,62,32,99,689,2012/2013
"Leonard,Meyers",151,277,.545,3,7,.429,148,270,.548,72,89,.809,80,175,255,33,11,49,38,168,377,2012/2013
"Leuer,Jon",25,52,.481,0,3,.000,25,49,.510,6,13,.462,13,24,37,8,6,8,0,21,56,2012/2013
"Leuer,Jon",10,28,.357,0,3,.000,10,25,.400,2,6,.333,5,8,13,5,2,5,0,11,22,2012/2013
"Leuer,Jon",15,24,.625,0,0,,15,24,.625,4,7,.571,8,16,24,3,4,3,0,10,34,2012/2013
"Lewis,Rashard",103,249,.414,51,131,.389,52,118,.441,28,45,.622,19,102,121,30,21,33,14,67,285,2012/2013
"Liggins,DeAndre",21,47,.447,7,19,.368,14,28,.500,9,18,.500,13,40,53,15,18,14,3,33,58,2012/2013
"Lillard,Damian",553,1288,.429,185,503,.368,368,785,.469,271,321,.844,42,215,257,531,74,243,19,172,1562,2012/2013
"Lin,Jeremy",396,897,.441,87,257,.339,309,640,.483,216,275,.785,32,215,247,497,134,236,29,205,1095,2012/2013
"Livingston,Shaun",166,346,.480,0,4,.000,166,342,.485,85,98,.867,31,127,158,215,48,76,31,127,417,2012/2013
"Livingston,Shaun",24,66,.364,0,3,.000,24,63,.381,15,15,1.000,2,35,37,38,11,17,2,22,63,2012/2013
"Livingston,Shaun",142,280,.507,0,1,.000,142,279,.509,70,83,.843,29,92,121,177,37,59,29,105,354,2012/2013
"Lopez,Brook",570,1094,.521,0,1,.000,570,1093,.522,297,392,.758,208,304,512,70,33,131,154,152,1437,2012/2013
"Lopez,Robin",384,719,.534,0,0,,384,719,.534,161,207,.778,226,236,462,64,32,110,128,167,929,2012/2013
"Love,Kevin",105,298,.352,20,92,.217,85,206,.413,100,142,.704,64,188,252,42,13,39,9,34,330,2012/2013
"Lowry,Kyle",250,623,.401,101,279,.362,149,344,.433,190,239,.795,56,265,321,435,94,157,24,218,791,2012/2013
"Lucas III,John",129,334,.386,57,151,.377,72,183,.393,18,25,.720,8,57,65,105,23,26,1,50,333,2012/2013
"Machado,Scott",3,6,.500,0,1,.000,3,5,.600,2,2,1.000,0,1,1,6,2,8,0,0,8,2012/2013
"Mack,Shelvin",58,126,.460,18,49,.367,40,77,.519,9,16,.563,3,37,40,68,15,34,0,39,143,2012/2013
"Mack,Shelvin",16,40,.400,4,13,.308,12,27,.444,1,2,.500,3,13,16,23,6,8,0,10,37,2012/2013
"Mack,Shelvin",1,2,.500,0,1,.000,1,1,1.000,0,0,,0,0,0,1,0,2,0,1,2,2012/2013
"Mack,Shelvin",41,84,.488,14,35,.400,27,49,.551,8,14,.571,0,24,24,44,9,24,0,28,104,2012/2013
"Maggette,Corey",27,76,.355,5,21,.238,22,55,.400,36,48,.750,5,20,25,19,6,17,2,42,95,2012/2013
"Mahinmi,Ian",149,329,.453,0,2,.000,149,327,.456,104,171,.608,115,196,311,27,39,92,66,201,402,2012/2013
"Marion,Shawn",355,690,.514,23,73,.315,332,617,.538,79,101,.782,146,379,525,163,75,103,47,111,812,2012/2013
"Marshall,Kendall",56,151,.371,23,73,.315,33,78,.423,8,14,.571,4,38,42,143,22,57,4,48,143,2012/2013
"Martin,Cartier",96,252,.381,58,146,.397,38,106,.358,20,28,.714,11,89,100,20,19,32,6,58,270,2012/2013
"Martin,Kenyon",56,93,.602,0,0,,56,93,.602,17,40,.425,34,61,95,8,16,16,17,64,129,2012/2013
"Martin,Kevin",350,778,.450,158,371,.426,192,407,.472,219,246,.890,31,147,178,106,72,101,8,138,1077,2012/2013
"Mason,Roger",132,305,.433,66,159,.415,66,146,.452,39,43,.907,11,121,132,74,26,51,11,104,369,2012/2013
"Matthews,Wesley",352,808,.436,169,425,.398,183,383,.478,149,187,.797,35,156,191,174,90,109,18,172,1022,2012/2013
"Maxiell,Jason",204,457,.446,0,0,,204,457,.446,90,145,.621,135,274,409,54,32,81,95,172,498,2012/2013
"Maynor,Eric",106,281,.377,34,96,.354,72,185,.389,45,62,.726,9,37,46,182,22,79,1,55,291,2012/2013
"Maynor,Eric",36,115,.313,15,46,.326,21,69,.304,17,21,.810,5,13,18,73,10,31,0,19,104,2012/2013
"Maynor,Eric",70,166,.422,19,50,.380,51,116,.440,28,41,.683,4,24,28,109,12,48,1,36,187,2012/2013
"Mayo,O.J.",461,1026,.449,142,349,.407,319,677,.471,191,233,.820,36,255,291,361,93,210,23,195,1255,2012/2013
"Mbah a Moute,Luc",151,377,.401,13,37,.351,138,340,.406,72,126,.571,89,167,256,55,42,70,14,82,387,2012/2013
"McGee,JaVale",303,527,.575,1,1,1.000,302,526,.574,110,186,.591,158,223,381,24,30,90,157,184,717,2012/2013
"McGuire,Dominic",24,56,.429,0,0,,24,56,.429,3,10,.300,19,59,78,20,13,12,11,39,51,2012/2013
"McGuire,Dominic",15,32,.469,0,0,,15,32,.469,2,6,.333,11,37,48,10,5,7,8,26,32,2012/2013
"McGuire,Dominic",9,21,.429,0,0,,9,21,.429,1,2,.500,7,21,28,9,8,5,3,13,19,2012/2013
"McGuire,Dominic",0,3,.000,0,0,,0,3,.000,0,2,.000,1,1,2,1,0,0,0,0,0,2012/2013
"McRoberts,Josh",156,343,.455,24,84,.286,132,259,.510,65,85,.765,93,232,325,141,32,66,27,131,401,2012/2013
"McRoberts,Josh",60,153,.392,17,55,.309,43,98,.439,22,30,.733,41,96,137,70,10,28,12,65,159,2012/2013
"McRoberts,Josh",96,190,.505,7,29,.241,89,161,.553,43,55,.782,52,136,188,71,22,38,15,66,242,2012/2013
"Meeks,Jodie",205,530,.387,122,342,.357,83,188,.441,86,96,.896,37,134,171,69,58,52,5,103,618,2012/2013
"Melo,Fab",3,6,.500,0,0,,3,6,.500,1,4,.250,0,3,3,0,2,1,2,7,7,2012/2013
"Middleton,Khris",62,141,.440,14,45,.311,48,96,.500,27,32,.844,4,46,50,28,15,11,4,53,165,2012/2013
"Miles,C.J.",255,614,.415,126,328,.384,129,286,.451,93,107,.869,24,150,174,63,49,69,17,138,729,2012/2013
"Miličić,Darko",0,1,.000,0,0,,0,1,.000,0,0,,0,1,1,0,0,2,0,1,0,2012/2013
"Miller,Andre",303,632,.479,17,64,.266,286,568,.504,163,194,.840,60,178,238,484,73,172,11,159,786,2012/2013
"Miller,Darius",44,108,.407,22,56,.393,22,52,.423,8,8,1.000,8,70,78,44,17,23,12,89,118,2012/2013
"Miller,Mike",100,231,.433,73,175,.417,27,56,.482,8,11,.727,18,139,157,99,21,35,4,63,281,2012/2013
"Miller,Quincy",4,12,.333,0,1,.000,4,11,.364,1,2,.500,1,1,2,3,1,1,0,3,9,2012/2013
"Mills,Patty",113,241,.469,52,130,.400,61,111,.550,16,19,.842,9,41,50,62,26,39,4,55,294,2012/2013
"Millsap,Paul",429,875,.490,13,39,.333,416,836,.498,264,356,.742,177,377,554,201,102,138,80,232,1135,2012/2013
"Mohammed,Nazr",66,180,.367,0,2,.000,66,178,.371,34,47,.723,73,122,195,26,21,24,32,97,166,2012/2013
"Monroe,Greg",514,1058,.486,0,4,.000,514,1054,.488,270,392,.689,236,541,777,281,105,234,55,190,1298,2012/2013
"Moore,E'Twaun",237,598,.396,67,197,.340,170,401,.424,47,59,.797,48,119,167,206,51,105,23,122,588,2012/2013
"Morris,Darius",73,188,.388,24,66,.364,49,122,.402,24,37,.649,24,33,57,76,21,45,2,58,194,2012/2013
"Morris,Marcus",222,526,.422,86,233,.369,136,293,.464,66,117,.564,80,197,277,62,45,77,20,160,596,2012/2013
"Morris,Marcus",171,400,.428,74,194,.381,97,206,.471,49,75,.653,63,156,219,47,27,53,16,120,465,2012/2013
"Morris,Marcus",51,126,.405,12,39,.308,39,87,.448,17,42,.405,17,41,58,15,18,24,4,40,131,2012/2013
"Morris,Markieff",266,653,.407,45,134,.336,221,519,.426,93,127,.732,131,265,396,108,77,104,64,209,670,2012/2013
"Morrow,Anthony",64,145,.441,16,43,.372,48,102,.471,20,22,.909,11,19,30,13,13,8,1,43,164,2012/2013
"Morrow,Anthony",47,111,.423,15,38,.395,32,73,.438,16,18,.889,10,16,26,9,12,4,1,33,125,2012/2013
"Morrow,Anthony",17,34,.500,1,5,.200,16,29,.552,4,4,1.000,1,3,4,4,1,4,0,10,39,2012/2013
"Motiejūnas,Donatas",97,213,.455,24,83,.289,73,130,.562,32,51,.627,36,57,93,31,7,37,10,73,250,2012/2013
"Moultrie,Arnett",78,134,.582,0,0,,78,134,.582,18,28,.643,76,69,145,10,17,19,10,43,174,2012/2013
"Mozgov,Timofey",44,87,.506,0,2,.000,44,85,.518,20,26,.769,50,57,107,9,6,25,18,57,108,2012/2013
"Mullens,Byron",217,563,.385,66,208,.317,151,355,.425,64,99,.646,71,266,337,81,34,74,32,110,564,2012/2013
"Murphy,Kevin",7,28,.250,1,5,.200,6,23,.261,0,0,,0,4,4,2,1,3,0,4,15,2012/2013
"Murphy,Troy",22,61,.361,11,35,.314,11,26,.423,10,11,.909,7,42,49,7,10,7,6,29,65,2012/2013
"Nash,Steve",236,475,.497,57,130,.438,179,345,.519,107,116,.922,26,116,142,333,30,126,5,70,636,2012/2013
"Neal,Gary",246,597,.412,89,251,.355,157,346,.454,64,74,.865,13,130,143,129,30,69,2,93,645,2012/2013
"Nelson,Jameer",306,780,.392,121,355,.341,185,425,.435,89,102,.873,23,186,209,413,71,154,6,161,822,2012/2013
"Nicholson,Andrew",256,486,.527,0,0,,256,486,.527,75,94,.798,69,189,258,44,24,79,32,133,587,2012/2013
"Noah,Joakim",303,630,.481,0,5,.000,303,625,.485,178,237,.751,260,473,733,262,78,176,141,185,784,2012/2013
"Novak,Steve",178,430,.414,149,351,.425,29,79,.367,30,33,.909,17,135,152,35,28,12,8,97,535,2012/2013
"Nowitzki,Dirk",343,728,.471,65,157,.414,278,571,.487,166,193,.860,37,326,363,132,38,70,37,93,917,2012/2013
"O'Neal,Jermaine",179,371,.482,0,0,,179,371,.482,96,115,.835,82,211,293,42,19,73,78,126,454,2012/2013
"O'Quinn,Kyle",101,197,.513,0,1,.000,101,196,.515,30,45,.667,65,144,209,52,11,37,26,107,232,2012/2013
"Odom,Lamar",146,366,.399,18,90,.200,128,276,.464,20,42,.476,117,363,480,142,69,86,58,214,330,2012/2013
"Ohlbrecht,Tim",1,3,.333,0,0,,1,3,.333,1,1,1.000,0,1,1,1,1,4,0,1,3,2012/2013
"Okafor,Emeka",328,687,.477,0,0,,328,687,.477,109,191,.571,199,493,692,93,45,107,77,145,765,2012/2013
"Orton,Daniel",12,26,.462,0,0,,12,26,.462,9,17,.529,13,13,26,4,4,4,3,13,33,2012/2013
"Outlaw,Travis",74,177,.418,14,50,.280,60,127,.472,38,52,.731,17,44,61,21,11,19,8,35,200,2012/2013
"Pachulia,Zaza",114,241,.473,0,3,.000,114,238,.479,78,103,.757,132,204,336,79,35,70,12,128,306,2012/2013
"Pargo,Jannero",78,212,.368,39,116,.336,39,96,.406,12,13,.923,10,25,35,67,18,41,3,42,207,2012/2013
"Pargo,Jannero",8,32,.250,3,20,.150,5,12,.417,2,2,1.000,0,6,6,14,0,8,1,8,21,2012/2013
"Pargo,Jannero",13,38,.342,7,20,.350,6,18,.333,2,2,1.000,1,6,7,19,3,5,0,8,35,2012/2013
"Pargo,Jannero",57,142,.401,29,76,.382,28,66,.424,8,9,.889,9,13,22,34,15,28,2,26,151,2012/2013
"Pargo,Jeremy",99,250,.396,25,74,.338,74,176,.420,42,62,.677,8,41,49,92,13,50,2,46,265,2012/2013
"Pargo,Jeremy",75,187,.401,18,57,.316,57,130,.438,28,41,.683,7,25,32,64,12,37,2,32,196,2012/2013
"Pargo,Jeremy",24,63,.381,7,17,.412,17,46,.370,14,21,.667,1,16,17,28,1,13,0,14,69,2012/2013
"Parker,Tony",519,995,.522,24,68,.353,495,927,.534,279,330,.845,18,180,198,499,54,170,6,92,1341,2012/2013
"Parsons,Chandler",456,939,.486,152,395,.385,304,544,.559,113,155,.729,79,325,404,269,75,147,32,148,1177,2012/2013
"Patterson,Patrick",319,623,.512,51,132,.386,268,491,.546,48,63,.762,113,224,337,81,31,61,40,138,737,2012/2013
"Patterson,Patrick",236,455,.519,35,96,.365,201,359,.560,37,49,.755,73,148,221,51,18,42,27,90,544,2012/2013
"Patterson,Patrick",83,168,.494,16,36,.444,67,132,.508,11,14,.786,40,76,116,30,13,19,13,48,193,2012/2013
"Paul,Chris",412,856,.481,76,232,.328,336,624,.538,286,323,.885,53,209,262,678,169,159,10,143,1186,2012/2013
"Pavlović,Sasha",42,119,.353,18,60,.300,24,59,.407,1,6,.167,7,49,56,32,24,14,5,59,103,2012/2013
"Peković,Nikola",385,741,.520,0,0,,385,741,.520,241,324,.744,230,315,545,53,43,101,50,143,1011,2012/2013
"Perkins,Kendrick",143,313,.457,0,1,.000,143,312,.458,44,72,.611,110,356,466,111,43,109,83,227,330,2012/2013
"Petro,Johan",48,110,.436,1,4,.250,47,106,.443,11,12,.917,33,79,112,16,10,24,9,48,108,2012/2013
"Pierce,Paul",476,1092,.436,145,382,.380,331,710,.466,333,423,.787,45,442,487,370,84,214,30,210,1430,2012/2013
"Piétrus,Mickaël",34,98,.347,20,64,.313,14,34,.412,12,18,.667,5,31,36,9,12,16,6,33,100,2012/2013
"Pittman,Dexter",4,11,.364,0,0,,4,11,.364,0,3,.000,7,5,12,0,0,3,0,8,8,2012/2013
"Pittman,Dexter",3,5,.600,0,0,,3,5,.600,0,0,,4,3,7,0,0,2,0,4,6,2012/2013
"Pittman,Dexter",1,6,.167,0,0,,1,6,.167,0,3,.000,3,2,5,0,0,1,0,4,2,2012/2013
"Plumlee,Miles",5,21,.238,0,0,,5,21,.238,3,4,.750,12,10,22,2,0,3,3,5,13,2012/2013
"Pondexter,Quincy",128,299,.428,60,152,.395,68,147,.463,59,75,.787,43,89,132,61,35,42,6,95,375,2012/2013
"Price,A.J.",161,413,.390,70,200,.350,91,213,.427,49,62,.790,20,94,114,205,33,64,3,73,441,2012/2013
"Price,Ronnie",39,120,.325,10,39,.256,29,81,.358,17,24,.708,13,31,44,73,26,34,3,61,105,2012/2013
"Prigioni,Pablo",100,220,.455,53,134,.396,47,86,.547,22,25,.880,41,102,143,236,69,86,2,127,275,2012/2013
"Prince,Tayshaun",359,820,.438,38,94,.404,321,726,.442,96,130,.738,72,292,364,196,48,89,25,86,852,2012/2013
"Prince,Tayshaun",215,484,.444,23,53,.434,192,431,.445,74,93,.796,43,166,209,111,21,54,13,45,527,2012/2013
"Prince,Tayshaun",144,336,.429,15,41,.366,129,295,.437,22,37,.595,29,126,155,85,27,35,12,41,325,2012/2013
"Przybilla,Joel",1,4,.250,0,0,,1,4,.250,0,2,.000,5,16,21,4,1,4,2,10,2,2012/2013
"Quinn,Chris",4,16,.250,0,5,.000,4,11,.364,2,2,1.000,1,1,2,9,3,6,0,4,10,2012/2013
"Radmanović,Vladimir",13,43,.302,5,27,.185,8,16,.500,2,3,.667,10,18,28,8,8,7,4,29,33,2012/2013
"Randolph,Anthony",56,114,.491,0,8,.000,56,106,.528,31,45,.689,29,66,95,12,19,37,21,41,143,2012/2013
"Randolph,Shavlik",28,48,.583,0,0,,28,48,.583,11,27,.407,28,42,70,4,8,10,7,38,67,2012/2013
"Randolph,Zach",471,1024,.460,2,23,.087,469,1001,.469,225,300,.750,310,544,854,108,61,150,31,180,1169,2012/2013
"Redick,J.J.",382,880,.434,165,451,.366,217,429,.506,171,190,.900,17,154,171,296,38,138,9,117,1100,2012/2013
"Redick,J.J.",262,582,.450,117,300,.390,145,282,.514,115,129,.891,9,110,119,220,29,105,5,70,756,2012/2013
"Redick,J.J.",120,298,.403,48,151,.318,72,147,.490,56,61,.918,8,44,52,76,9,33,4,47,344,2012/2013
"Richardson,Jason",135,336,.402,57,167,.341,78,169,.462,20,33,.606,19,108,127,51,40,26,15,57,347,2012/2013
"Richardson,Quentin",1,11,.091,1,4,.250,0,7,.000,2,2,1.000,5,5,10,1,0,2,0,1,5,2012/2013
"Ridnour,Luke",367,811,.453,66,212,.311,301,599,.503,139,164,.848,41,165,206,311,82,130,15,187,939,2012/2013
"Rivers,Austin",145,390,.372,28,86,.326,117,304,.385,59,108,.546,16,93,109,127,26,74,9,122,377,2012/2013
"Roberts,Brian",213,511,.417,59,153,.386,154,358,.430,70,77,.909,17,80,97,219,37,71,3,108,555,2012/2013
"Robinson,Nate",399,921,.433,141,348,.405,258,573,.450,135,169,.799,29,155,184,358,85,144,10,207,1074,2012/2013
"Robinson,Thomas",138,321,.430,0,1,.000,138,320,.431,57,109,.523,122,193,315,46,41,88,26,124,333,2012/2013
"Robinson,Thomas",103,243,.424,0,0,,103,243,.424,41,71,.577,92,146,238,36,25,65,21,95,247,2012/2013
"Robinson,Thomas",35,78,.449,0,1,.000,35,77,.455,16,38,.421,30,47,77,10,16,23,5,29,86,2012/2013
"Rondo,Rajon",225,465,.484,12,50,.240,213,415,.513,60,93,.645,43,169,212,420,70,148,9,96,522,2012/2013
"Ross,Terrence",186,457,.407,65,196,.332,121,261,.464,30,42,.714,35,109,144,53,43,48,14,122,467,2012/2013
"Roy,Brandon",11,35,.314,0,9,.000,11,26,.423,7,10,.700,3,11,14,23,3,7,0,5,29,2012/2013
"Rubio,Ricky",185,514,.360,27,92,.293,158,422,.374,211,264,.799,44,185,229,418,137,172,5,143,608,2012/2013
"Rush,Brandon",6,9,.667,0,2,.000,6,7,.857,2,3,.667,0,1,1,2,0,3,0,5,14,2012/2013
"Sacre,Robert",18,48,.375,0,0,,18,48,.375,7,11,.636,9,25,34,6,0,10,10,38,43,2012/2013
"Salmons,John",244,612,.399,99,267,.371,145,345,.420,85,110,.773,33,174,207,226,51,85,25,143,672,2012/2013
"Samuels,Samardo",22,60,.367,0,1,.000,22,59,.373,14,24,.583,10,18,28,8,3,6,3,30,58,2012/2013
"Sanders,Larry",306,605,.506,0,2,.000,306,603,.507,84,136,.618,224,448,672,83,53,87,201,233,696,2012/2013
"Scola,Luis",432,915,.472,3,16,.188,429,899,.477,181,230,.787,158,383,541,182,67,126,35,257,1048,2012/2013
"Scott,Mike",70,147,.476,0,1,.000,70,146,.479,43,56,.768,39,71,110,12,4,21,2,32,183,2012/2013
"Sefolosha,Thabo",224,466,.481,108,258,.419,116,208,.558,57,69,.826,58,259,317,125,103,64,44,177,613,2012/2013
"Selby,Josh",6,22,.273,1,6,.167,5,16,.313,7,11,.636,0,5,5,4,2,7,0,7,20,2012/2013
"Séraphin,Kevin",330,716,.461,0,0,,330,716,.461,61,88,.693,107,239,346,57,24,130,59,211,721,2012/2013
"Sessions,Ramon",276,676,.408,33,107,.308,243,569,.427,291,347,.839,27,142,169,230,48,104,7,91,876,2012/2013
"Shengelia,Tornike",10,23,.435,1,2,.500,9,21,.429,9,16,.563,9,14,23,3,3,11,1,11,30,2012/2013
"Shumpert,Iman",109,275,.396,51,127,.402,58,148,.392,36,47,.766,31,105,136,75,43,37,7,99,305,2012/2013
"Shved,Alexey",236,635,.372,85,288,.295,151,347,.435,108,150,.720,41,134,175,286,54,147,27,117,665,2012/2013
"Sims,Henry",2,3,.667,0,0,,2,3,.667,0,0,,2,0,2,0,0,1,0,1,4,2012/2013
"Singler,Kyle",275,642,.428,70,200,.350,205,442,.464,100,124,.806,109,221,330,77,57,98,37,217,720,2012/2013
"Singleton,Chris",92,241,.382,7,36,.194,85,205,.415,40,70,.571,51,133,184,37,38,45,24,124,231,2012/2013
"Sloan,Donald",27,78,.346,7,19,.368,20,59,.339,20,25,.800,3,25,28,38,5,14,0,17,81,2012/2013
"Sloan,Donald",27,78,.346,7,19,.368,20,59,.339,20,25,.800,3,25,28,37,5,13,0,17,81,2012/2013
"Sloan,Donald",0,0,,0,0,,0,0,,0,0,,0,0,0,1,0,1,0,0,0,2012/2013
"Smith,Greg",170,274,.620,0,1,.000,170,273,.623,81,130,.623,111,210,321,25,18,41,40,175,421,2012/2013
"Smith,Ish",56,159,.352,8,27,.296,48,132,.364,3,7,.429,12,49,61,87,21,37,9,26,123,2012/2013
"Smith,Ish",39,116,.336,4,17,.235,35,99,.354,3,7,.429,11,35,46,57,13,27,6,14,85,2012/2013
"Smith,Ish",17,43,.395,4,10,.400,13,33,.394,0,0,,1,14,15,30,8,10,3,12,38,2012/2013
"Smith,J.R.",527,1249,.422,155,436,.356,372,813,.458,237,311,.762,64,361,425,218,100,134,24,226,1446,2012/2013
"Smith,Jason",167,341,.490,0,4,.000,167,337,.496,86,102,.843,64,122,186,34,15,55,45,123,420,2012/2013
"Smith,Josh",550,1182,.465,61,201,.303,489,981,.498,166,321,.517,133,506,639,321,94,226,136,175,1327,2012/2013
"Smith,Nolan",42,114,.368,6,28,.214,36,86,.419,20,28,.714,7,20,27,35,7,29,1,26,110,2012/2013
"Speights,Marreese",260,584,.445,3,10,.300,257,574,.448,135,175,.771,146,240,386,47,24,80,53,175,658,2012/2013
"Speights,Marreese",106,247,.429,2,5,.400,104,242,.430,48,67,.716,76,113,189,18,10,35,27,86,262,2012/2013
"Speights,Marreese",154,337,.457,1,5,.200,153,332,.461,87,108,.806,70,127,197,29,14,45,26,89,396,2012/2013
"Splitter,Tiago",315,563,.560,0,2,.000,315,561,.561,208,285,.730,144,371,515,130,63,100,64,161,838,2012/2013
"Stackhouse,Jerry",66,172,.384,30,89,.337,36,83,.434,20,23,.870,5,28,33,35,7,24,4,31,182,2012/2013
"Stephenson,Lance",275,598,.460,62,188,.330,213,410,.520,75,115,.652,47,257,304,223,81,109,16,162,687,2012/2013
"Stevenson,DeShawn",98,262,.374,76,209,.364,22,53,.415,12,23,.522,18,104,122,52,29,23,6,69,284,2012/2013
"Stiemsma,Greg",127,278,.457,0,0,,127,278,.457,53,69,.768,61,200,261,30,44,59,90,184,307,2012/2013
"Stone,Julyan",2,2,1.000,0,0,,2,2,1.000,3,4,.750,2,1,3,2,1,2,0,4,7,2012/2013
"Stoudemire,Amar'e",154,267,.577,0,0,,154,267,.577,105,130,.808,60,85,145,13,10,50,21,89,413,2012/2013
"Stuckey,Rodney",304,748,.406,55,182,.302,249,566,.440,213,272,.783,43,169,212,270,51,134,17,127,876,2012/2013
"Sullinger,Jared",111,225,.493,1,5,.200,110,220,.500,47,63,.746,92,172,264,35,22,29,22,154,270,2012/2013
"Summers,DaJuan",1,4,.250,0,0,,1,4,.250,0,0,,0,2,2,1,0,0,0,0,2,2012/2013
"Taylor,Jeffery",172,399,.431,53,154,.344,119,245,.486,75,103,.728,51,99,150,63,47,48,15,136,472,2012/2013
"Taylor,Tyshawn",32,87,.368,6,13,.462,26,74,.351,15,27,.556,2,16,18,21,13,25,0,25,85,2012/2013
"Teague,Jeff",439,974,.451,89,248,.359,350,726,.482,199,226,.881,25,155,180,579,117,230,28,181,1166,2012/2013
"Teague,Marquis",43,113,.381,4,23,.174,39,90,.433,9,16,.563,3,41,44,63,9,35,7,47,99,2012/2013
"Teletović,Mirza",71,185,.384,37,108,.343,34,77,.442,9,11,.818,33,62,95,23,13,20,8,53,188,2012/2013
"Telfair,Sebastian",112,309,.362,53,150,.353,59,159,.371,54,69,.783,13,71,84,153,37,64,11,104,331,2012/2013
"Telfair,Sebastian",94,247,.381,43,113,.381,51,134,.381,44,57,.772,12,56,68,114,28,53,10,84,275,2012/2013
"Telfair,Sebastian",18,62,.290,10,37,.270,8,25,.320,10,12,.833,1,15,16,39,9,11,1,20,56,2012/2013
"Temple,Garrett",105,258,.407,26,80,.325,79,178,.444,26,37,.703,29,94,123,115,50,61,17,94,262,2012/2013
"Terry,Jason",281,648,.434,123,331,.372,158,317,.498,114,131,.870,19,140,159,198,66,102,11,110,799,2012/2013
"Thabeet,Hasheem",64,106,.604,0,0,,64,106,.604,32,53,.604,69,126,195,11,30,41,60,148,160,2012/2013
"Thomas,Isaiah",366,832,.440,115,321,.358,251,511,.491,253,287,.882,29,132,161,316,67,140,3,167,1100,2012/2013
"Thomas,Kurt",45,83,.542,1,1,1.000,44,82,.537,6,13,.462,24,65,89,21,10,8,16,52,97,2012/2013
"Thomas,Lance",53,106,.500,0,0,,53,106,.500,43,59,.729,44,71,115,17,11,14,7,78,149,2012/2013
"Thomas,Malcolm",5,10,.500,0,0,,5,10,.500,5,8,.625,5,11,16,4,2,3,2,8,15,2012/2013
"Thomas,Malcolm",0,1,.000,0,0,,0,1,.000,3,4,.750,0,5,5,2,0,1,1,1,3,2012/2013
"Thomas,Malcolm",5,9,.556,0,0,,5,9,.556,2,4,.500,5,6,11,2,2,2,1,7,12,2012/2013
"Thomas,Tyrus",48,136,.353,3,8,.375,45,128,.352,26,31,.839,16,44,60,19,14,17,15,51,125,2012/2013
"Thompson,Jason",374,745,.502,0,3,.000,374,742,.504,143,206,.694,172,377,549,84,48,101,61,227,891,2012/2013
"Thompson,Klay",508,1205,.422,211,526,.401,297,679,.437,132,157,.841,32,274,306,183,86,157,45,237,1359,2012/2013
"Thompson,Tristan",390,799,.488,0,3,.000,390,796,.490,177,291,.608,306,467,773,108,60,123,71,234,957,2012/2013
"Thornton,Marcus",332,774,.429,141,379,.372,191,395,.484,111,126,.881,50,131,181,91,61,68,4,105,916,2012/2013
"Tinsley,Jamaal",86,234,.368,39,127,.307,47,107,.439,18,26,.692,17,98,115,290,64,106,14,106,229,2012/2013
"Tolliver,Anthony",82,216,.380,45,133,.338,37,83,.446,44,51,.863,31,124,155,32,15,36,12,66,253,2012/2013
"Tucker,P.J.",210,444,.473,22,70,.314,188,374,.503,64,86,.744,132,218,350,109,62,67,19,145,506,2012/2013
"Turiaf,Ronny",49,97,.505,0,0,,49,97,.505,23,63,.365,45,107,152,35,19,29,35,80,121,2012/2013
"Türkoğlu,Hedo",14,53,.264,1,24,.042,13,29,.448,3,6,.500,4,22,26,23,7,12,1,11,32,2012/2013
"Turner,Evan",441,1053,.419,58,159,.365,383,894,.428,154,208,.740,56,461,517,354,71,187,17,197,1094,2012/2013
"Tyler,Jeremy",9,24,.375,0,0,,9,24,.375,4,6,.667,6,14,20,1,1,6,2,10,22,2012/2013
"Tyler,Jeremy",9,24,.375,0,0,,9,24,.375,4,6,.667,6,11,17,1,1,6,2,10,22,2012/2013
"Tyler,Jeremy",0,0,,0,0,,0,0,,0,0,,0,3,3,0,0,0,0,0,0,2012/2013
"Udoh,Ekpe",117,269,.435,0,1,.000,117,268,.437,89,119,.748,113,138,251,43,39,43,85,139,323,2012/2013
"Udrih,Beno",210,476,.441,34,102,.333,176,374,.471,84,103,.816,34,107,141,302,41,108,3,90,538,2012/2013
"Udrih,Beno",113,238,.475,13,49,.265,100,189,.529,24,33,.727,17,61,78,138,16,53,2,39,263,2012/2013
"Udrih,Beno",97,238,.408,21,53,.396,76,185,.411,60,70,.857,17,46,63,164,25,55,1,51,275,2012/2013
"Valančiūnas,Jonas",204,366,.557,0,0,,204,366,.557,146,185,.789,121,251,372,45,17,94,78,188,554,2012/2013
"Varejão,Anderson",138,289,.478,0,5,.000,138,284,.486,77,102,.755,138,223,361,84,37,44,14,68,353,2012/2013
"Varnado,Jarvis",3,7,.429,0,0,,3,7,.429,2,4,.500,2,7,9,3,1,6,2,10,8,2012/2013
"Varnado,Jarvis",2,4,.500,0,0,,2,4,.500,2,4,.500,1,2,3,1,1,1,0,1,6,2012/2013
"Varnado,Jarvis",1,3,.333,0,0,,1,3,.333,0,0,,1,5,6,2,0,5,2,9,2,2012/2013
"Vásquez,Greivis",438,1012,.433,83,243,.342,355,769,.462,124,154,.805,43,294,337,704,66,247,6,190,1083,2012/2013
"Veselý,Jan",57,114,.500,0,1,.000,57,113,.504,12,39,.308,43,79,122,28,15,27,17,107,126,2012/2013
"Villanueva,Charlie",175,464,.377,90,259,.347,85,205,.415,27,49,.551,49,192,241,54,31,39,39,96,467,2012/2013
"Vučević,Nikola",461,889,.519,0,3,.000,461,886,.520,86,126,.683,273,644,917,143,61,141,79,218,1008,2012/2013
"Wade,Dwyane",569,1093,.521,17,66,.258,552,1027,.537,308,425,.725,86,258,344,352,128,194,56,140,1463,2012/2013
"Waiters,Dion",336,815,.412,63,203,.310,273,612,.446,159,213,.746,22,127,149,183,59,121,16,113,894,2012/2013
"Walker,Kemba",526,1244,.423,107,332,.322,419,912,.459,296,371,.798,60,223,283,471,160,200,31,153,1455,2012/2013
"Wall,John",324,735,.441,12,45,.267,312,690,.452,246,306,.804,35,161,196,373,65,157,37,117,906,2012/2013
"Wallace,Gerald",182,458,.397,46,163,.282,136,295,.461,121,190,.637,69,250,319,181,97,110,46,118,531,2012/2013
"Wallace,Rasheed",55,142,.387,22,69,.319,33,73,.452,14,20,.700,11,72,83,6,13,10,15,40,146,2012/2013
"Walton,Luke",71,181,.392,20,67,.299,51,114,.447,10,20,.500,38,107,145,166,42,60,13,98,172,2012/2013
"Warrick,Hakim",67,165,.406,0,3,.000,67,162,.414,60,88,.682,21,68,89,25,13,29,6,37,194,2012/2013
"Warrick,Hakim",1,2,.500,0,0,,1,2,.500,2,2,1.000,0,0,0,0,1,0,0,0,4,2012/2013
"Warrick,Hakim",66,163,.405,0,3,.000,66,160,.413,58,86,.674,21,68,89,25,12,29,6,37,190,2012/2013
"Watson,C.J.",192,459,.418,88,214,.411,104,245,.424,71,91,.780,38,107,145,161,66,69,12,123,543,2012/2013
"Watson,Earl",37,120,.308,5,28,.179,32,92,.348,17,25,.680,23,64,87,190,40,69,8,94,96,2012/2013
"Wayns,Maalik",26,88,.295,7,31,.226,19,57,.333,17,19,.895,1,6,7,27,6,15,0,26,76,2012/2013
"Wayns,Maalik",19,72,.264,5,25,.200,14,47,.298,13,15,.867,1,4,5,20,3,13,0,18,56,2012/2013
"Wayns,Maalik",7,16,.438,2,6,.333,5,10,.500,4,4,1.000,0,2,2,7,3,2,0,8,20,2012/2013
"Webster,Martell",281,636,.442,139,329,.422,142,307,.463,168,198,.848,53,241,294,143,49,90,17,166,869,2012/2013
"West,David",502,1009,.498,4,19,.211,498,990,.503,242,315,.768,145,418,563,213,74,157,69,149,1250,2012/2013
"Westbrook,Russell",673,1535,.438,97,300,.323,576,1235,.466,460,575,.800,111,317,428,607,145,273,24,189,1903,2012/2013
"White,D.J.",12,23,.522,0,0,,12,23,.522,5,9,.556,4,9,13,4,1,2,6,5,29,2012/2013
"White,James",50,116,.431,14,41,.341,36,75,.480,11,19,.579,5,43,48,29,13,17,4,44,125,2012/2013
"Wilcox,Chris",110,153,.719,0,1,.000,110,152,.724,39,58,.672,55,125,180,22,32,34,28,125,259,2012/2013
"Wilkins,Damien",145,316,.459,17,51,.333,128,265,.483,81,109,.743,32,73,105,91,37,49,18,98,388,2012/2013
"Williams,Deron",495,1124,.440,169,447,.378,326,677,.482,317,369,.859,29,203,232,604,75,218,30,194,1476,2012/2013
"Williams,Derrick",338,786,.430,65,196,.332,273,590,.463,192,272,.706,96,334,430,46,44,101,37,127,933,2012/2013
"Williams,Lou",187,443,.422,72,196,.367,115,247,.466,105,121,.868,8,72,80,139,44,74,10,55,551,2012/2013
"Williams,Marvin",199,470,.423,54,166,.325,145,304,.477,77,99,.778,55,208,263,77,37,60,38,98,529,2012/2013
"Williams,Mo",229,533,.430,59,154,.383,170,379,.449,75,85,.882,24,86,110,285,46,125,9,105,592,2012/2013
"Williams,Reggie",57,132,.432,22,72,.306,35,60,.583,10,21,.476,8,43,51,39,12,19,1,19,146,2012/2013
"Williams,Terrence",48,97,.495,5,15,.333,43,82,.524,9,21,.429,4,40,44,38,11,22,2,13,110,2012/2013
"World Peace,Metta",332,824,.403,141,412,.342,191,412,.464,124,169,.734,101,271,372,112,122,98,42,198,929,2012/2013
"Wright,Brandan",241,404,.597,0,3,.000,241,401,.601,59,96,.615,85,175,260,38,26,34,76,78,541,2012/2013
"Wright,Chris",1,2,.500,0,0,,1,2,.500,0,0,,0,0,0,0,0,1,0,0,2,2012/2013
"Wright,Dorell",237,599,.396,135,361,.374,102,238,.429,120,141,.851,42,260,302,150,62,64,35,98,729,2012/2013
"Wroten,Tony",33,86,.384,4,16,.250,29,70,.414,21,29,.724,13,15,28,43,8,29,4,34,91,2012/2013
"Young,Nick",224,542,.413,75,210,.357,149,332,.449,105,128,.820,24,106,130,84,36,50,14,84,628,2012/2013
"Young,Sam",58,148,.392,16,52,.308,42,96,.438,23,43,.535,26,97,123,42,15,33,8,62,155,2012/2013
"Young,Thaddeus",509,958,.531,1,8,.125,508,950,.535,108,188,.574,182,389,571,125,133,90,55,191,1127,2012/2013
"Zeller,Luke",9,26,.346,1,5,.200,8,21,.381,0,0,,1,9,10,3,0,0,0,5,19,2012/2013
"Zeller,Tyler",245,559,.438,0,4,.000,245,555,.441,120,157,.764,159,279,438,96,35,95,70,251,610,2012/2013
"Acy,Quincy",66,141,.468,4,15,.267,62,126,.492,35,53,.660,72,144,216,28,23,30,26,122,171,2013/2014
"Acy,Quincy",6,14,.429,2,5,.400,4,9,.444,5,8,.625,5,10,15,4,4,2,3,8,19,2013/2014
"Acy,Quincy",60,127,.472,2,10,.200,58,117,.496,30,45,.667,67,134,201,24,19,28,23,114,152,2013/2014
"Adams,Steven",93,185,.503,0,0,,93,185,.503,79,136,.581,142,190,332,43,40,71,57,203,265,2013/2014
"Adrien,Jeff",143,275,.520,0,0,,143,275,.520,76,119,.639,102,204,306,38,24,39,36,108,362,2013/2014
"Adrien,Jeff",22,40,.550,0,0,,22,40,.550,13,25,.520,33,55,88,7,7,8,15,35,57,2013/2014
"Adrien,Jeff",121,235,.515,0,0,,121,235,.515,63,94,.670,69,149,218,31,17,31,21,73,305,2013/2014
"Afflalo,Arron",464,1011,.459,128,300,.427,336,711,.473,274,336,.815,32,230,262,248,35,146,3,136,1330,2013/2014
"Ajinça,Alexis",136,249,.546,0,1,.000,136,248,.548,56,67,.836,94,183,277,40,23,63,46,187,328,2013/2014
"Aldrich,Cole",33,61,.541,0,0,,33,61,.541,26,30,.867,37,92,129,14,8,18,30,40,92,2013/2014
"Aldridge,LaMarcus",652,1423,.458,3,15,.200,649,1408,.461,296,360,.822,166,599,765,178,63,123,68,147,1603,2013/2014
"Allen,Lavoy",134,300,.447,2,13,.154,132,287,.460,33,50,.660,119,192,311,71,24,44,33,126,303,2013/2014
"Allen,Lavoy",117,266,.440,2,13,.154,115,253,.455,27,40,.675,106,171,277,65,22,40,27,115,263,2013/2014
"Allen,Lavoy",17,34,.500,0,0,,17,34,.500,6,10,.600,13,21,34,6,2,4,6,11,40,2013/2014
"Allen,Ray",240,543,.442,116,309,.375,124,234,.530,105,116,.905,23,182,205,143,54,84,8,115,701,2013/2014
"Allen,Tony",204,413,.494,11,47,.234,193,366,.527,76,121,.628,79,129,208,94,90,90,19,121,495,2013/2014
"Aminu,Al-Farouq",234,494,.474,13,48,.271,221,446,.496,91,137,.664,129,367,496,114,82,88,38,147,572,2013/2014
"Amundson,Lou",16,32,.500,0,0,,16,32,.500,6,24,.250,28,27,55,6,9,14,11,49,38,2013/2014
"Amundson,Lou",16,32,.500,0,0,,16,32,.500,6,24,.250,28,27,55,6,9,14,11,49,38,2013/2014
"Amundson,Lou",0,0,,0,0,,0,0,,0,0,,0,0,0,0,0,0,0,0,0,2013/2014
"Andersen,Chris",177,275,.644,3,12,.250,174,263,.662,120,169,.710,129,250,379,19,32,53,97,162,477,2013/2014
"Anderson,Alan",194,485,.400,84,248,.339,110,237,.464,92,118,.780,40,135,175,81,48,62,11,147,564,2013/2014
"Anderson,James",309,717,.431,115,351,.328,194,366,.530,77,106,.726,59,241,300,149,74,106,28,154,810,2013/2014
"Anderson,Ryan",155,354,.438,67,164,.409,88,190,.463,59,62,.952,66,76,142,17,10,20,7,47,436,2013/2014
"Antetokounmpo,Giannis",173,418,.414,41,118,.347,132,300,.440,138,202,.683,78,261,339,150,60,122,61,173,525,2013/2014
"Anthony,Carmelo",743,1643,.452,167,415,.402,576,1228,.469,459,541,.848,145,477,622,242,95,198,51,224,2112,2013/2014
"Anthony,Joel",12,32,.375,0,0,,12,32,.375,4,8,.500,15,23,38,2,3,3,12,17,28,2013/2014
"Anthony,Joel",2,6,.333,0,0,,2,6,.333,2,2,1.000,2,5,7,0,0,1,4,4,6,2013/2014
"Anthony,Joel",10,26,.385,0,0,,10,26,.385,2,6,.333,13,18,31,2,3,2,8,13,22,2013/2014
"Antić,Pero",123,294,.418,56,171,.327,67,123,.545,50,66,.758,57,152,209,58,19,55,12,126,352,2013/2014
"Ariza,Trevor",389,853,.456,180,442,.407,209,411,.509,149,193,.772,99,376,475,191,126,132,20,179,1107,2013/2014
"Armstrong,Hilton",9,19,.474,0,0,,9,19,.474,7,16,.438,19,28,47,5,4,6,4,11,25,2013/2014
"Arthur,Darrell",162,410,.395,24,64,.375,138,346,.399,53,62,.855,52,158,210,61,39,58,47,185,401,2013/2014
"Aşık,Ömer",101,190,.532,0,0,,101,190,.532,78,126,.619,101,277,378,25,14,59,37,92,280,2013/2014
"Augustin,D.J.",298,718,.415,133,332,.401,165,386,.427,201,227,.885,15,115,130,313,53,125,3,147,930,2013/2014
"Augustin,D.J.",7,24,.292,1,11,.091,6,13,.462,6,6,1.000,0,4,4,10,1,9,0,7,21,2013/2014
"Augustin,D.J.",291,694,.419,132,321,.411,159,373,.426,195,221,.882,15,111,126,303,52,116,3,140,909,2013/2014
"Ayón,Gustavo",52,102,.510,0,0,,52,102,.510,8,20,.400,42,83,125,28,25,29,10,47,112,2013/2014
"Ayres,Jeff",101,174,.580,0,0,,101,174,.580,38,55,.691,89,169,258,60,13,63,25,146,240,2013/2014
"Babb,Chris",8,30,.267,6,27,.222,2,3,.667,0,0,,4,13,17,3,6,3,0,13,22,2013/2014
"Babbitt,Luke",60,154,.390,36,95,.379,24,59,.407,14,18,.778,18,70,88,29,7,15,11,52,170,2013/2014
"Barbosa,Leandro",56,131,.427,7,25,.280,49,106,.462,31,39,.795,5,32,37,32,7,19,4,30,150,2013/2014
"Barea,J.J.",254,656,.387,73,231,.316,181,425,.426,79,100,.790,16,138,154,303,26,125,0,129,660,2013/2014
"Bargnani,Andrea",222,502,.442,30,108,.278,192,394,.487,84,102,.824,69,153,222,45,14,58,52,100,558,2013/2014
"Barnes,Harrison",271,679,.399,66,190,.347,205,489,.419,130,181,.718,66,245,311,116,65,84,20,158,738,2013/2014
"Barnes,Matt",231,527,.438,97,283,.343,134,244,.549,66,90,.733,60,232,292,125,56,85,28,185,625,2013/2014
"Barton,Will",65,156,.417,10,33,.303,55,123,.447,26,32,.813,16,58,74,33,9,18,7,31,166,2013/2014
"Bass,Brandon",352,725,.486,2,6,.333,350,719,.487,205,239,.858,161,309,470,87,36,102,71,190,911,2013/2014
"Battier,Shane",105,275,.382,73,210,.348,32,65,.492,15,23,.652,34,104,138,63,50,21,39,124,298,2013/2014
"Batum,Nicolas",381,819,.465,145,402,.361,236,417,.566,163,203,.803,116,495,611,420,75,208,57,156,1070,2013/2014
"Bayless,Jerryd",248,617,.402,76,212,.358,172,405,.425,94,118,.797,22,123,145,194,60,82,9,161,666,2013/2014
"Bayless,Jerryd",90,239,.377,25,83,.301,65,156,.417,45,57,.789,8,51,59,66,20,22,5,72,250,2013/2014
"Bayless,Jerryd",158,378,.418,51,129,.395,107,249,.430,49,61,.803,14,72,86,128,40,60,4,89,416,2013/2014
"Baynes,Aron",71,163,.436,0,0,,71,163,.436,19,21,.905,57,88,145,34,2,36,5,77,161,2013/2014
"Bazemore,Kent",147,343,.429,43,128,.336,104,215,.484,66,109,.606,10,107,117,91,43,79,13,102,403,2013/2014
"Bazemore,Kent",36,97,.371,10,39,.256,26,58,.448,19,36,.528,5,35,40,20,12,28,6,42,101,2013/2014
"Bazemore,Kent",111,246,.451,33,89,.371,78,157,.497,47,73,.644,5,72,77,71,31,51,7,60,302,2013/2014
"Beal,Bradley",481,1149,.419,138,343,.402,343,806,.426,149,189,.788,54,219,273,243,71,128,18,153,1249,2013/2014
"Beasley,Michael",177,355,.499,21,54,.389,156,301,.518,61,79,.772,31,141,172,42,23,57,21,93,436,2013/2014
"Belinelli,Marco",337,695,.485,126,293,.430,211,402,.525,111,131,.847,18,208,226,179,50,95,7,130,911,2013/2014
"Bennett,Anthony",80,225,.356,13,53,.245,67,172,.390,44,69,.638,49,106,155,17,21,47,8,93,217,2013/2014
"Beverley,Patrick",199,481,.414,92,255,.361,107,226,.473,83,102,.814,72,124,196,151,77,66,23,174,573,2013/2014
"Biedriņš,Andris",1,1,1.000,0,0,,1,1,1.000,1,6,.167,2,15,17,0,0,2,0,6,3,2013/2014
"Billups,Chauncey",24,79,.304,14,48,.292,10,31,.323,10,12,.833,4,24,28,42,8,25,1,25,72,2013/2014
"Biyombo,Bismack",88,144,.611,0,0,,88,144,.611,46,89,.517,105,261,366,8,7,40,86,124,222,2013/2014
"Blair,DeJuan",210,393,.534,0,2,.000,210,391,.537,77,121,.636,139,229,368,70,60,77,21,192,497,2013/2014
"Blake,Steve",133,353,.377,79,210,.376,54,143,.378,33,43,.767,13,146,159,307,54,102,8,85,378,2013/2014
"Blake,Steve",88,233,.378,52,131,.397,36,102,.353,28,35,.800,8,95,103,205,34,71,2,49,256,2013/2014
"Blake,Steve",45,120,.375,27,79,.342,18,41,.439,5,8,.625,5,51,56,102,20,31,6,36,122,2013/2014
"Blatche,Andray",321,674,.476,15,54,.278,306,620,.494,164,221,.742,120,270,390,112,75,110,38,166,821,2013/2014
"Bledsoe,Eric",265,556,.477,50,140,.357,215,416,.517,183,237,.772,27,175,202,235,69,143,14,99,763,2013/2014
"Blue,Vander",2,4,.500,0,1,.000,2,3,.667,1,5,.200,0,3,3,1,0,2,0,1,5,2013/2014
"Bogans,Keith",3,6,.500,3,6,.500,0,0,,3,3,1.000,0,3,3,3,1,1,0,2,12,2013/2014
"Bogut,Andrew",235,375,.627,0,0,,235,375,.627,22,64,.344,182,489,671,112,47,97,121,210,492,2013/2014
"Bonner,Matt",73,164,.445,42,98,.429,31,66,.470,9,12,.750,16,114,130,31,15,16,11,49,197,2013/2014
"Booker,Trevor",222,403,.551,0,2,.000,222,401,.554,47,76,.618,149,230,379,64,41,58,45,131,491,2013/2014
"Boozer,Carlos",447,980,.456,0,2,.000,447,978,.457,148,193,.767,137,495,632,118,53,154,22,216,1042,2013/2014
"Bosh,Chris",492,953,.516,74,218,.339,418,735,.569,223,272,.820,98,424,522,87,80,125,78,192,1281,2013/2014
"Bradley,Avery",361,825,.438,79,200,.395,282,625,.451,90,112,.804,48,178,226,85,63,96,11,145,891,2013/2014
"Brand,Elton",179,332,.539,0,2,.000,179,330,.542,61,94,.649,97,264,361,74,40,60,88,192,419,2013/2014
"Brewer,Corey",388,807,.481,59,211,.280,329,596,.552,163,227,.718,63,144,207,135,151,105,30,210,998,2013/2014
"Brewer,Ronnie",3,15,.200,1,8,.125,2,7,.286,0,2,.000,2,12,14,10,6,2,1,4,7,2013/2014
"Brewer,Ronnie",3,15,.200,1,8,.125,2,7,.286,0,2,.000,2,12,14,10,6,2,1,4,7,2013/2014
"Brewer,Ronnie",0,0,,0,0,,0,0,,0,0,,0,0,0,0,0,0,0,0,0,2013/2014
"Brooks,Aaron",233,581,.401,96,248,.387,137,333,.411,83,95,.874,43,97,140,233,52,117,13,146,645,2013/2014
"Brooks,Aaron",104,263,.395,54,132,.409,50,131,.382,37,44,.841,23,39,62,83,25,51,6,76,299,2013/2014
"Brooks,Aaron",129,318,.406,42,116,.362,87,202,.431,46,51,.902,20,58,78,150,27,66,7,70,346,2013/2014
"Brooks,MarShon",57,125,.456,13,25,.520,44,100,.440,32,44,.727,10,44,54,25,14,24,4,21,159,2013/2014
"Brooks,MarShon",9,24,.375,2,4,.500,7,20,.350,11,14,.786,1,18,19,4,1,7,1,5,31,2013/2014
"Brooks,MarShon",5,13,.385,0,2,.000,5,11,.455,3,4,.750,1,4,5,0,1,0,0,0,13,2013/2014
"Brooks,MarShon",43,88,.489,11,19,.579,32,69,.464,18,26,.692,8,22,30,21,12,17,3,16,115,2013/2014
"Brown,Lorenzo",26,86,.302,3,30,.100,23,56,.411,9,13,.692,8,20,28,41,13,16,3,19,64,2013/2014
"Brown,Shannon",24,66,.364,0,2,.000,24,64,.375,15,21,.714,7,21,28,9,13,18,0,24,63,2013/2014
"Brown,Shannon",8,28,.286,0,2,.000,8,26,.308,7,9,.778,1,12,13,5,1,8,0,12,23,2013/2014
"Brown,Shannon",16,38,.421,0,0,,16,38,.421,8,12,.667,6,9,15,4,12,10,0,12,40,2013/2014
"Bryant,Kobe",31,73,.425,3,16,.188,28,57,.491,18,21,.857,2,24,26,38,7,34,1,9,83,2013/2014
"Budinger,Chase",100,254,.394,42,120,.350,58,134,.433,32,39,.821,19,84,103,31,19,24,2,58,274,2013/2014
"Bullock,Reggie",43,121,.355,22,73,.301,21,48,.438,7,9,.778,11,43,54,12,9,13,1,26,115,2013/2014
"Burke,Trey",341,897,.380,111,336,.330,230,561,.410,102,113,.903,37,171,208,396,42,131,6,145,895,2013/2014
"Burks,Alec",380,831,.457,50,143,.350,330,688,.480,279,373,.748,59,198,257,212,69,149,14,190,1089,2013/2014
"Butler,Caron",213,540,.394,98,249,.394,115,291,.395,63,75,.840,21,208,229,82,47,60,17,120,587,2013/2014
"Butler,Caron",137,354,.387,53,147,.361,84,207,.406,47,56,.839,16,142,158,56,23,52,11,64,374,2013/2014
"Butler,Caron",76,186,.409,45,102,.441,31,84,.369,16,19,.842,5,66,71,26,24,8,6,56,213,2013/2014
"Butler,Jimmy",275,693,.397,68,240,.283,207,453,.457,260,338,.769,87,243,330,175,127,102,36,106,878,2013/2014
"Butler,Rasual",51,110,.464,26,62,.419,25,48,.521,8,14,.571,6,35,41,17,7,11,9,30,136,2013/2014
"Buycks,Dwight",15,48,.313,5,17,.294,10,31,.323,8,9,.889,4,19,23,10,8,10,0,11,43,2013/2014
"Bynum,Andrew",94,225,.418,0,0,,94,225,.418,37,49,.755,53,92,145,29,6,34,29,31,225,2013/2014
"Bynum,Andrew",85,203,.419,0,0,,85,203,.419,32,42,.762,47,79,126,27,6,30,28,28,202,2013/2014
"Bynum,Andrew",9,22,.409,0,0,,9,22,.409,5,7,.714,6,13,19,2,0,4,1,3,23,2013/2014
"Bynum,Will",184,430,.428,20,62,.323,164,368,.446,97,121,.802,24,75,99,216,39,103,7,121,485,2013/2014
"Calathes,Nick",142,311,.457,19,61,.311,123,250,.492,44,72,.611,23,114,137,207,66,101,8,117,347,2013/2014
"Calderón,José",341,748,.456,191,425,.449,150,323,.464,52,63,.825,29,163,192,377,69,103,11,136,925,2013/2014
"Caldwell-Pope,Kentavious",182,460,.396,59,185,.319,123,275,.447,47,61,.770,38,118,156,55,75,28,12,145,470,2013/2014
"Canaan,Isaiah",31,87,.356,18,55,.327,13,32,.406,21,29,.724,7,17,24,22,8,21,4,25,101,2013/2014
"Carroll,DeMarre",302,642,.470,97,268,.362,205,374,.548,109,141,.773,107,296,403,134,108,79,21,188,810,2013/2014
"Carter,Vince",330,811,.407,146,371,.394,184,440,.418,161,196,.821,67,217,284,212,61,108,35,209,967,2013/2014
"Carter-Williams,Michael",427,1054,.405,55,208,.264,372,846,.440,258,367,.703,101,336,437,441,130,247,43,213,1167,2013/2014
"Casspi,Omri",173,410,.422,61,176,.347,112,234,.479,83,122,.680,55,205,260,88,44,72,14,100,490,2013/2014
"Chalmers,Mario",254,560,.454,87,226,.385,167,334,.500,121,163,.742,41,173,214,357,119,162,16,210,716,2013/2014
"Chandler,Tyson",191,322,.593,0,1,.000,191,321,.595,98,155,.632,159,370,529,59,36,71,63,145,480,2013/2014
"Chandler,Wilson",307,738,.416,122,351,.348,185,387,.478,110,152,.724,58,236,294,114,46,79,31,193,846,2013/2014
"Childress,Josh",0,0,,0,0,,0,0,,0,0,,0,3,3,2,1,1,0,1,0,2013/2014
"Christmas,Dionte",22,62,.355,9,31,.290,13,31,.419,18,24,.750,13,25,38,8,2,6,3,19,71,2013/2014
"Clark,Earl",97,261,.372,41,122,.336,56,139,.403,22,34,.647,22,121,143,18,17,31,25,67,257,2013/2014
"Clark,Earl",90,240,.375,40,116,.345,50,124,.403,14,24,.583,20,107,127,16,16,30,19,61,234,2013/2014
"Clark,Earl",7,21,.333,1,6,.167,6,15,.400,8,10,.800,2,14,16,2,1,1,6,6,23,2013/2014
"Clark,Ian",26,67,.388,11,31,.355,15,36,.417,5,7,.714,3,16,19,15,8,14,2,24,68,2013/2014
"Claver,Victor",17,42,.405,3,18,.167,14,24,.583,10,11,.909,9,30,39,12,3,11,3,16,47,2013/2014
"Cole,Norris",207,500,.414,60,174,.345,147,326,.451,53,68,.779,17,143,160,248,77,127,5,156,527,2013/2014
"Collins,Jason",11,24,.458,0,3,.000,11,21,.524,3,4,.750,7,12,19,4,8,7,1,30,25,2013/2014
"Collison,Darren",324,694,.467,71,189,.376,253,505,.501,192,224,.857,47,141,188,297,93,132,15,150,911,2013/2014
"Collison,Nick",134,241,.556,4,17,.235,130,224,.580,66,93,.710,116,177,293,104,30,71,28,187,338,2013/2014
"Conley,Mike",463,1030,.450,105,291,.361,358,739,.484,225,276,.815,41,172,213,441,110,150,13,141,1256,2013/2014
"Copeland,Chris",55,117,.470,33,79,.418,22,38,.579,10,14,.714,7,25,32,18,3,14,7,38,153,2013/2014
"Cousins,DeMarcus",591,1191,.496,0,7,.000,591,1184,.499,432,595,.726,218,613,831,207,109,251,91,270,1614,2013/2014
"Covington,Robert",6,14,.429,4,11,.364,2,3,.667,0,0,,2,3,5,0,2,1,0,3,16,2013/2014
"Crabbe,Allen",12,33,.364,6,14,.429,6,19,.316,3,4,.750,1,8,9,6,2,3,1,10,33,2013/2014
"Crawford,Jamal",421,1011,.416,161,446,.361,260,565,.460,279,322,.866,34,124,158,223,59,135,12,120,1282,2013/2014
"Crawford,Jordan",327,788,.415,90,285,.316,237,503,.471,146,169,.864,28,155,183,281,47,134,5,120,890,2013/2014
"Crawford,Jordan",188,455,.413,50,157,.318,138,298,.463,110,126,.873,18,102,120,224,34,84,3,76,536,2013/2014
"Crawford,Jordan",139,333,.417,40,128,.313,99,205,.483,36,43,.837,10,53,63,57,13,50,2,44,354,2013/2014
"Crowder,Jae",130,296,.439,50,151,.331,80,145,.552,46,61,.754,46,148,194,60,59,41,21,100,356,2013/2014
"Cunningham,Dante",236,509,.464,0,5,.000,236,504,.468,38,67,.567,112,218,330,83,62,42,58,146,510,2013/2014
"Cunningham,Jared",6,21,.286,1,7,.143,5,14,.357,13,16,.813,1,5,6,8,3,2,0,16,26,2013/2014
"Cunningham,Jared",1,2,.500,0,1,.000,1,1,1.000,0,2,.000,0,1,1,3,0,2,0,3,2,2013/2014
"Cunningham,Jared",5,19,.263,1,6,.167,4,13,.308,13,14,.929,1,4,5,5,3,0,0,13,24,2013/2014
"Curry,Seth",1,3,.333,1,1,1.000,0,2,.000,0,0,,0,1,1,0,2,0,0,0,3,2013/2014
"Curry,Seth",0,0,,0,0,,0,0,,0,0,,0,0,0,0,0,0,0,0,0,2013/2014
"Curry,Seth",1,3,.333,1,1,1.000,0,2,.000,0,0,,0,1,1,0,2,0,0,0,3,2013/2014
"Curry,Stephen",652,1383,.471,261,615,.424,391,768,.509,308,348,.885,46,288,334,666,128,294,14,194,1873,2013/2014
"Dalembert,Samuel",214,377,.568,0,1,.000,214,376,.569,101,137,.737,200,341,541,38,41,90,94,210,529,2013/2014
"Daniels,Troy",15,31,.484,12,25,.480,3,6,.500,0,0,,0,4,4,5,0,3,0,6,42,2013/2014
"Datome,Luigi",34,97,.351,7,39,.179,27,58,.466,8,10,.800,14,32,46,11,6,11,1,20,83,2013/2014
"Davies,Brandon",54,128,.422,2,10,.200,52,118,.441,34,53,.642,38,71,109,28,24,35,8,92,144,2013/2014
"Davis,Anthony",522,1005,.519,2,9,.222,520,996,.522,348,440,.791,207,466,673,105,89,109,189,200,1394,2013/2014
"Davis,Ed",155,290,.534,0,0,,155,290,.534,47,89,.528,92,168,260,27,17,40,43,114,357,2013/2014
"Davis,Glen",271,593,.457,4,11,.364,267,582,.459,95,137,.693,108,243,351,77,58,76,29,159,641,2013/2014
"Davis,Glen",232,512,.453,4,10,.400,228,502,.454,77,114,.675,87,195,282,70,46,59,22,111,545,2013/2014
"Davis,Glen",39,81,.481,0,1,.000,39,80,.488,18,23,.783,21,48,69,7,12,17,7,48,96,2013/2014
"Daye,Austin",24,68,.353,12,37,.324,12,31,.387,6,10,.600,5,22,27,8,4,5,4,18,66,2013/2014
"Daye,Austin",3,13,.231,0,8,.000,3,5,.600,2,3,.667,2,5,7,2,0,0,0,4,8,2013/2014
"Daye,Austin",21,55,.382,12,29,.414,9,26,.346,4,7,.571,3,17,20,6,4,5,4,14,58,2013/2014
"De Colo,Nando",64,153,.418,18,53,.340,46,100,.460,31,35,.886,14,59,73,65,22,35,6,48,177,2013/2014
"De Colo,Nando",42,93,.452,10,31,.323,32,62,.516,18,22,.818,6,39,45,32,15,21,3,25,112,2013/2014
"De Colo,Nando",22,60,.367,8,22,.364,14,38,.368,13,13,1.000,8,20,28,33,7,14,3,23,65,2013/2014
"Dedmon,Dewayne",38,83,.458,0,0,,38,83,.458,21,32,.656,38,89,127,5,7,18,22,66,97,2013/2014
"Dedmon,Dewayne",0,1,.000,0,0,,0,1,.000,1,2,.500,0,0,0,0,0,0,0,1,1,2013/2014
"Dedmon,Dewayne",15,29,.517,0,0,,15,29,.517,7,13,.538,11,38,49,3,0,9,9,28,37,2013/2014
"Dedmon,Dewayne",23,53,.434,0,0,,23,53,.434,13,17,.765,27,51,78,2,7,9,13,37,59,2013/2014
"Dellavedova,Matthew",122,296,.412,57,155,.368,65,141,.461,38,48,.792,29,94,123,187,33,60,5,121,339,2013/2014
"Deng,Luol",371,860,.431,57,189,.302,314,671,.468,212,268,.791,99,262,361,183,62,114,9,111,1011,2013/2014
"Deng,Luol",160,354,.452,17,62,.274,143,292,.490,101,124,.815,40,118,158,85,24,59,4,53,438,2013/2014
"Deng,Luol",211,506,.417,40,127,.315,171,379,.451,111,144,.771,59,144,203,98,38,55,5,58,573,2013/2014
"DeRozan,DeMar",604,1407,.429,64,210,.305,540,1197,.451,519,630,.824,51,292,343,313,86,176,28,197,1791,2013/2014
"Diaw,Boris",302,580,.521,45,112,.402,257,468,.549,68,92,.739,74,252,326,222,44,121,32,140,717,2013/2014
"Dieng,Gorgui",113,227,.498,1,1,1.000,112,226,.496,59,93,.634,103,197,300,39,30,54,50,108,286,2013/2014
"Douglas,Toney",73,190,.384,31,102,.304,42,88,.477,25,34,.735,18,69,87,68,19,34,5,81,202,2013/2014
"Douglas,Toney",32,86,.372,19,59,.322,13,27,.481,5,8,.625,4,22,26,19,6,16,2,34,88,2013/2014
"Douglas,Toney",41,104,.394,12,43,.279,29,61,.475,20,26,.769,14,47,61,49,13,18,3,47,114,2013/2014
"Douglas-Roberts,Chris",111,252,.440,51,132,.386,60,120,.500,66,82,.805,16,103,119,51,29,36,16,61,339,2013/2014
"Dragić,Goran",552,1093,.505,122,299,.408,430,794,.542,316,416,.760,69,176,245,447,104,213,22,206,1542,2013/2014
"Drummond,Andre",479,769,.623,0,2,.000,479,767,.625,137,328,.418,440,631,1071,35,101,110,131,273,1095,2013/2014
"Dudley,Jared",196,447,.438,81,225,.360,115,222,.518,38,58,.655,36,124,160,104,41,56,10,146,511,2013/2014
"Duncan,Tim",444,906,.490,0,5,.000,444,901,.493,231,316,.731,158,563,721,220,43,159,139,134,1119,2013/2014
"Dunleavy,Mike",333,774,.430,123,324,.380,210,450,.467,140,164,.854,46,299,345,186,64,108,46,163,929,2013/2014
"Durant,Kevin",849,1688,.503,192,491,.391,657,1197,.549,703,805,.873,58,540,598,445,103,285,59,174,2593,2013/2014
"Edwards,Shane",1,3,.333,0,0,,1,3,.333,0,0,,1,1,2,0,0,1,0,1,2,2013/2014
"Ellington,Wayne",55,126,.437,25,59,.424,30,67,.448,10,11,.909,8,35,43,19,16,11,2,33,145,2013/2014
"Ellis,Monta",576,1278,.451,69,209,.330,507,1069,.474,339,430,.788,38,257,295,471,141,264,23,197,1560,2013/2014
"Ely,Melvin",3,6,.500,0,0,,3,6,.500,0,0,,0,1,1,0,0,0,1,5,6,2013/2014
"Evans,Jeremy",175,332,.527,0,2,.000,175,330,.530,51,75,.680,120,190,310,44,42,40,46,139,401,2013/2014
"Evans,Reggie",71,150,.473,0,0,,71,150,.473,72,130,.554,115,219,334,21,37,58,3,119,214,2013/2014
"Evans,Reggie",23,59,.390,0,0,,23,59,.390,35,65,.538,53,96,149,5,13,28,2,54,81,2013/2014
"Evans,Reggie",48,91,.527,0,0,,48,91,.527,37,65,.569,62,123,185,16,24,30,1,65,133,2013/2014
"Evans,Tyreke",391,897,.436,21,95,.221,370,802,.461,239,310,.771,76,265,341,363,84,175,21,155,1042,2013/2014
"Faried,Kenneth",447,820,.545,0,3,.000,447,817,.547,202,311,.650,238,446,684,96,70,135,69,193,1096,2013/2014
"Farmar,Jordan",151,364,.415,70,160,.438,81,204,.397,44,59,.746,20,84,104,199,38,95,8,65,416,2013/2014
"Faverani,Vítor",64,147,.435,12,40,.300,52,107,.486,24,37,.649,42,86,128,16,14,41,27,74,164,2013/2014
"Favors,Derrick",390,747,.522,0,1,.000,390,746,.523,190,284,.669,199,438,637,91,75,129,108,236,970,2013/2014
"Felix,Carrick",7,14,.500,2,5,.400,5,9,.556,3,4,.750,1,5,6,4,0,4,0,4,19,2013/2014
"Felton,Raymond",240,608,.395,62,195,.318,178,413,.431,88,122,.721,54,143,197,365,78,129,27,157,630,2013/2014
"Fields,Landry",27,67,.403,0,5,.000,27,62,.435,14,22,.636,15,44,59,20,10,11,3,25,68,2013/2014
"Fisher,Derek",141,361,.391,88,229,.384,53,132,.402,55,71,.775,12,110,122,117,70,49,3,157,425,2013/2014
"Fournier,Evan",228,544,.419,89,237,.376,139,307,.453,93,123,.756,34,168,202,112,34,100,7,179,638,2013/2014
"Foye,Randy",361,875,.413,189,498,.380,172,377,.456,157,185,.849,36,196,232,287,67,145,39,205,1068,2013/2014
"Franklin,Jamaal",16,39,.410,5,11,.455,11,28,.393,2,2,1.000,4,19,23,6,4,11,2,23,39,2013/2014
"Fredette,Jimmer",107,227,.471,40,84,.476,67,143,.469,19,21,.905,8,44,52,64,14,48,3,35,273,2013/2014
"Fredette,Jimmer",94,198,.475,36,73,.493,58,125,.464,17,19,.895,7,38,45,61,14,44,3,28,241,2013/2014
"Fredette,Jimmer",13,29,.448,4,11,.364,9,18,.500,2,2,1.000,1,6,7,3,0,4,0,7,32,2013/2014
"Freeland,Joel",77,162,.475,0,2,.000,77,160,.481,20,29,.690,88,120,208,36,10,32,22,95,174,2013/2014
"Frye,Channing",336,778,.432,160,432,.370,176,346,.509,78,95,.821,73,343,416,98,60,89,63,245,910,2013/2014
"García,Francisco",118,294,.401,69,193,.358,49,101,.485,10,19,.526,21,101,122,63,27,30,33,120,315,2013/2014
"Garnett,Kevin",157,356,.441,0,3,.000,157,353,.445,38,47,.809,60,298,358,82,43,69,40,123,352,2013/2014
"Garrett,Diante",101,265,.381,36,96,.375,65,169,.385,10,12,.833,11,86,97,120,41,75,5,75,248,2013/2014
"Gasol,Marc",336,711,.473,2,11,.182,334,700,.477,185,241,.768,84,340,424,215,59,111,76,150,859,2013/2014
"Gasol,Pau",425,885,.480,4,14,.286,421,871,.483,187,254,.736,124,456,580,201,27,141,92,124,1041,2013/2014
"Gay,Rudy",537,1179,.455,65,197,.330,472,982,.481,318,387,.822,113,324,437,209,95,224,56,171,1457,2013/2014
"Gay,Rudy",130,335,.388,22,59,.373,108,276,.391,68,88,.773,29,104,133,40,28,59,23,47,350,2013/2014
"Gay,Rudy",407,844,.482,43,138,.312,364,706,.516,250,299,.836,84,220,304,169,67,165,33,124,1107,2013/2014
"Gee,Alonzo",98,236,.415,19,58,.328,79,178,.444,43,61,.705,35,114,149,47,39,44,15,96,258,2013/2014
"George,Paul",577,1362,.424,182,500,.364,395,862,.458,401,464,.864,64,478,542,283,151,224,22,198,1737,2013/2014
"Gibson,Taj",429,896,.479,0,7,.000,429,889,.483,211,281,.751,200,358,558,91,41,150,112,207,1069,2013/2014
"Ginóbili,Manu",294,627,.469,90,258,.349,204,369,.553,160,188,.851,30,172,202,293,70,139,17,128,838,2013/2014
"Gobert,Rudy",36,74,.486,0,0,,36,74,.486,32,65,.492,51,104,155,7,8,32,41,57,104,2013/2014
"Gomes,Ryan",3,8,.375,0,2,.000,3,6,.500,0,0,,0,4,4,1,0,1,0,5,6,2013/2014
"Gooden,Drew",76,143,.531,7,17,.412,69,126,.548,24,27,.889,37,77,114,15,10,17,7,53,183,2013/2014
"Goodwin,Archie",76,167,.455,5,36,.139,71,131,.542,37,55,.673,25,62,87,20,20,44,11,45,194,2013/2014
"Gordon,Ben",37,108,.343,8,29,.276,29,79,.367,17,21,.810,3,24,27,21,10,21,2,18,99,2013/2014
"Gordon,Eric",356,817,.436,101,258,.391,255,559,.456,175,223,.785,30,135,165,208,74,134,12,114,988,2013/2014
"Gortat,Marcin",455,840,.542,1,1,1.000,454,839,.541,157,229,.686,202,565,767,138,41,126,121,201,1068,2013/2014
"Granger,Danny",116,307,.378,43,128,.336,73,179,.408,63,67,.940,31,102,133,41,12,46,17,62,338,2013/2014
"Granger,Danny",80,223,.359,31,94,.330,49,129,.380,51,53,.962,24,81,105,33,9,36,13,41,242,2013/2014
"Granger,Danny",36,84,.429,12,34,.353,24,50,.480,12,14,.857,7,21,28,8,3,10,4,21,96,2013/2014
"Gray,Aaron",27,61,.443,0,1,.000,27,60,.450,11,20,.550,42,69,111,22,10,31,8,64,65,2013/2014
"Gray,Aaron",2,3,.667,0,0,,2,3,.667,1,2,.500,3,5,8,3,0,4,0,7,5,2013/2014
"Gray,Aaron",25,58,.431,0,1,.000,25,57,.439,10,18,.556,39,64,103,19,10,27,8,57,60,2013/2014
"Green,Danny",218,505,.432,132,318,.415,86,187,.460,50,63,.794,25,204,229,104,65,76,61,107,618,2013/2014
"Green,Draymond",187,459,.407,55,165,.333,132,294,.449,82,123,.667,86,323,409,152,102,91,72,231,511,2013/2014
"Green,Gerald",448,1006,.445,204,510,.400,244,496,.492,195,230,.848,48,227,275,122,70,145,42,220,1295,2013/2014
"Green,Jeff",482,1171,.412,135,396,.341,347,775,.448,283,356,.795,54,326,380,138,57,165,47,180,1382,2013/2014
"Green,Willie",102,271,.376,41,121,.339,61,150,.407,28,34,.824,12,66,78,50,22,34,11,96,273,2013/2014
"Griffin,Blake",718,1359,.528,12,44,.273,706,1315,.537,482,674,.715,192,565,757,309,92,224,51,265,1930,2013/2014
"Gutiérrez,Jorge",25,54,.463,3,12,.250,22,42,.524,9,12,.750,3,19,22,30,10,14,1,37,62,2013/2014
"Hamilton,Jordan",147,376,.391,70,198,.354,77,178,.433,40,51,.784,32,162,194,52,44,46,20,67,404,2013/2014
"Hamilton,Jordan",99,254,.390,45,129,.349,54,125,.432,23,31,.742,23,110,133,34,31,27,13,31,266,2013/2014
"Hamilton,Jordan",48,122,.393,25,69,.362,23,53,.434,17,20,.850,9,52,61,18,13,19,7,36,138,2013/2014
"Hamilton,Justin",9,20,.450,3,9,.333,6,11,.545,5,5,1.000,4,3,7,0,5,4,0,8,26,2013/2014
"Hamilton,Justin",0,0,,0,0,,0,0,,0,0,,0,0,0,0,1,1,0,0,0,2013/2014
"Hamilton,Justin",9,20,.450,3,9,.333,6,11,.545,5,5,1.000,4,3,7,0,4,3,0,8,26,2013/2014
"Hansbrough,Tyler",93,196,.474,0,2,.000,93,194,.479,126,185,.681,120,167,287,17,28,47,19,132,312,2013/2014
"Hardaway,Tim",294,687,.428,130,358,.363,164,329,.498,106,128,.828,19,102,121,66,44,47,7,144,824,2013/2014
"Harden,James",549,1205,.456,177,483,.366,372,722,.515,576,665,.866,61,283,344,446,115,265,29,177,1851,2013/2014
"Harkless,Maurice",224,483,.464,59,154,.383,165,329,.502,85,143,.594,69,195,264,80,97,86,50,140,592,2013/2014
"Harrellson,Josh",38,82,.463,12,31,.387,26,51,.510,5,7,.714,30,46,76,15,6,10,15,44,93,2013/2014
"Harrington,Al",82,207,.396,34,100,.340,48,107,.449,27,35,.771,15,65,80,28,14,34,0,72,225,2013/2014
"Harris,Devin",96,254,.378,31,101,.307,65,153,.425,92,115,.800,8,77,85,178,28,59,2,72,315,2013/2014
"Harris,Elias",0,1,.000,0,0,,0,1,.000,0,0,,1,0,1,1,1,0,0,0,0,2013/2014
"Harris,Manny",28,70,.400,7,20,.350,21,50,.420,10,12,.833,7,27,34,11,4,9,1,10,73,2013/2014
"Harris,Mike",29,61,.475,0,2,.000,29,59,.492,26,27,.963,15,18,33,5,16,11,7,36,84,2013/2014
"Harris,Tobias",332,716,.464,32,126,.254,300,590,.508,197,244,.807,88,336,424,82,41,78,24,143,893,2013/2014
"Haslem,Udonis",74,146,.507,0,0,,74,146,.507,25,44,.568,42,133,175,13,11,24,15,79,173,2013/2014
"Hawes,Spencer",403,883,.456,128,308,.416,275,575,.478,119,152,.783,131,529,660,240,44,173,94,237,1053,2013/2014
"Hawes,Spencer",264,586,.451,81,203,.399,183,383,.478,79,101,.782,88,364,452,176,31,119,67,154,688,2013/2014
"Hawes,Spencer",139,297,.468,47,105,.448,92,192,.479,40,51,.784,43,165,208,64,13,54,27,83,365,2013/2014
"Hayes,Chuck",56,130,.431,0,1,.000,56,129,.434,20,25,.800,69,141,210,35,34,33,12,95,132,2013/2014
"Hayes,Chuck",14,32,.438,0,0,,14,32,.438,5,7,.714,20,27,47,6,11,7,2,18,33,2013/2014
"Hayes,Chuck",42,98,.429,0,1,.000,42,97,.433,15,18,.833,49,114,163,29,23,26,10,77,99,2013/2014
"Hayward,Gordon",426,1032,.413,85,280,.304,341,752,.453,311,381,.816,62,329,391,400,110,212,40,155,1248,2013/2014
"Henderson,Gerald",403,930,.433,40,115,.348,363,815,.445,235,309,.761,31,279,310,199,51,113,32,159,1081,2013/2014
"Henry,Xavier",144,345,.417,28,81,.346,116,264,.439,116,177,.655,25,89,114,51,44,57,7,79,432,2013/2014
"Henson,John",344,639,.538,0,1,.000,344,638,.539,91,177,.514,171,326,497,113,41,114,116,185,779,2013/2014
"Hibbert,Roy",331,754,.439,2,5,.400,329,749,.439,207,269,.770,202,336,538,91,29,148,182,269,871,2013/2014
"Hickson,J.J.",332,654,.508,0,8,.000,332,646,.514,150,290,.517,206,426,632,96,47,128,51,177,814,2013/2014
"Hilário,Nenê",299,594,.503,1,5,.200,298,589,.506,155,266,.583,65,229,294,153,64,117,47,164,754,2013/2014
"Hill,George",272,616,.442,95,260,.365,177,356,.497,142,176,.807,53,230,283,265,75,92,23,158,781,2013/2014
"Hill,Jordan",286,521,.549,0,1,.000,286,520,.550,124,181,.685,194,341,535,54,29,75,64,172,696,2013/2014
"Hill,Solomon",17,40,.425,7,23,.304,10,17,.588,6,7,.857,9,32,41,12,5,13,2,19,47,2013/2014
"Hinrich,Kirk",243,619,.393,85,242,.351,158,377,.419,95,125,.760,31,161,192,286,80,120,26,203,666,2013/2014
"Holiday,Jrue",203,454,.447,30,77,.390,173,377,.459,51,63,.810,28,114,142,268,56,105,12,92,487,2013/2014
"Hollins,Ryan",53,72,.736,0,0,,53,72,.736,35,56,.625,31,59,90,8,9,29,31,87,141,2013/2014
"Hopson,Scotty",0,4,.000,0,2,.000,0,2,.000,1,2,.500,0,0,0,1,1,0,0,0,1,2013/2014
"Horford,Al",238,420,.567,4,11,.364,234,409,.572,58,85,.682,66,178,244,76,27,64,44,56,538,2013/2014
"Howard,Dwight",473,800,.591,2,7,.286,471,793,.594,349,638,.547,231,635,866,131,60,229,128,240,1297,2013/2014
"Hummel,Robbie",67,177,.379,32,89,.360,35,88,.398,15,16,.938,35,97,132,23,16,10,2,57,181,2013/2014
"Humphries,Kris",231,461,.501,0,2,.000,231,459,.503,117,144,.813,127,282,409,67,31,64,61,136,579,2013/2014
"Ibaka,Serge",524,978,.536,23,60,.383,501,918,.546,156,199,.784,224,485,709,85,39,123,219,233,1227,2013/2014
"Iguodala,Andre",220,458,.480,62,175,.354,158,283,.558,86,132,.652,53,240,293,263,95,100,18,103,588,2013/2014
"İlyasova,Ersan",237,579,.409,37,131,.282,200,448,.446,107,130,.823,107,235,342,72,46,61,8,135,618,2013/2014
"Irving,Kyrie",532,1237,.430,123,344,.358,409,893,.458,291,338,.861,52,207,259,433,108,190,23,163,1478,2013/2014
"Ivey,Royal",0,2,.000,0,1,.000,0,1,.000,0,0,,0,1,1,0,0,0,0,1,0,2013/2014
"Jack,Jarrett",286,698,.410,63,185,.341,223,513,.435,125,149,.839,22,201,223,324,56,133,22,133,760,2013/2014
"Jackson,Reggie",403,916,.440,83,245,.339,320,671,.477,158,177,.893,43,270,313,331,85,168,9,142,1047,2013/2014
"Jackson,Stephen",6,26,.231,1,14,.071,5,12,.417,2,4,.500,2,8,10,5,6,6,1,11,15,2013/2014
"James,Bernard",11,23,.478,0,1,.000,11,22,.500,6,11,.545,15,27,42,3,3,10,8,24,28,2013/2014
"James,Damion",2,9,.222,0,2,.000,2,7,.286,2,2,1.000,1,11,12,3,0,1,1,3,6,2013/2014
"James,LeBron",767,1353,.567,116,306,.379,651,1047,.622,439,585,.750,81,452,533,488,121,270,26,126,2089,2013/2014
"James,Mike",5,21,.238,1,5,.200,4,16,.250,0,2,.000,0,7,7,17,2,5,0,11,11,2013/2014
"Jamison,Antawn",29,92,.315,8,41,.195,21,51,.412,18,25,.720,9,46,55,7,9,7,3,29,84,2013/2014
"Jeffers,Othyus",3,6,.500,0,2,.000,3,4,.750,3,4,.750,1,8,9,1,0,1,0,3,9,2013/2014
"Jeffers,Othyus",3,5,.600,0,1,.000,3,4,.750,1,2,.500,1,5,6,1,0,0,0,2,7,2013/2014
"Jeffers,Othyus",0,1,.000,0,1,.000,0,0,,2,2,1.000,0,3,3,0,0,1,0,1,2,2013/2014
"Jefferson,Al",700,1376,.509,3,15,.200,697,1361,.512,191,277,.690,156,636,792,155,67,124,79,176,1594,2013/2014
"Jefferson,Richard",294,654,.450,123,301,.409,171,353,.484,120,162,.741,18,201,219,130,56,94,14,168,831,2013/2014
"Jenkins,John",16,42,.381,4,18,.222,12,24,.500,4,4,1.000,3,19,22,11,1,11,1,11,40,2013/2014
"Jennings,Brandon",423,1135,.373,154,457,.337,269,678,.397,241,321,.751,59,185,244,609,101,215,8,157,1241,2013/2014
"Jerebko,Jonas",98,208,.471,31,74,.419,67,134,.500,43,59,.729,51,124,175,39,21,43,6,85,270,2013/2014
"Johnson,Amir",344,612,.562,20,66,.303,324,546,.593,91,143,.636,172,333,505,115,56,123,88,271,799,2013/2014
"Johnson,Chris",85,214,.397,43,127,.339,42,87,.483,37,43,.860,31,66,97,31,27,22,4,63,250,2013/2014
"Johnson,James",143,308,.464,22,87,.253,121,221,.548,76,90,.844,60,106,166,111,42,66,57,102,384,2013/2014
"Johnson,Joe",462,1018,.454,162,404,.401,300,614,.489,159,195,.815,48,222,270,216,47,120,10,129,1245,2013/2014
"Johnson,Orlando",36,113,.319,9,47,.191,27,66,.409,19,26,.731,9,46,55,20,6,15,2,26,100,2013/2014
"Johnson,Orlando",33,96,.344,8,41,.195,25,55,.455,17,22,.773,7,44,51,16,6,14,1,23,91,2013/2014
"Johnson,Orlando",3,17,.176,1,6,.167,2,11,.182,2,4,.500,2,2,4,4,0,1,1,3,9,2013/2014
"Johnson,Wesley",277,651,.425,100,271,.369,177,380,.466,61,77,.792,70,278,348,124,86,90,77,207,715,2013/2014
"Johnson-Odom,Darius",0,7,.000,0,3,.000,0,4,.000,0,2,.000,0,2,2,1,1,2,0,3,0,2013/2014
"Jones,James",31,68,.456,28,54,.519,3,14,.214,7,11,.636,2,21,23,9,3,4,4,6,97,2013/2014
"Jones,Perry",83,181,.459,22,61,.361,61,120,.508,28,42,.667,28,86,114,26,14,21,19,62,216,2013/2014
"Jones,Solomon",6,17,.353,0,0,,6,17,.353,2,4,.500,8,8,16,2,2,2,2,12,14,2013/2014
"Jones,Terrence",386,712,.542,31,101,.307,355,611,.581,118,195,.605,162,366,528,87,53,71,99,139,921,2013/2014
"Jordan,DeAndre",348,515,.676,0,0,,348,515,.676,160,374,.428,331,783,1114,74,80,123,203,264,856,2013/2014
"Joseph,Cory",126,265,.475,12,38,.316,114,227,.502,79,96,.823,32,75,107,114,35,43,14,84,343,2013/2014
"Kaman,Chris",176,346,.509,0,3,.000,176,343,.513,52,68,.765,54,175,229,58,11,74,40,93,404,2013/2014
"Kanter,Enes",419,853,.491,0,1,.000,419,852,.492,149,204,.730,222,376,598,75,28,144,42,230,987,2013/2014
"Karasev,Sergey",12,35,.343,4,19,.211,8,16,.500,9,10,.900,0,16,16,6,3,11,1,22,37,2013/2014
"Kelly,Ryan",157,371,.423,48,142,.338,109,229,.476,110,135,.815,42,177,219,95,32,47,45,147,472,2013/2014
"Kidd-Gilchrist,Michael",167,353,.473,1,9,.111,166,344,.483,113,184,.614,109,215,324,52,43,60,39,145,448,2013/2014
"Kirilenko,Andrei",82,160,.513,1,5,.200,81,155,.523,61,119,.513,55,91,146,72,40,54,19,65,226,2013/2014
"Knight,Brandon",461,1092,.422,110,338,.325,351,754,.466,259,323,.802,46,209,255,352,69,188,17,146,1291,2013/2014
"Korver,Kyle",289,609,.475,185,392,.472,104,217,.479,87,94,.926,22,260,282,208,70,102,24,147,850,2013/2014
"Koufos,Kosta",227,459,.495,0,0,,227,459,.495,60,93,.645,160,258,418,39,32,67,71,182,514,2013/2014
"Kravtsov,Viacheslav",8,15,.533,0,0,,8,15,.533,4,8,.500,9,8,17,1,0,6,1,7,20,2013/2014
"Kuzmić,Ognjen",5,13,.385,0,0,,5,13,.385,5,11,.455,10,11,21,2,3,10,4,17,15,2013/2014
"Lamb,Doron",63,160,.394,36,90,.400,27,70,.386,29,36,.806,8,41,49,43,11,27,1,54,191,2013/2014
"Lamb,Jeremy",263,609,.432,88,247,.356,175,362,.483,51,64,.797,27,162,189,115,56,61,26,143,665,2013/2014
"Landry,Carl",31,60,.517,0,0,,31,60,.517,14,17,.824,15,42,57,5,3,9,1,34,76,2013/2014
"Larkin,Shane",52,137,.380,12,38,.316,40,99,.404,16,25,.640,11,31,42,71,26,39,1,46,132,2013/2014
"Lawson,Ty",347,806,.431,72,202,.356,275,604,.455,324,406,.798,40,175,215,543,100,200,10,113,1090,2013/2014
"Ledo,Ricky",6,17,.353,3,8,.375,3,9,.333,4,4,1.000,0,2,2,2,1,2,0,2,19,2013/2014
"Lee,Courtney",295,614,.480,72,194,.371,223,420,.531,99,112,.884,29,158,187,115,65,73,28,127,761,2013/2014
"Lee,Courtney",90,183,.492,23,52,.442,67,131,.511,18,22,.818,8,41,49,32,20,25,9,37,221,2013/2014
"Lee,Courtney",205,431,.476,49,142,.345,156,289,.540,81,90,.900,21,117,138,83,45,48,19,90,540,2013/2014
"Lee,David",513,981,.523,0,1,.000,513,980,.523,231,296,.780,182,461,643,147,48,152,26,206,1257,2013/2014
"Len,Alex",33,78,.423,0,0,,33,78,.423,20,31,.645,39,60,99,4,4,26,18,68,86,2013/2014
"Leonard,Kawhi",337,645,.522,69,182,.379,268,463,.579,101,126,.802,76,336,412,133,114,80,50,127,844,2013/2014
"Leonard,Meyers",41,91,.451,0,6,.000,41,85,.482,16,21,.762,26,85,111,18,7,15,5,76,98,2013/2014
"Leuer,Jon",121,246,.492,23,49,.469,98,197,.497,37,47,.787,37,121,158,20,18,27,13,63,302,2013/2014
"Lewis,Rashard",98,236,.415,46,134,.343,52,102,.510,26,33,.788,24,86,110,57,53,35,8,90,268,2013/2014
"Liggins,DeAndre",1,1,1.000,0,0,,1,1,1.000,0,0,,1,0,1,0,0,0,0,0,2,2013/2014
"Lillard,Damian",553,1304,.424,218,554,.394,335,750,.447,371,426,.871,35,253,288,457,64,193,22,197,1695,2013/2014
"Lin,Jeremy",295,662,.446,82,229,.358,213,433,.492,218,265,.823,34,153,187,294,68,176,27,166,890,2013/2014
"Livingston,Shaun",235,487,.483,1,6,.167,234,481,.486,158,191,.827,67,179,246,245,93,105,31,172,629,2013/2014
"Lopez,Brook",129,229,.563,0,1,.000,129,228,.566,94,115,.817,39,63,102,16,9,28,30,52,352,2013/2014
"Lopez,Robin",355,644,.551,0,1,.000,355,643,.552,198,242,.818,326,374,700,73,25,84,139,196,908,2013/2014
"Love,Kevin",650,1421,.457,190,505,.376,460,916,.502,520,633,.821,224,739,963,341,59,196,35,136,2010,2013/2014
"Lowry,Kyle",457,1080,.423,190,500,.380,267,580,.460,313,385,.813,88,281,369,586,121,194,15,267,1417,2013/2014
"Lucas III,John",62,190,.326,25,84,.298,37,106,.349,10,16,.625,12,27,39,42,14,22,0,41,159,2013/2014
"Mack,Shelvin",209,501,.417,62,184,.337,147,317,.464,64,74,.865,21,139,160,271,50,89,2,100,544,2013/2014
"Mahinmi,Ian",91,189,.481,0,1,.000,91,188,.484,90,145,.621,107,150,257,24,41,58,72,207,272,2013/2014
"Marion,Shawn",341,708,.482,58,162,.358,283,546,.518,51,65,.785,132,365,497,124,90,95,37,125,791,2013/2014
"Marshall,Kendall",170,419,.406,71,178,.399,99,241,.411,19,36,.528,15,140,155,477,48,150,4,76,430,2013/2014
"Martin,Cartier",111,264,.420,59,151,.391,52,113,.460,48,65,.738,13,97,110,33,27,34,7,71,329,2013/2014
"Martin,Cartier",106,256,.414,56,146,.384,50,110,.455,46,61,.754,12,93,105,31,26,33,7,68,314,2013/2014
"Martin,Cartier",5,8,.625,3,5,.600,2,3,.667,2,4,.500,1,4,5,2,1,1,0,3,15,2013/2014
"Martin,Kenyon",63,123,.512,0,1,.000,63,122,.516,11,19,.579,36,98,134,50,25,26,27,85,137,2013/2014
"Martin,Kevin",440,1023,.430,115,297,.387,325,726,.448,303,340,.891,34,169,203,121,66,106,6,123,1298,2013/2014
"Mason,Roger",25,67,.373,17,48,.354,8,19,.421,7,7,1.000,1,21,22,19,6,9,1,26,74,2013/2014
"Matthews,Wesley",445,1009,.441,201,511,.393,244,498,.490,252,301,.837,51,238,289,197,76,110,14,176,1343,2013/2014
"Maxiell,Jason",47,105,.448,0,0,,47,105,.448,15,31,.484,28,58,86,9,8,14,20,47,109,2013/2014
"Maynor,Eric",32,101,.317,12,37,.324,20,64,.313,6,11,.545,9,30,39,52,9,29,3,17,82,2013/2014
"Maynor,Eric",21,72,.292,8,25,.320,13,47,.277,2,3,.667,7,17,24,40,5,17,1,13,52,2013/2014
"Maynor,Eric",11,29,.379,4,12,.333,7,17,.412,4,8,.500,2,13,15,12,4,12,2,4,30,2013/2014
"Mayo,O.J.",224,550,.407,84,227,.370,140,323,.433,76,88,.864,24,100,124,113,28,95,13,111,608,2013/2014
"Mbah a Moute,Luc",87,193,.451,4,17,.235,83,176,.472,46,67,.687,56,90,146,36,30,40,14,68,224,2013/2014
"Mbah a Moute,Luc",15,32,.469,1,3,.333,14,29,.483,9,13,.692,9,18,27,15,9,4,5,18,40,2013/2014
"Mbah a Moute,Luc",72,161,.447,3,14,.214,69,147,.469,37,54,.685,47,72,119,21,21,36,9,50,184,2013/2014
"McCallum,Ray",113,300,.377,22,59,.373,91,241,.378,32,43,.744,18,61,79,120,22,39,9,69,280,2013/2014
"McCollum,CJ",74,178,.416,30,80,.375,44,98,.449,23,34,.676,7,41,48,27,14,35,2,53,201,2013/2014
"McGee,JaVale",17,38,.447,0,0,,17,38,.447,1,1,1.000,10,7,17,2,1,8,7,16,35,2013/2014
"McLemore,Ben",255,679,.376,95,297,.320,160,382,.419,115,143,.804,53,182,235,82,45,96,18,201,720,2013/2014
"McRoberts,Josh",247,566,.436,105,291,.361,142,275,.516,62,85,.729,85,288,373,333,58,83,46,189,661,2013/2014
"Meeks,Jodie",413,892,.463,162,404,.401,251,488,.514,221,258,.857,30,164,194,138,111,111,4,119,1209,2013/2014
"Mekel,Gal",30,86,.349,5,20,.250,25,66,.379,8,12,.667,5,22,27,63,4,31,1,31,73,2013/2014
"Middleton,Khris",376,854,.440,120,290,.414,256,564,.454,118,137,.861,60,250,310,169,83,123,20,243,990,2013/2014
"Miles,C.J.",178,409,.435,83,211,.393,95,198,.480,64,75,.853,18,85,103,52,46,44,15,103,503,2013/2014
"Miller,Andre",106,231,.459,11,21,.524,95,210,.452,60,77,.779,28,102,130,197,34,61,9,75,283,2013/2014
"Miller,Andre",66,144,.458,9,18,.500,57,126,.452,35,47,.745,16,57,73,100,15,33,7,32,176,2013/2014
"Miller,Andre",40,87,.460,2,3,.667,38,84,.452,25,30,.833,12,45,57,97,19,28,2,43,107,2013/2014
"Miller,Darius",73,166,.440,25,77,.325,48,89,.539,29,36,.806,9,43,52,43,24,22,9,88,200,2013/2014
"Miller,Mike",213,443,.481,107,233,.459,106,210,.505,46,56,.821,30,177,207,130,26,77,5,95,579,2013/2014
"Miller,Quincy",94,256,.367,30,94,.319,64,162,.395,39,55,.709,36,111,147,26,22,48,32,70,257,2013/2014
"Mills,Patty",309,666,.464,135,318,.425,174,348,.500,73,82,.890,34,135,169,149,68,63,9,114,826,2013/2014
"Millsap,Paul",483,1047,.461,76,212,.358,407,835,.487,286,391,.731,154,473,627,232,129,185,78,210,1328,2013/2014
"Mitchell,Tony",5,12,.417,1,1,1.000,4,11,.364,11,19,.579,15,11,26,2,6,4,3,9,22,2013/2014
"Mitchell,Tony",3,5,.600,0,1,.000,3,4,.750,0,0,,1,0,1,1,1,0,0,0,6,2013/2014
"Mohammed,Nazr",54,126,.429,0,0,,54,126,.429,16,30,.533,66,109,175,20,14,37,30,77,124,2013/2014
"Monroe,Greg",504,1015,.497,0,1,.000,504,1014,.497,241,367,.657,256,504,760,171,91,166,47,205,1249,2013/2014
"Moore,E'Twaun",195,456,.428,57,161,.354,138,295,.468,52,68,.765,29,107,136,112,60,55,13,106,499,2013/2014
"Morris,Darius",39,96,.406,12,38,.316,27,58,.466,17,26,.654,7,19,26,44,13,27,0,33,107,2013/2014
"Morris,Darius",29,67,.433,10,24,.417,19,43,.442,15,21,.714,3,10,13,31,8,19,0,21,83,2013/2014
"Morris,Darius",4,13,.308,0,7,.000,4,6,.667,1,2,.500,0,5,5,5,2,2,0,9,9,2013/2014
"Morris,Darius",6,16,.375,2,7,.286,4,9,.444,1,3,.333,4,4,8,8,3,6,0,3,15,2013/2014
"Morris,Marcus",288,651,.442,99,260,.381,189,391,.483,121,159,.761,84,235,319,88,72,95,18,157,796,2013/2014
"Morris,Markieff",411,845,.486,34,108,.315,377,737,.512,259,327,.792,139,346,485,144,68,147,51,232,1115,2013/2014
"Morrow,Anthony",238,520,.458,88,195,.451,150,325,.462,72,87,.828,29,111,140,59,38,51,12,102,636,2013/2014
"Motiejūnas,Donatas",131,296,.443,21,84,.250,110,212,.519,58,96,.604,60,165,225,34,20,49,21,132,341,2013/2014
"Moultrie,Arnett",16,38,.421,0,0,,16,38,.421,4,5,.800,11,24,35,2,8,7,4,22,36,2013/2014
"Mozgov,Timofey",285,545,.523,4,24,.167,281,521,.539,196,260,.754,171,357,528,62,27,122,100,213,770,2013/2014
"Muhammad,Shabazz",57,124,.460,3,11,.273,54,113,.478,26,40,.650,24,29,53,6,8,16,1,24,143,2013/2014
"Mullens,Byron",73,165,.442,33,89,.371,40,76,.526,10,20,.500,24,68,92,14,15,27,11,64,189,2013/2014
"Mullens,Byron",26,64,.406,13,39,.333,13,25,.520,2,6,.333,7,25,32,6,6,13,3,33,67,2013/2014
"Mullens,Byron",47,101,.465,20,50,.400,27,51,.529,8,14,.571,17,43,60,8,9,14,8,31,122,2013/2014
"Murphy,Erik",3,13,.231,0,3,.000,3,10,.300,0,0,,2,6,8,2,0,2,4,7,6,2013/2014
"Murry,Toure'",56,129,.434,5,12,.417,51,117,.436,23,39,.590,13,31,44,49,19,34,1,46,140,2013/2014
"Muscala,Mike",31,73,.425,0,3,.000,31,70,.443,14,14,1.000,17,35,52,7,3,12,10,29,76,2013/2014
"N'Diaye,Hamady",3,9,.333,0,0,,3,9,.333,0,1,.000,5,13,18,3,0,3,4,15,6,2013/2014
"Nash,Steve",36,94,.383,8,24,.333,28,70,.400,22,24,.917,4,25,29,86,7,31,2,18,102,2013/2014
"Neal,Gary",193,471,.410,68,180,.378,125,291,.430,94,105,.895,10,80,90,83,18,64,0,65,548,2013/2014
"Neal,Gary",108,277,.390,40,111,.360,68,166,.410,45,54,.833,8,42,50,46,7,39,0,26,301,2013/2014
"Neal,Gary",85,194,.438,28,69,.406,57,125,.456,49,51,.961,2,38,40,37,11,25,0,39,247,2013/2014
"Nedović,Nemanja",8,39,.205,3,18,.167,5,21,.238,7,8,.875,3,12,15,13,0,13,1,13,26,2013/2014
"Nelson,Jameer",294,747,.394,136,391,.348,158,356,.444,96,112,.857,29,202,231,476,52,166,5,146,820,2013/2014
"Nicholson,Andrew",180,420,.429,28,89,.315,152,331,.459,47,57,.825,53,202,255,25,18,51,23,150,435,2013/2014
"Noah,Joakim",380,800,.475,0,2,.000,380,798,.476,247,335,.737,282,618,900,431,99,194,121,245,1007,2013/2014
"Novak,Steve",60,146,.411,52,122,.426,8,24,.333,6,6,1.000,8,50,58,13,12,5,4,44,178,2013/2014
"Nowitzki,Dirk",633,1273,.497,131,329,.398,502,944,.532,338,376,.899,40,458,498,216,73,117,45,165,1735,2013/2014
"Nunnally,James",15,46,.326,8,25,.320,7,21,.333,6,9,.667,1,18,19,8,6,7,2,11,44,2013/2014
"Nunnally,James",6,18,.333,3,10,.300,3,8,.375,3,4,.750,1,7,8,2,1,4,1,2,18,2013/2014
"Nunnally,James",9,28,.321,5,15,.333,4,13,.308,3,5,.600,0,11,11,6,5,3,1,9,26,2013/2014
"O'Neal,Jermaine",125,248,.504,0,0,,125,248,.504,99,132,.750,85,157,242,25,14,52,40,102,349,2013/2014
"O'Quinn,Kyle",186,371,.501,0,3,.000,186,368,.505,57,83,.687,100,264,364,78,39,78,88,165,429,2013/2014
"Oden,Greg",27,49,.551,0,0,,27,49,.551,13,23,.565,23,31,54,1,7,12,13,52,67,2013/2014
"Oladipo,Victor",392,936,.419,74,226,.327,318,710,.448,248,318,.780,43,286,329,327,129,256,37,210,1106,2013/2014
"Olynyk,Kelly",234,502,.466,40,114,.351,194,388,.500,99,122,.811,140,225,365,109,35,106,27,227,607,2013/2014
"Onuaku,Arinze",1,5,.200,0,0,,1,5,.200,1,2,.500,2,6,8,3,0,1,0,3,3,2013/2014
"Onuaku,Arinze",1,4,.250,0,0,,1,4,.250,1,2,.500,2,5,7,3,0,1,0,3,3,2013/2014
"Onuaku,Arinze",0,1,.000,0,0,,0,1,.000,0,0,,0,1,1,0,0,0,0,0,0,2013/2014
"Orton,Daniel",21,47,.447,0,0,,21,47,.447,23,30,.767,16,45,61,15,6,18,16,38,65,2013/2014
"Outlaw,Travis",130,326,.399,41,117,.350,89,209,.426,42,52,.808,36,132,168,48,20,26,19,94,343,2013/2014
"Pachulia,Zaza",149,349,.427,0,1,.000,149,348,.428,110,130,.846,141,192,333,136,45,92,14,124,408,2013/2014
"Pargo,Jannero",52,118,.441,24,60,.400,28,58,.483,8,11,.727,1,19,20,52,14,26,1,17,136,2013/2014
"Parker,Tony",456,914,.499,25,67,.373,431,847,.509,197,243,.811,17,138,155,388,36,151,9,86,1134,2013/2014
"Parsons,Chandler",466,987,.472,130,351,.370,336,636,.528,164,221,.742,69,340,409,298,88,144,29,168,1226,2013/2014
"Patterson,Patrick",225,489,.460,55,151,.364,170,338,.503,50,71,.704,117,225,342,78,55,65,37,159,555,2013/2014
"Patterson,Patrick",50,122,.410,9,39,.231,41,83,.494,9,16,.563,34,65,99,15,13,16,3,39,118,2013/2014
"Patterson,Patrick",175,367,.477,46,112,.411,129,255,.506,41,55,.745,83,160,243,63,42,49,34,120,437,2013/2014
"Paul,Chris",406,870,.467,78,212,.368,328,658,.498,295,345,.855,38,230,268,663,154,145,4,157,1185,2013/2014
"Peković,Nikola",379,701,.541,0,0,,379,701,.541,186,249,.747,206,262,468,50,30,84,23,129,944,2013/2014
"Perkins,Kendrick",87,193,.451,0,1,.000,87,192,.453,37,67,.552,82,223,305,67,26,90,32,177,211,2013/2014
"Pierce,Paul",321,712,.451,112,300,.373,209,412,.507,256,310,.826,26,322,348,178,86,153,31,190,1010,2013/2014
"Pittman,Dexter",0,1,.000,0,0,,0,1,.000,0,2,.000,3,0,3,0,0,0,0,0,0,2013/2014
"Plumlee,Mason",199,302,.659,0,3,.000,199,299,.666,122,195,.626,99,209,308,60,49,77,55,171,520,2013/2014
"Plumlee,Miles",286,553,.517,0,0,,286,553,.517,74,132,.561,198,428,626,43,50,111,90,185,646,2013/2014
"Pondexter,Quincy",31,79,.392,11,34,.324,20,45,.444,21,26,.808,10,16,26,20,5,15,1,18,94,2013/2014
"Porter,Otto",33,91,.363,4,21,.190,29,70,.414,8,12,.667,21,36,57,10,8,14,1,26,78,2013/2014
"Powell,Josh",2,6,.333,0,0,,2,6,.333,0,0,,0,5,5,0,0,1,1,1,4,2013/2014
"Pressey,Phil",78,253,.308,28,106,.264,50,147,.340,29,45,.644,20,85,105,241,68,87,5,97,213,2013/2014
"Price,A.J.",19,46,.413,6,22,.273,13,24,.542,0,2,.000,1,9,10,13,1,7,0,5,44,2013/2014
"Price,Ronnie",28,92,.304,9,43,.209,19,49,.388,9,13,.692,8,35,43,66,25,26,2,50,74,2013/2014
"Prigioni,Pablo",88,191,.461,65,140,.464,23,51,.451,11,12,.917,36,93,129,228,67,60,2,132,252,2013/2014
"Prince,Tayshaun",200,492,.407,20,69,.290,180,423,.426,34,60,.567,32,202,234,119,39,41,19,63,454,2013/2014
"Raduljica,Miroslav",68,126,.540,0,0,,68,126,.540,45,55,.818,54,54,108,23,7,28,13,84,181,2013/2014
"Randolph,Anthony",68,176,.386,18,61,.295,50,115,.435,52,69,.754,20,102,122,32,26,39,19,64,206,2013/2014
"Randolph,Shavlik",7,14,.500,0,0,,7,14,.500,6,11,.545,7,18,25,1,3,5,1,15,20,2013/2014
"Randolph,Zach",560,1198,.467,2,20,.100,558,1178,.474,250,337,.742,265,530,795,200,54,183,23,210,1372,2013/2014
"Redick,J.J.",181,398,.455,73,185,.395,108,213,.507,97,106,.915,9,65,74,78,28,42,3,65,532,2013/2014
"Rice,Glen",11,37,.297,5,17,.294,6,20,.300,5,7,.714,4,16,20,7,6,9,1,7,32,2013/2014
"Ridnour,Luke",126,327,.385,37,108,.343,89,219,.406,17,26,.654,23,74,97,176,32,66,8,92,306,2013/2014
"Ridnour,Luke",84,219,.384,25,68,.368,59,151,.391,13,19,.684,15,47,62,122,23,46,2,55,206,2013/2014
"Ridnour,Luke",42,108,.389,12,40,.300,30,68,.441,4,7,.571,8,27,35,54,9,20,6,37,100,2013/2014
"Rivers,Austin",192,474,.405,36,99,.364,156,375,.416,110,173,.636,26,103,129,160,45,77,9,134,530,2013/2014
"Roberson,Andre",33,68,.485,2,13,.154,31,55,.564,7,10,.700,36,58,94,15,19,19,10,74,75,2013/2014
"Roberts,Brian",244,581,.420,64,178,.360,180,403,.447,125,133,.940,17,119,136,234,43,95,7,132,677,2013/2014
"Robinson,Nate",164,383,.428,58,154,.377,106,229,.463,71,85,.835,21,60,81,112,36,58,4,92,457,2013/2014
"Robinson,Thomas",141,293,.481,0,1,.000,141,292,.483,57,101,.564,105,202,307,34,23,57,20,131,339,2013/2014
"Rondo,Rajon",141,350,.403,26,90,.289,115,260,.442,42,67,.627,22,142,164,294,40,99,2,65,350,2013/2014
"Rose,Derrick",58,164,.354,16,47,.340,42,117,.359,27,32,.844,9,23,32,43,5,34,1,15,159,2013/2014
"Ross,Terrence",318,751,.423,161,408,.395,157,343,.458,82,98,.837,43,209,252,79,64,88,27,183,879,2013/2014
"Rubio,Ricky",255,670,.381,44,133,.331,211,537,.393,227,283,.802,61,281,342,704,191,221,11,218,781,2013/2014
"Rush,Brandon",30,90,.333,16,47,.340,14,43,.326,3,5,.600,5,39,44,24,5,20,9,31,79,2013/2014
"Sacre,Robert",143,300,.477,0,0,,143,300,.477,64,94,.681,82,172,254,51,24,44,47,134,350,2013/2014
"Salmons,John",150,413,.363,63,163,.387,87,250,.348,40,52,.769,20,143,163,147,47,54,19,124,403,2013/2014
"Salmons,John",41,117,.350,16,42,.381,25,75,.333,7,7,1.000,8,38,46,44,12,14,8,32,105,2013/2014
"Salmons,John",109,296,.368,47,121,.388,62,175,.354,33,45,.733,12,105,117,103,35,40,11,92,298,2013/2014
"Sanders,Larry",76,162,.469,0,1,.000,76,161,.472,26,55,.473,60,105,165,19,18,26,40,74,178,2013/2014
"Schröder,Dennis",72,188,.383,10,42,.238,62,146,.425,29,43,.674,5,55,60,93,17,61,0,54,183,2013/2014
"Scola,Luis",263,560,.470,1,7,.143,262,553,.474,99,136,.728,86,305,391,81,26,108,16,164,626,2013/2014
"Scott,Mike",301,628,.479,62,200,.310,239,428,.558,103,132,.780,62,222,284,75,30,79,7,121,767,2013/2014
"Sefolosha,Thabo",141,340,.415,48,152,.316,93,188,.495,53,69,.768,50,170,220,94,79,55,17,90,383,2013/2014
"Séraphin,Kevin",111,220,.505,0,0,,111,220,.505,27,31,.871,53,75,128,17,3,41,26,103,249,2013/2014
"Sessions,Ramon",330,769,.429,35,124,.282,295,645,.457,326,404,.807,38,165,203,340,49,148,9,90,1021,2013/2014
"Sessions,Ramon",190,465,.409,15,68,.221,175,397,.441,183,234,.782,22,95,117,206,33,93,6,50,578,2013/2014
"Sessions,Ramon",140,304,.461,20,56,.357,120,248,.484,143,170,.841,16,70,86,134,16,55,3,40,443,2013/2014
"Shakur,Mustafa",0,3,.000,0,1,.000,0,2,.000,1,2,.500,0,0,0,4,0,2,0,2,1,2013/2014
"Shengelia,Tornike",13,28,.464,0,6,.000,13,22,.591,3,8,.375,4,12,16,14,3,12,1,18,29,2013/2014
"Shengelia,Tornike",11,24,.458,0,6,.000,11,18,.611,3,8,.375,4,10,14,12,2,11,1,16,25,2013/2014
"Shengelia,Tornike",2,4,.500,0,0,,2,4,.500,0,0,,0,2,2,2,1,1,0,2,4,2013/2014
"Shumpert,Iman",183,484,.378,76,228,.333,107,256,.418,53,71,.746,81,227,308,129,92,79,13,209,495,2013/2014
"Shved,Alexey",76,237,.321,30,102,.294,46,135,.341,68,90,.756,21,60,81,68,26,48,16,36,250,2013/2014
"Sims,Henry",130,274,.474,0,1,.000,130,273,.476,90,121,.744,104,133,237,52,28,41,20,116,350,2013/2014
"Sims,Henry",18,45,.400,0,0,,18,45,.400,8,14,.571,22,34,56,5,5,8,7,32,44,2013/2014
"Sims,Henry",112,229,.489,0,1,.000,112,228,.491,82,107,.766,82,99,181,47,23,33,13,84,306,2013/2014
"Singler,Kyle",269,602,.447,94,246,.382,175,356,.492,152,184,.826,116,187,303,75,61,79,38,211,784,2013/2014
"Singleton,Chris",25,67,.373,7,19,.368,18,48,.375,18,25,.720,18,37,55,6,9,17,3,25,75,2013/2014
"Siva,Peyton",18,57,.316,7,25,.280,11,32,.344,11,15,.733,2,12,14,34,9,18,1,27,54,2013/2014
"Sloan,Donald",44,117,.376,10,42,.238,34,75,.453,12,20,.600,4,40,44,50,10,22,1,19,110,2013/2014
"Smith,Chris",0,0,,0,0,,0,0,,0,0,,0,0,0,0,0,0,0,0,0,2013/2014
"Smith,Greg",18,28,.643,0,0,,18,28,.643,2,5,.400,11,16,27,0,1,5,2,17,38,2013/2014
"Smith,Ish",119,281,.423,1,23,.043,118,258,.457,22,39,.564,31,98,129,179,49,65,13,66,261,2013/2014
"Smith,J.R.",396,955,.415,189,480,.394,207,475,.436,90,138,.652,35,261,296,219,65,108,20,196,1071,2013/2014
"Smith,Jason",131,282,.465,0,0,,131,282,.465,39,50,.780,51,130,181,29,11,28,29,100,301,2013/2014
"Smith,Josh",517,1233,.419,70,265,.264,447,968,.462,160,301,.532,102,418,520,252,105,199,110,197,1264,2013/2014
"Snell,Tony",129,336,.384,57,178,.320,72,158,.456,31,41,.756,19,105,124,68,29,44,15,84,346,2013/2014
"Southerland,James",5,15,.333,3,6,.500,2,9,.222,1,2,.500,0,8,8,0,1,1,2,3,14,2013/2014
"Southerland,James",0,3,.000,0,1,.000,0,2,.000,0,0,,0,0,0,0,0,0,0,0,0,2013/2014
"Southerland,James",5,12,.417,3,5,.600,2,7,.286,1,2,.500,0,8,8,0,1,1,2,3,14,2013/2014
"Speights,Marreese",195,442,.441,8,31,.258,187,411,.455,110,134,.821,101,189,290,32,10,66,34,148,508,2013/2014
"Splitter,Tiago",181,346,.523,0,3,.000,181,343,.528,121,173,.699,123,240,363,90,29,75,31,117,483,2013/2014
"Stephens,D.J.",3,7,.429,0,0,,3,7,.429,1,1,1.000,1,4,5,0,0,0,0,0,7,2013/2014
"Stephenson,Lance",427,870,.491,86,244,.352,341,626,.545,140,197,.711,95,463,558,359,54,210,7,195,1080,2013/2014
"Stiemsma,Greg",70,122,.574,0,1,.000,70,121,.579,19,32,.594,72,154,226,36,35,44,57,169,159,2013/2014
"Stone,Julyan",7,17,.412,2,8,.250,5,9,.556,2,3,.667,2,18,20,12,3,5,0,13,18,2013/2014
"Stoudemire,Amar'e",311,558,.557,0,0,,311,558,.557,150,203,.739,112,208,320,34,23,91,37,159,772,2013/2014
"Stuckey,Rodney",372,853,.436,24,88,.273,348,765,.455,244,292,.836,39,130,169,152,54,125,10,131,1012,2013/2014
"Sullinger,Jared",384,899,.427,56,208,.269,328,691,.475,158,203,.778,241,360,601,118,35,119,49,251,982,2013/2014
"Taylor,Jeffery",82,218,.376,18,67,.269,64,151,.424,26,47,.553,15,45,60,22,13,25,5,62,208,2013/2014
"Taylor,Tyshawn",31,91,.341,3,12,.250,28,79,.354,24,30,.800,3,12,15,36,12,31,1,29,89,2013/2014
"Teague,Jeff",456,1040,.438,74,225,.329,382,815,.469,318,376,.846,34,174,208,528,89,232,17,158,1304,2013/2014
"Teague,Marquis",38,119,.319,5,18,.278,33,101,.327,26,35,.743,1,39,40,58,10,39,5,46,107,2013/2014
"Teague,Marquis",16,66,.242,2,10,.200,14,56,.250,11,16,.688,1,18,19,28,2,17,4,25,45,2013/2014
"Teague,Marquis",22,53,.415,3,8,.375,19,45,.422,15,19,.789,0,21,21,30,8,22,1,21,62,2013/2014
"Teletović,Mirza",221,529,.418,136,349,.390,85,180,.472,44,62,.710,60,206,266,57,29,54,23,143,622,2013/2014
"Temple,Garrett",51,141,.362,6,29,.207,45,112,.402,30,43,.698,21,47,68,72,35,42,11,72,138,2013/2014
"Terry,Jason",55,152,.362,39,103,.379,16,49,.327,10,15,.667,4,33,37,56,13,27,0,48,159,2013/2014
"Thabeet,Hasheem",13,23,.565,0,0,,13,23,.565,1,5,.200,9,31,40,1,4,14,9,47,27,2013/2014
"Thomas,Adonis",6,14,.429,1,5,.200,5,9,.556,1,1,1.000,0,3,3,3,0,1,0,6,14,2013/2014
"Thomas,Adonis",3,9,.333,0,3,.000,3,6,.500,1,1,1.000,0,3,3,2,0,0,0,2,7,2013/2014
"Thomas,Adonis",3,5,.600,1,2,.500,2,3,.667,0,0,,0,0,0,1,0,1,0,4,7,2013/2014
"Thomas,Isaiah",496,1096,.453,127,364,.349,369,732,.504,346,407,.850,47,163,210,454,93,213,8,185,1465,2013/2014
"Thomas,Lance",2,9,.222,0,0,,2,9,.222,2,4,.500,2,5,7,3,0,2,0,4,6,2013/2014
"Thomas,Malcolm",7,16,.438,1,4,.250,6,12,.500,0,2,.000,5,16,21,2,0,9,3,5,15,2013/2014
"Thomas,Malcolm",1,4,.250,0,0,,1,4,.250,0,2,.000,1,8,9,0,0,1,2,0,2,2013/2014
"Thomas,Malcolm",6,12,.500,1,4,.250,5,8,.625,0,0,,4,8,12,2,0,8,1,5,13,2013/2014
"Thompson,Hollis",171,372,.460,67,167,.401,104,205,.507,52,73,.712,73,174,247,73,53,60,12,144,461,2013/2014
"Thompson,Jason",251,496,.506,0,0,,251,496,.506,84,145,.579,153,374,527,53,32,95,56,251,586,2013/2014
"Thompson,Klay",559,1259,.444,223,535,.417,336,724,.464,147,185,.795,38,211,249,181,74,135,37,234,1488,2013/2014
"Thompson,Tristan",363,761,.477,0,1,.000,363,760,.478,235,339,.693,269,485,754,72,42,108,35,188,961,2013/2014
"Thornton,Marcus",252,639,.394,109,316,.345,143,323,.443,90,112,.804,57,141,198,77,58,67,11,110,703,2013/2014
"Thornton,Marcus",142,373,.381,57,179,.318,85,194,.438,42,52,.808,39,85,124,47,31,38,8,74,383,2013/2014
"Thornton,Marcus",110,266,.414,52,137,.380,58,129,.450,48,60,.800,18,56,74,30,27,29,3,36,320,2013/2014
"Tinsley,Jamaal",4,20,.200,1,15,.067,3,5,.600,0,0,,2,9,11,23,2,9,0,10,9,2013/2014
"Tolliver,Anthony",129,307,.420,102,247,.413,27,60,.450,33,41,.805,33,135,168,42,19,23,15,82,393,2013/2014
"Tucker,P.J.",265,615,.431,74,191,.387,191,424,.450,156,201,.776,161,368,529,141,110,102,23,204,760,2013/2014
"Turiaf,Ronny",64,107,.598,0,0,,64,107,.598,21,50,.420,55,119,174,24,8,24,50,65,149,2013/2014
"Türkoğlu,Hedo",42,109,.385,22,50,.440,20,59,.339,9,18,.500,11,78,89,33,19,16,10,50,115,2013/2014
"Turner,Evan",434,1021,.425,50,156,.321,384,865,.444,213,262,.813,62,346,408,262,67,189,7,195,1131,2013/2014
"Turner,Evan",356,831,.428,38,132,.288,318,699,.455,189,228,.829,50,272,322,198,56,155,5,147,939,2013/2014
"Turner,Evan",78,190,.411,12,24,.500,66,166,.398,24,34,.706,12,74,86,64,11,34,2,48,192,2013/2014
"Tyler,Jeremy",60,116,.517,0,0,,60,116,.517,26,48,.542,38,71,109,8,6,26,20,70,146,2013/2014
"Udoh,Ekpe",57,143,.399,0,0,,57,143,.399,30,47,.638,61,87,148,31,15,38,44,96,144,2013/2014
"Udrih,Beno",78,178,.438,19,42,.452,59,136,.434,25,30,.833,10,49,59,116,23,47,4,50,200,2013/2014
"Udrih,Beno",68,160,.425,17,40,.425,51,120,.425,20,24,.833,10,47,57,110,22,42,3,46,173,2013/2014
"Udrih,Beno",10,18,.556,2,2,1.000,8,16,.500,5,6,.833,0,2,2,6,1,5,1,4,27,2013/2014
"Valančiūnas,Jonas",359,676,.531,0,1,.000,359,675,.532,198,260,.762,226,488,714,57,24,136,71,249,916,2013/2014
"Varejão,Anderson",227,459,.495,0,7,.000,227,452,.502,92,135,.681,187,442,629,140,69,72,39,164,546,2013/2014
"Varnado,Jarvis",36,60,.600,0,0,,36,60,.600,27,52,.519,19,44,63,13,10,10,29,62,99,2013/2014
"Varnado,Jarvis",0,0,,0,0,,0,0,,0,0,,0,0,0,0,0,0,0,1,0,2013/2014
"Varnado,Jarvis",36,60,.600,0,0,,36,60,.600,27,52,.519,19,44,63,13,10,10,29,61,99,2013/2014
"Vásquez,Greivis",277,658,.421,109,289,.377,168,369,.455,95,108,.880,20,153,173,323,31,128,5,143,758,2013/2014
"Vásquez,Greivis",65,150,.433,16,50,.320,49,100,.490,30,32,.938,5,29,34,95,6,27,1,38,176,2013/2014
"Vásquez,Greivis",212,508,.417,93,239,.389,119,269,.442,65,76,.855,15,124,139,228,25,101,4,105,582,2013/2014
"Veselý,Jan",89,173,.514,0,0,,89,173,.514,19,56,.339,81,110,191,21,53,36,35,121,197,2013/2014
"Veselý,Jan",48,92,.522,0,0,,48,92,.522,8,30,.267,53,60,113,10,26,22,19,64,104,2013/2014
"Veselý,Jan",41,81,.506,0,0,,41,81,.506,11,26,.423,28,50,78,11,27,14,16,57,93,2013/2014
"Villanueva,Charlie",35,92,.380,14,56,.250,21,36,.583,8,14,.571,6,28,34,6,4,7,5,16,92,2013/2014
"Vučević,Nikola",353,696,.507,0,0,,353,696,.507,105,137,.766,185,441,626,104,60,112,47,169,811,2013/2014
"Vujačić,Sasha",2,5,.400,1,2,.500,1,3,.333,0,0,,0,3,3,0,1,3,0,1,5,2013/2014
"Wade,Dwyane",415,761,.545,9,32,.281,406,729,.557,189,258,.733,60,181,241,252,79,161,29,106,1028,2013/2014
"Waiters,Dion",430,993,.433,92,250,.368,338,743,.455,161,235,.685,32,163,195,209,63,154,17,153,1113,2013/2014
"Walker,Kemba",449,1143,.393,109,327,.333,340,816,.417,282,337,.837,39,267,306,447,86,169,32,128,1289,2013/2014
"Wall,John",579,1337,.433,108,308,.351,471,1029,.458,317,394,.805,38,295,333,721,149,295,40,219,1583,2013/2014
"Wallace,Gerald",116,230,.504,19,64,.297,97,166,.584,47,101,.465,36,176,212,143,73,97,14,79,298,2013/2014
"Ware,Casper",18,42,.429,7,21,.333,11,21,.524,5,6,.833,0,9,9,10,8,5,0,11,48,2013/2014
"Watson,C.J.",146,334,.437,53,145,.366,93,189,.492,69,88,.784,19,82,101,107,60,60,8,66,414,2013/2014
"Watson,Earl",3,11,.273,2,7,.286,1,4,.250,4,4,1.000,5,10,15,28,5,17,1,33,12,2013/2014
"Wayns,Maalik",1,2,.500,0,0,,1,2,.500,0,0,,0,2,2,2,2,0,0,4,2,2013/2014
"Webster,Martell",254,587,.433,146,372,.392,108,215,.502,105,125,.840,38,184,222,97,41,58,15,150,759,2013/2014
"West,David",458,939,.488,4,15,.267,454,924,.491,198,251,.789,120,422,542,223,61,133,74,186,1118,2013/2014
"Westbrook,Russell",346,791,.437,68,214,.318,278,577,.482,242,293,.826,55,208,263,319,88,177,7,104,1002,2013/2014
"White,D.J.",0,1,.000,0,0,,0,1,.000,0,0,,0,2,2,0,1,0,0,1,0,2013/2014
"White,Royce",0,1,.000,0,0,,0,1,.000,0,0,,0,0,0,0,0,0,0,2,0,2013/2014
"Williams,Deron",322,716,.450,98,268,.366,224,448,.500,173,216,.801,15,153,168,392,93,143,13,148,915,2013/2014
"Williams,Derrick",206,482,.427,26,99,.263,180,383,.470,186,259,.718,71,252,323,56,48,76,20,114,624,2013/2014
"Williams,Derrick",19,54,.352,2,15,.133,17,39,.436,14,16,.875,3,23,26,1,4,6,4,9,54,2013/2014
"Williams,Derrick",187,428,.437,24,84,.286,163,344,.474,172,243,.708,68,229,297,55,44,70,16,105,570,2013/2014
"Williams,Elliot",140,337,.415,37,125,.296,103,212,.486,87,119,.731,30,100,130,72,35,68,3,126,404,2013/2014
"Williams,Lou",197,493,.400,79,231,.342,118,262,.450,152,179,.849,10,114,124,210,45,92,4,65,625,2013/2014
"Williams,Marvin",231,526,.439,84,234,.359,147,292,.503,57,73,.781,82,252,334,78,54,53,31,151,603,2013/2014
"Williams,Mo",280,672,.417,83,225,.369,197,447,.441,78,89,.876,42,111,153,321,55,149,10,197,721,2013/2014
"Williams,Reggie",5,9,.556,1,3,.333,4,6,.667,0,0,,0,0,0,1,1,2,0,1,11,2013/2014
"Williams,Shawne",73,192,.380,42,129,.326,31,63,.492,14,20,.700,25,142,167,30,19,21,30,93,202,2013/2014
"Withey,Jeff",69,129,.535,0,1,.000,69,128,.539,52,73,.712,49,101,150,26,15,20,50,73,190,2013/2014
"Wolters,Nate",170,389,.437,18,62,.290,152,327,.465,59,90,.656,33,116,149,187,35,57,15,67,417,2013/2014
"World Peace,Metta",56,141,.397,17,54,.315,39,87,.448,10,16,.625,18,41,59,17,24,19,8,44,139,2013/2014
"Wright,Brandan",224,331,.677,0,0,,224,331,.677,77,106,.726,102,142,244,31,32,35,55,94,525,2013/2014
"Wright,Chris",21,35,.600,0,1,.000,21,34,.618,6,15,.400,10,10,20,5,7,5,5,17,48,2013/2014
"Wright,Dorell",111,297,.374,69,202,.342,42,95,.442,52,69,.754,29,162,191,64,23,39,16,62,343,2013/2014
"Wroten,Tony",345,808,.427,40,188,.213,305,620,.492,209,326,.641,69,159,228,217,78,204,16,151,939,2013/2014
"Young,Nick",387,889,.435,135,350,.386,252,539,.468,235,285,.825,29,137,166,95,46,95,12,156,1144,2013/2014
"Young,Thaddeus",582,1283,.454,90,292,.308,492,991,.496,163,229,.712,166,310,476,182,167,165,36,213,1417,2013/2014
"Zeller,Cody",172,404,.426,0,1,.000,172,403,.427,146,200,.730,118,235,353,92,40,87,41,170,490,2013/2014
"Zeller,Tyler",156,290,.538,0,1,.000,156,289,.540,87,121,.719,103,179,282,36,18,60,38,137,399,2013/2014
"Acy,Quincy",152,331,.459,18,60,.300,134,271,.494,76,97,.784,79,222,301,68,27,60,22,147,398,2014/2015
"Adams,Jordan",35,86,.407,10,25,.400,25,61,.410,14,23,.609,9,19,28,16,16,14,7,24,94,2014/2015
"Adams,Steven",217,399,.544,0,2,.000,217,397,.547,103,205,.502,199,324,523,66,38,99,86,222,537,2014/2015
"Adrien,Jeff",19,44,.432,0,0,,19,44,.432,22,38,.579,23,54,77,15,4,9,9,30,60,2014/2015
"Afflalo,Arron",375,884,.424,118,333,.354,257,551,.466,167,198,.843,27,220,247,129,41,116,7,167,1035,2014/2015
"Afflalo,Arron",281,657,.428,82,243,.337,199,414,.481,127,151,.841,21,159,180,101,32,83,5,108,771,2014/2015
"Afflalo,Arron",94,227,.414,36,90,.400,58,137,.423,40,47,.851,6,61,67,28,9,33,2,59,264,2014/2015
"Ajinça,Alexis",181,329,.550,0,0,,181,329,.550,81,99,.818,104,211,315,47,21,69,51,151,443,2014/2015
"Aldemir,Furkan",40,78,.513,0,5,.000,40,73,.548,13,27,.481,78,98,176,28,17,17,16,96,93,2014/2015
"Aldrich,Cole",144,301,.478,0,0,,144,301,.478,50,64,.781,101,237,338,75,37,59,65,122,338,2014/2015
"Aldridge,LaMarcus",659,1415,.466,37,105,.352,622,1310,.475,306,362,.845,177,549,726,124,48,122,68,125,1661,2014/2015
"Allen,Lavoy",141,299,.472,0,0,,141,299,.472,33,47,.702,123,200,323,73,15,40,42,102,315,2014/2015
"Allen,Tony",225,455,.495,10,29,.345,215,426,.505,79,126,.627,103,177,280,86,129,86,30,166,539,2014/2015
"Aminu,Al-Farouq",147,357,.412,34,124,.274,113,233,.485,84,118,.712,114,228,342,59,70,55,62,137,412,2014/2015
"Amundson,Lou",109,255,.427,0,1,.000,109,254,.429,41,87,.471,94,174,268,70,22,62,52,126,259,2014/2015
"Amundson,Lou",4,12,.333,0,0,,4,12,.333,3,5,.600,5,15,20,5,1,5,0,11,11,2014/2015
"Amundson,Lou",105,243,.432,0,1,.000,105,242,.434,38,82,.463,89,159,248,65,21,57,52,115,248,2014/2015
"Andersen,Chris",120,207,.580,4,13,.308,116,194,.598,76,114,.667,76,223,299,43,26,40,61,88,320,2014/2015
"Anderson,Alan",195,440,.443,73,210,.348,122,230,.530,82,101,.812,31,173,204,83,56,60,5,148,545,2014/2015
"Anderson,Kyle",31,89,.348,3,11,.273,28,78,.359,9,14,.643,5,67,72,28,15,10,7,28,74,2014/2015
"Anderson,Ryan",291,729,.399,122,359,.340,169,370,.457,129,151,.854,108,187,295,55,33,62,20,113,833,2014/2015
"Antetokounmpo,Giannis",383,780,.491,7,44,.159,376,736,.511,257,347,.741,100,442,542,207,73,173,85,254,1030,2014/2015
"Anthony,Carmelo",358,806,.444,61,179,.341,297,627,.474,189,237,.797,72,192,264,122,40,89,17,87,966,2014/2015
"Anthony,Joel",36,62,.581,0,0,,36,62,.581,15,22,.682,32,61,93,5,12,12,49,55,87,2014/2015
"Antić,Pero",108,296,.365,52,173,.301,56,123,.455,88,123,.715,58,131,189,49,18,49,14,132,356,2014/2015
"Ariza,Trevor",366,910,.402,194,555,.350,172,355,.485,122,143,.853,77,382,459,209,152,141,17,186,1048,2014/2015
"Arthur,Darrell",155,384,.404,26,110,.236,129,274,.471,46,59,.780,53,118,171,57,48,47,26,146,382,2014/2015
"Aşık,Ömer",213,412,.517,0,0,,213,412,.517,131,225,.582,244,504,748,72,29,95,54,144,557,2014/2015
"Augustin,D.J.",258,647,.399,83,246,.337,175,401,.436,178,205,.868,20,141,161,353,49,145,3,93,777,2014/2015
"Augustin,D.J.",189,461,.410,49,150,.327,140,311,.450,147,169,.870,13,87,100,265,33,110,2,61,574,2014/2015
"Augustin,D.J.",69,186,.371,34,96,.354,35,90,.389,31,36,.861,7,54,61,88,16,35,1,32,203,2014/2015
"Ayres,Jeff",55,95,.579,0,0,,55,95,.579,27,36,.750,37,80,117,14,8,26,8,60,137,2014/2015
"Babbitt,Luke",92,192,.479,59,115,.513,33,77,.429,13,19,.684,12,99,111,24,17,26,11,63,256,2014/2015
"Bairstow,Cameron",3,14,.214,0,0,,3,14,.214,4,5,.800,6,2,8,1,2,3,1,8,10,2014/2015
"Barbosa,Leandro",183,386,.474,43,112,.384,140,274,.511,58,74,.784,23,68,91,99,41,44,8,87,467,2014/2015
"Barea,J.J.",225,536,.420,54,167,.323,171,369,.463,76,94,.809,23,111,134,263,33,70,1,104,580,2014/2015
"Bargnani,Andrea",164,361,.454,15,41,.366,149,320,.466,87,107,.813,32,95,127,46,2,42,27,53,430,2014/2015
"Barnes,Harrison",316,656,.482,87,215,.405,229,441,.519,108,150,.720,117,336,453,116,61,71,19,146,827,2014/2015
"Barnes,Matt",277,624,.444,136,376,.362,141,248,.569,74,95,.779,51,251,302,114,67,87,50,240,764,2014/2015
"Barron,Earl",12,39,.308,2,4,.500,10,35,.286,6,12,.500,14,14,28,5,4,5,2,26,32,2014/2015
"Barton,Will",150,353,.425,23,85,.271,127,268,.474,74,94,.787,26,136,162,81,48,61,19,70,397,2014/2015
"Barton,Will",38,100,.380,4,18,.222,34,82,.415,10,15,.667,3,31,34,27,14,17,4,20,90,2014/2015
"Barton,Will",112,253,.443,19,67,.284,93,186,.500,64,79,.810,23,105,128,54,34,44,15,50,307,2014/2015
"Bass,Brandon",344,683,.504,9,32,.281,335,651,.515,169,214,.790,139,259,398,104,41,83,32,140,866,2014/2015
"Batum,Nicolas",240,600,.400,100,309,.324,140,291,.481,84,98,.857,62,354,416,341,78,132,40,106,664,2014/2015
"Bayless,Jerryd",220,516,.426,37,120,.308,183,396,.462,121,137,.883,22,189,211,233,59,133,12,163,598,2014/2015
"Baynes,Aron",185,327,.566,1,4,.250,184,323,.570,90,104,.865,109,209,318,35,16,65,22,162,461,2014/2015
"Bazemore,Kent",141,331,.426,48,132,.364,93,199,.467,60,100,.600,21,201,222,78,52,73,33,127,390,2014/2015
"Beal,Bradley",363,851,.427,106,259,.409,257,592,.434,130,166,.783,57,184,241,194,76,123,18,136,962,2014/2015
"Beasley,Michael",92,212,.434,8,34,.235,84,178,.472,20,26,.769,12,77,89,32,15,37,13,66,212,2014/2015
"Belinelli,Marco",199,470,.423,86,230,.374,113,240,.471,84,99,.848,26,131,157,94,31,61,3,85,568,2014/2015
"Benimon,Jerrelle",0,0,,0,0,,0,0,,0,0,,1,2,3,0,0,1,0,0,0,2014/2015
"Bennett,Anthony",125,297,.421,7,23,.304,118,274,.431,41,64,.641,52,164,216,48,27,36,16,87,298,2014/2015
"Beverley,Patrick",204,532,.383,115,323,.356,89,209,.426,45,60,.750,67,170,237,192,59,83,23,182,568,2014/2015
"Bhullar,Sim",1,2,.500,0,0,,1,2,.500,0,0,,0,1,1,1,0,0,1,0,2,2014/2015
"Biyombo,Bismack",101,186,.543,0,0,,101,186,.543,102,175,.583,159,248,407,16,18,52,99,140,304,2014/2015
"Black,Tarik",157,273,.575,0,1,.000,157,272,.577,65,118,.551,142,226,368,42,19,48,24,158,379,2014/2015
"Black,Tarik",45,83,.542,0,1,.000,45,82,.549,15,29,.517,58,69,127,8,6,19,2,56,105,2014/2015
"Black,Tarik",112,190,.589,0,0,,112,190,.589,50,89,.562,84,157,241,34,13,29,22,102,274,2014/2015
"Blair,DeJuan",26,57,.456,0,0,,26,57,.456,4,6,.667,16,40,56,3,7,13,1,41,56,2014/2015
"Blake,Steve",122,327,.373,77,219,.352,45,108,.417,29,41,.707,16,121,137,288,41,104,5,118,350,2014/2015
"Bledsoe,Eric",468,1046,.447,88,272,.324,380,774,.491,353,441,.800,72,351,423,493,127,274,45,189,1377,2014/2015
"Blue,Vander",9,30,.300,2,10,.200,7,20,.350,2,5,.400,2,7,9,8,3,6,0,4,22,2014/2015
"Bogdanović,Bojan",261,576,.453,91,256,.355,170,320,.531,87,106,.821,50,163,213,68,34,78,9,104,700,2014/2015
"Bogut,Andrew",200,355,.563,0,0,,200,355,.563,22,42,.524,141,402,543,180,39,106,113,188,422,2014/2015
"Bonner,Matt",94,230,.409,46,126,.365,48,104,.462,30,37,.811,29,86,115,47,10,11,12,65,264,2014/2015
"Booker,Trevor",226,464,.487,29,84,.345,197,380,.518,86,148,.581,139,258,397,83,43,88,41,144,567,2014/2015
"Boozer,Carlos",371,743,.499,0,0,,371,743,.499,94,150,.627,111,371,482,95,41,92,12,184,836,2014/2015
"Bosh,Chris",343,745,.460,63,168,.375,280,577,.485,179,232,.772,46,264,310,95,41,95,25,69,928,2014/2015
"Bradley,Avery",434,1012,.429,124,352,.352,310,660,.470,79,100,.790,46,195,241,135,82,109,15,177,1071,2014/2015
"Brand,Elton",42,95,.442,0,1,.000,42,94,.447,12,23,.522,28,72,100,22,17,18,25,54,96,2014/2015
"Brewer,Corey",343,805,.426,63,235,.268,280,570,.491,168,226,.743,80,217,297,173,114,131,19,173,917,2014/2015
"Brewer,Corey",94,225,.418,8,41,.195,86,184,.467,55,78,.705,32,62,94,78,54,50,4,62,251,2014/2015
"Brewer,Corey",249,580,.429,55,194,.284,194,386,.503,113,148,.764,48,155,203,95,60,81,15,111,666,2014/2015
"Brooks,Aaron",344,817,.421,121,313,.387,223,504,.442,145,174,.833,32,134,166,261,54,157,15,189,954,2014/2015
"Brown,Jabari",70,170,.412,23,62,.371,47,108,.435,64,85,.753,3,33,36,40,12,32,2,33,227,2014/2015
"Brown,Lorenzo",52,122,.426,6,28,.214,46,94,.489,12,19,.632,14,56,70,90,28,30,6,49,122,2014/2015
"Brown,Markel",76,210,.362,17,64,.266,59,146,.404,47,57,.825,16,91,107,39,31,27,12,57,216,2014/2015
"Brown,Shannon",7,19,.368,3,7,.429,4,12,.333,3,4,.750,0,1,1,3,4,4,0,8,20,2014/2015
"Bryant,Kobe",266,713,.373,54,184,.293,212,529,.401,196,241,.813,26,173,199,197,47,128,7,65,782,2014/2015
"Budinger,Chase",169,390,.433,52,143,.364,117,247,.474,67,81,.827,33,165,198,64,44,49,10,72,457,2014/2015
"Bullock,Reggie",24,70,.343,15,46,.326,9,24,.375,6,9,.667,1,49,50,8,10,8,4,19,69,2014/2015
"Bullock,Reggie",23,54,.426,15,39,.385,8,15,.533,4,5,.800,0,40,40,6,9,6,2,17,65,2014/2015
"Bullock,Reggie",1,16,.063,0,7,.000,1,9,.111,2,4,.500,1,9,10,2,1,2,2,2,4,2014/2015
"Burke,Trey",370,1005,.368,124,390,.318,246,615,.400,109,145,.752,31,173,204,328,65,124,15,119,973,2014/2015
"Burks,Alec",121,300,.403,26,68,.382,95,232,.409,106,129,.822,19,95,114,82,17,52,5,64,374,2014/2015
"Butler,Caron",161,396,.407,83,219,.379,78,177,.441,55,61,.902,21,175,196,79,43,49,4,120,460,2014/2015
"Butler,Jimmy",421,912,.462,73,193,.378,348,719,.484,386,463,.834,114,265,379,212,114,93,36,108,1301,2014/2015
"Butler,Rasual",218,517,.422,91,235,.387,127,282,.450,53,67,.791,27,170,197,63,29,48,22,98,580,2014/2015
"Buycks,Dwight",18,40,.450,7,11,.636,11,29,.379,9,10,.900,2,10,12,14,3,12,0,3,52,2014/2015
"Bynum,Will",10,31,.323,0,9,.000,10,22,.455,2,4,.500,2,4,6,18,1,8,1,9,22,2014/2015
"Caboclo,Bruno",4,12,.333,2,3,.667,2,9,.222,0,0,,1,1,2,0,0,4,1,3,10,2014/2015
"Calathes,Nick",104,247,.421,11,43,.256,93,204,.456,24,45,.533,19,87,106,146,63,61,5,100,243,2014/2015
"Calderón,José",147,354,.415,59,142,.415,88,212,.415,29,32,.906,19,105,124,198,31,75,0,76,382,2014/2015
"Caldwell-Pope,Kentavious",390,972,.401,153,444,.345,237,528,.449,110,158,.696,46,209,255,109,93,94,18,161,1043,2014/2015
"Canaan,Isaiah",146,378,.386,91,246,.370,55,132,.417,49,60,.817,18,69,87,98,29,62,3,83,432,2014/2015
"Canaan,Isaiah",53,131,.405,32,84,.381,21,47,.447,16,21,.762,11,22,33,29,14,23,0,28,154,2014/2015
"Canaan,Isaiah",93,247,.377,59,162,.364,34,85,.400,33,39,.846,7,47,54,69,15,39,3,55,278,2014/2015
"Capela,Clint",14,29,.483,0,0,,14,29,.483,4,23,.174,10,26,36,2,1,5,9,14,32,2014/2015
"Carroll,DeMarre",318,653,.487,120,304,.395,198,349,.567,127,181,.702,99,273,372,118,94,75,17,154,883,2014/2015
"Carter,Vince",135,406,.333,69,232,.297,66,174,.379,45,57,.789,27,106,133,79,43,43,14,102,384,2014/2015
"Carter-Williams,Michael",364,919,.396,36,153,.235,328,766,.428,202,291,.694,64,289,353,442,111,253,30,167,966,2014/2015
"Carter-Williams,Michael",232,611,.380,32,125,.256,200,486,.412,117,182,.643,43,211,254,302,60,174,18,103,613,2014/2015
"Carter-Williams,Michael",132,308,.429,4,28,.143,128,280,.457,85,109,.780,21,78,99,140,51,79,12,64,353,2014/2015
"Casspi,Omri",209,427,.489,35,87,.402,174,340,.512,140,191,.733,54,206,260,102,31,88,9,107,593,2014/2015
"Chalmers,Mario",267,663,.403,73,248,.294,194,415,.467,206,266,.774,24,182,206,307,122,173,10,251,813,2014/2015
"Chandler,Tyson",293,440,.666,0,0,,293,440,.666,185,257,.720,294,570,864,84,42,105,91,169,771,2014/2015
"Chandler,Wilson",418,975,.429,139,406,.342,279,569,.490,110,142,.775,96,379,475,134,58,110,29,231,1085,2014/2015
"Cherry,Will",5,19,.263,2,9,.222,3,10,.300,3,6,.500,1,4,5,8,6,4,1,10,15,2014/2015
"Christopher,Patrick",3,12,.250,0,4,.000,3,8,.375,0,0,,2,4,6,0,1,1,0,6,6,2014/2015
"Clark,Earl",11,30,.367,4,14,.286,7,16,.438,1,4,.250,1,22,23,3,3,6,4,12,27,2014/2015
"Clark,Ian",19,55,.345,10,30,.333,9,25,.360,9,9,1.000,4,12,16,12,9,9,3,20,57,2014/2015
"Clark,Ian",15,44,.341,9,25,.360,6,19,.316,5,5,1.000,4,9,13,10,6,7,2,12,44,2014/2015
"Clark,Ian",4,11,.364,1,5,.200,3,6,.500,4,4,1.000,0,3,3,2,3,2,1,8,13,2014/2015
"Clarkson,Jordan",267,596,.448,38,121,.314,229,475,.482,131,158,.829,56,135,191,206,51,96,12,109,703,2014/2015
"Claver,Victor",9,20,.450,6,11,.545,3,9,.333,0,0,,3,17,20,1,1,4,1,12,24,2014/2015
"Cole,Norris",230,558,.412,55,176,.313,175,382,.458,58,81,.716,13,146,159,255,57,99,15,124,573,2014/2015
"Cole,Norris",118,306,.386,27,102,.265,91,204,.446,32,46,.696,12,96,108,165,42,58,8,75,295,2014/2015
"Cole,Norris",112,252,.444,28,74,.378,84,178,.472,26,35,.743,1,50,51,90,15,41,7,49,278,2014/2015
"Collison,Darren",260,550,.473,60,161,.373,200,389,.514,145,184,.788,19,124,143,252,67,112,14,95,725,2014/2015
"Collison,Nick",106,253,.419,16,60,.267,90,193,.466,45,65,.692,90,160,250,90,35,45,25,156,273,2014/2015
"Conley,Mike",393,882,.446,107,277,.386,286,605,.473,214,249,.859,29,180,209,375,89,156,14,139,1107,2014/2015
"Cooley,Jack",9,22,.409,0,0,,9,22,.409,9,21,.429,10,15,25,1,6,3,3,23,27,2014/2015
"Copeland,Chris",112,310,.361,52,167,.311,60,143,.420,33,45,.733,23,88,111,51,11,59,11,78,309,2014/2015
"Cotton,Bryce",29,69,.420,7,20,.350,22,49,.449,15,18,.833,3,15,18,15,4,12,0,6,80,2014/2015
"Cousins,DeMarcus",498,1066,.467,2,8,.250,496,1058,.469,423,541,.782,185,562,747,210,90,254,103,241,1421,2014/2015
"Covington,Robert",299,756,.396,167,446,.374,132,310,.426,178,217,.820,65,251,316,105,97,128,31,189,943,2014/2015
"Crabbe,Allen",63,153,.412,30,85,.353,33,68,.485,12,16,.750,7,66,73,39,19,15,15,74,168,2014/2015
"Crawford,Jamal",332,839,.396,119,364,.327,213,475,.448,227,252,.901,18,106,124,158,59,92,14,108,1010,2014/2015
"Crowder,Jae",229,545,.420,61,208,.293,168,337,.499,109,141,.773,72,221,293,94,72,49,25,137,628,2014/2015
"Crowder,Jae",33,76,.434,13,38,.342,20,38,.526,10,11,.909,12,17,29,12,15,10,5,26,89,2014/2015
"Crowder,Jae",196,469,.418,48,170,.282,148,299,.495,99,130,.762,60,204,264,82,57,39,20,111,539,2014/2015
"Cunningham,Dante",155,339,.457,1,10,.100,154,329,.468,29,47,.617,70,186,256,50,46,35,37,101,340,2014/2015
"Cunningham,Jared",12,33,.364,4,13,.308,8,20,.400,7,13,.538,1,8,9,10,3,7,0,12,35,2014/2015
"Curry,Seth",0,3,.000,0,1,.000,0,2,.000,0,0,,0,2,2,1,0,0,0,2,0,2014/2015
"Curry,Stephen",653,1341,.487,286,646,.443,367,695,.528,308,337,.914,56,285,341,619,163,249,16,158,1900,2014/2015
"Dalembert,Samuel",57,130,.438,0,0,,57,130,.438,14,20,.700,53,115,168,29,14,39,41,70,128,2014/2015
"Daniels,Troy",61,165,.370,43,118,.364,18,47,.383,11,13,.846,8,25,33,22,6,20,1,40,176,2014/2015
"Daniels,Troy",15,47,.319,13,43,.302,2,4,.500,3,4,.750,0,6,6,4,0,5,0,14,46,2014/2015
"Daniels,Troy",19,59,.322,13,39,.333,6,20,.300,2,2,1.000,6,13,19,13,3,8,0,14,53,2014/2015
"Daniels,Troy",27,59,.458,17,36,.472,10,23,.435,6,7,.857,2,6,8,5,3,7,1,12,77,2014/2015
"Datome,Luigi",43,89,.483,18,40,.450,25,49,.510,1,1,1.000,3,26,29,9,2,9,7,15,105,2014/2015
"Datome,Luigi",5,12,.417,1,4,.250,4,8,.500,0,0,,1,3,4,2,1,2,0,1,11,2014/2015
"Datome,Luigi",38,77,.494,17,36,.472,21,41,.512,1,1,1.000,2,23,25,7,1,7,7,14,94,2014/2015
"Davies,Brandon",55,137,.401,8,34,.235,47,103,.456,24,37,.649,38,45,83,30,18,29,7,59,142,2014/2015
"Davies,Brandon",49,119,.412,7,30,.233,42,89,.472,21,33,.636,35,38,73,28,17,25,4,54,126,2014/2015
"Davies,Brandon",6,18,.333,1,4,.250,5,14,.357,3,4,.750,3,7,10,2,1,4,3,5,16,2014/2015
"Davis,Anthony",642,1199,.535,1,12,.083,641,1187,.540,371,461,.805,173,523,696,149,100,95,200,141,1656,2014/2015
"Davis,Ed",282,469,.601,0,0,,282,469,.601,92,189,.487,230,370,600,94,49,58,98,202,656,2014/2015
"Davis,Glen",117,255,.459,0,4,.000,117,251,.466,60,95,.632,43,126,169,39,41,39,21,132,294,2014/2015
"Dawkins,Andre",1,6,.167,1,6,.167,0,0,,0,0,,0,2,2,1,0,1,0,3,3,2014/2015
"Daye,Austin",50,141,.355,24,71,.338,26,70,.371,5,6,.833,10,65,75,17,12,23,5,39,129,2014/2015
"Daye,Austin",40,115,.348,19,57,.333,21,58,.362,4,4,1.000,6,55,61,9,8,18,3,30,103,2014/2015
"Daye,Austin",10,26,.385,5,14,.357,5,12,.417,1,2,.500,4,10,14,8,4,5,2,9,26,2014/2015
"Dedmon,Dewayne",91,162,.562,0,1,.000,91,161,.565,34,64,.531,118,177,295,9,16,51,50,141,216,2014/2015
"Dellavedova,Matthew",111,307,.362,68,167,.407,43,140,.307,29,38,.763,37,89,126,204,24,61,2,152,319,2014/2015
"Deng,Luol",369,787,.469,78,220,.355,291,567,.513,191,251,.761,103,273,376,139,65,108,22,109,1007,2014/2015
"DeRozan,DeMar",409,990,.413,25,88,.284,384,902,.426,361,434,.832,41,236,277,210,73,137,11,122,1204,2014/2015
"Diaw,Boris",291,632,.460,54,169,.320,237,463,.512,72,93,.774,78,270,348,233,36,126,23,148,708,2014/2015
"Dieng,Gorgui",259,512,.506,1,6,.167,258,506,.510,191,244,.783,223,386,609,146,71,126,126,188,710,2014/2015
"Dinwiddie,Spencer",51,169,.302,12,65,.185,39,104,.375,31,34,.912,4,44,48,104,19,33,6,53,145,2014/2015
"Dorsey,Joey",80,145,.552,0,1,.000,80,144,.556,24,83,.289,103,176,279,25,40,41,25,157,184,2014/2015
"Douglas,Toney",19,51,.373,5,18,.278,14,33,.424,8,13,.615,2,20,22,24,11,10,4,20,51,2014/2015
"Douglas-Roberts,Chris",5,21,.238,1,7,.143,4,14,.286,8,8,1.000,1,11,12,4,1,0,0,14,19,2014/2015
"Dragić,Goran",502,1002,.501,90,259,.347,412,743,.555,181,234,.774,81,193,274,350,78,173,15,195,1275,2014/2015
"Dragić,Goran",340,679,.501,66,186,.355,274,493,.556,97,130,.746,51,134,185,211,50,114,9,120,843,2014/2015
"Dragić,Goran",162,323,.502,24,73,.329,138,250,.552,84,104,.808,30,59,89,139,28,59,6,75,432,2014/2015
"Dragić,Zoran",11,30,.367,3,14,.214,8,16,.500,3,5,.600,5,3,8,5,2,5,0,6,28,2014/2015
"Dragić,Zoran",2,8,.250,0,5,.000,2,3,.667,2,3,.667,2,1,3,1,0,0,0,1,6,2014/2015
"Dragić,Zoran",9,22,.409,3,9,.333,6,13,.462,1,2,.500,3,2,5,4,2,5,0,5,22,2014/2015
"Drew,Larry",20,58,.345,4,26,.154,16,32,.500,2,3,.667,1,14,15,45,6,25,0,13,46,2014/2015
"Drummond,Andre",494,961,.514,0,2,.000,494,959,.515,142,365,.389,437,667,1104,55,73,120,153,285,1130,2014/2015
"Dudley,Jared",198,423,.468,74,192,.385,124,231,.537,48,67,.716,45,175,220,130,72,62,11,113,518,2014/2015
"Duncan,Tim",419,819,.512,2,7,.286,417,812,.514,230,311,.740,170,534,704,230,63,131,151,165,1070,2014/2015
"Dunleavy,Mike",209,481,.435,107,263,.407,102,218,.468,70,87,.805,28,220,248,114,39,60,21,123,595,2014/2015
"Durant,Kevin",238,467,.510,64,159,.403,174,308,.565,146,171,.854,16,162,178,110,24,74,25,40,686,2014/2015
"Early,Cleanthony",76,214,.355,22,84,.262,54,130,.415,36,48,.750,22,75,97,36,24,40,12,57,210,2014/2015
"Ellington,Wayne",254,617,.412,90,243,.370,164,374,.439,52,64,.813,31,179,210,105,33,50,2,77,650,2014/2015
"Ellis,Monta",602,1354,.445,81,284,.285,521,1070,.487,228,303,.752,34,156,190,329,148,198,25,197,1513,2014/2015
"Ennis,James",101,247,.409,31,95,.326,70,152,.461,79,94,.840,51,125,176,48,25,39,17,89,312,2014/2015
"Ennis,Tyler",52,144,.361,12,43,.279,40,101,.396,5,7,.714,7,28,35,73,18,42,5,36,121,2014/2015
"Ennis,Tyler",9,21,.429,2,6,.333,7,15,.467,2,2,1.000,1,6,7,14,0,8,2,3,22,2014/2015
"Ennis,Tyler",43,123,.350,10,37,.270,33,86,.384,3,5,.600,6,22,28,59,18,34,3,33,99,2014/2015
"Evans,Jeremy",32,58,.552,2,5,.400,30,53,.566,24,29,.828,26,45,71,13,11,5,12,29,90,2014/2015
"Evans,Reggie",58,137,.423,0,2,.000,58,135,.430,60,97,.619,97,202,299,32,22,45,5,91,176,2014/2015
"Evans,Tyreke",521,1165,.447,69,227,.304,452,938,.482,202,291,.694,82,334,416,521,100,246,37,198,1313,2014/2015
"Exum,Dante",145,416,.349,83,264,.314,62,152,.408,20,32,.625,27,104,131,198,41,118,14,147,393,2014/2015
"Ezeli,Festus",76,139,.547,0,0,,76,139,.547,49,78,.628,60,95,155,9,7,32,42,77,201,2014/2015
"Faried,Kenneth",373,736,.507,1,8,.125,372,728,.511,199,288,.691,242,426,668,89,62,118,57,211,946,2014/2015
"Farmar,Jordan",61,158,.386,35,97,.361,26,61,.426,10,11,.909,8,34,42,67,20,32,5,52,167,2014/2015
"Favors,Derrick",482,918,.525,1,6,.167,481,912,.527,222,332,.669,196,411,607,112,60,121,123,210,1187,2014/2015
"Felton,Raymond",43,106,.406,10,34,.294,33,72,.458,12,15,.800,2,24,26,41,11,18,4,17,108,2014/2015
"Fields,Landry",20,41,.488,1,2,.500,19,39,.487,5,6,.833,10,16,26,15,11,8,0,9,46,2014/2015
"Fournier,Evan",253,575,.440,85,225,.378,168,350,.480,107,147,.728,28,125,153,120,40,82,2,116,698,2014/2015
"Foye,Randy",148,402,.368,94,263,.357,54,139,.388,45,55,.818,9,76,85,119,34,60,11,97,435,2014/2015
"Franklin,Jamaal",1,2,.500,1,2,.500,0,0,,0,0,,1,1,2,3,0,3,1,4,3,2014/2015
"Frazier,Tim",21,61,.344,5,17,.294,16,44,.364,10,21,.476,6,22,28,60,8,25,0,26,57,2014/2015
"Frazier,Tim",13,43,.302,3,11,.273,10,32,.313,5,15,.333,4,15,19,43,6,18,0,16,34,2014/2015
"Frazier,Tim",8,18,.444,2,6,.333,6,12,.500,5,6,.833,2,7,9,17,2,7,0,10,23,2014/2015
"Fredette,Jimmer",63,166,.380,9,48,.188,54,118,.458,43,45,.956,8,32,40,58,15,33,2,43,178,2014/2015
"Freeland,Joel",74,151,.490,0,0,,74,151,.490,21,25,.840,62,129,191,16,9,23,23,93,169,2014/2015
"Frye,Channing",191,487,.392,136,346,.393,55,141,.390,31,35,.886,27,266,293,94,47,78,39,191,549,2014/2015
"Gallinari,Danilo",228,568,.401,107,301,.355,121,267,.453,171,191,.895,31,187,218,83,47,57,20,94,734,2014/2015
"Galloway,Langston",204,511,.399,62,176,.352,142,335,.424,63,78,.808,37,153,190,150,52,61,12,129,533,2014/2015
"García,Francisco",17,63,.270,10,45,.222,7,18,.389,1,4,.250,3,14,17,15,9,10,5,20,45,2014/2015
"Garnett,Kevin",143,306,.467,1,7,.143,142,299,.475,36,45,.800,48,263,311,77,46,46,17,109,323,2014/2015
"Garnett,Kevin",125,275,.455,1,6,.167,124,269,.461,34,41,.829,46,239,285,69,41,45,13,96,285,2014/2015
"Garnett,Kevin",18,31,.581,0,1,.000,18,30,.600,2,4,.500,2,24,26,8,5,1,4,13,38,2014/2015
"Gasol,Marc",530,1072,.494,3,17,.176,527,1055,.500,350,440,.795,115,515,630,307,70,176,131,208,1413,2014/2015
"Gasol,Pau",570,1153,.494,12,26,.462,558,1127,.495,294,366,.803,220,699,919,210,25,158,147,147,1446,2014/2015
"Gay,Rudy",508,1116,.455,79,220,.359,429,896,.479,337,393,.858,98,301,399,250,71,183,41,157,1432,2014/2015
"Gee,Alonzo",87,186,.468,13,35,.371,74,151,.490,54,77,.701,37,57,94,25,35,33,7,58,241,2014/2015
"Gee,Alonzo",66,137,.482,10,24,.417,56,113,.496,48,65,.738,29,41,70,19,28,25,6,42,190,2014/2015
"Gee,Alonzo",21,49,.429,3,11,.273,18,38,.474,6,12,.500,8,16,24,6,7,8,1,16,51,2014/2015
"George,Paul",18,49,.367,9,22,.409,9,27,.333,8,11,.727,4,18,22,6,5,12,1,11,53,2014/2015
"Gibson,Taj",254,506,.502,0,0,,254,506,.502,132,184,.717,162,234,396,71,36,77,75,162,640,2014/2015
"Ginóbili,Manu",251,589,.426,89,258,.345,162,331,.489,147,204,.721,28,183,211,293,67,154,20,138,738,2014/2015
"Gobert,Rudy",258,427,.604,0,2,.000,258,425,.607,170,273,.623,265,510,775,109,64,111,189,175,686,2014/2015
"Gooden,Drew",110,276,.399,23,59,.390,87,217,.401,34,44,.773,72,151,223,49,21,28,9,91,277,2014/2015
"Goodwin,Archie",79,201,.393,12,41,.293,67,160,.419,61,83,.735,27,47,74,44,18,48,9,55,231,2014/2015
"Gordon,Aaron",93,208,.447,13,48,.271,80,160,.500,44,61,.721,46,123,169,33,21,38,22,83,243,2014/2015
"Gordon,Ben",129,295,.437,35,97,.361,94,198,.475,56,67,.836,6,57,63,50,14,55,1,60,349,2014/2015
"Gordon,Drew",8,19,.421,0,3,.000,8,16,.500,1,2,.500,7,11,18,2,1,8,0,7,17,2014/2015
"Gordon,Eric",285,694,.411,141,315,.448,144,379,.380,107,133,.805,28,131,159,229,50,122,14,145,818,2014/2015
"Gortat,Marcin",439,775,.566,0,3,.000,439,772,.569,123,175,.703,180,537,717,97,49,100,110,191,1001,2014/2015
"Granger,Danny",65,162,.401,30,84,.357,35,78,.449,28,37,.757,20,60,80,17,13,24,6,67,188,2014/2015
"Grant,Jerami",124,352,.352,49,156,.314,75,196,.383,114,193,.591,49,149,198,79,40,85,68,144,411,2014/2015
"Green,Danny",322,738,.436,191,457,.418,131,281,.466,111,127,.874,54,289,343,158,101,93,87,163,946,2014/2015
"Green,Draymond",339,765,.443,111,329,.337,228,436,.523,132,200,.660,114,533,647,291,123,133,99,253,921,2014/2015
"Green,Erick",61,162,.377,14,47,.298,47,115,.409,10,12,.833,7,24,31,39,12,14,0,26,146,2014/2015
"Green,Gerald",324,778,.416,137,387,.354,187,391,.478,99,120,.825,33,153,186,91,42,104,12,145,884,2014/2015
"Green,JaMychal",27,47,.574,0,6,.000,27,41,.659,8,10,.800,19,26,45,4,5,14,5,25,62,2014/2015
"Green,JaMychal",4,7,.571,0,2,.000,4,5,.800,0,0,,3,3,6,0,0,2,2,6,8,2014/2015
"Green,JaMychal",23,40,.575,0,4,.000,23,36,.639,8,10,.800,16,23,39,4,5,12,3,19,54,2014/2015
"Green,Jeff",416,967,.430,97,292,.332,319,675,.473,239,287,.833,64,264,328,134,53,108,34,147,1168,2014/2015
"Green,Jeff",206,475,.434,47,154,.305,159,321,.495,121,144,.840,21,120,141,53,27,56,13,66,580,2014/2015
"Green,Jeff",210,492,.427,50,138,.362,160,354,.452,118,143,.825,43,144,187,81,26,52,21,81,588,2014/2015
"Green,Willie",118,306,.386,42,121,.347,76,185,.411,28,34,.824,14,65,79,68,26,48,5,81,306,2014/2015
"Griffin,Blake",574,1144,.502,10,25,.400,564,1119,.504,311,427,.728,126,382,508,354,63,152,35,196,1469,2014/2015
"Gutiérrez,Jorge",22,41,.537,0,3,.000,22,38,.579,9,13,.692,5,20,25,22,6,12,0,25,53,2014/2015
"Gutiérrez,Jorge",7,14,.500,0,1,.000,7,13,.538,2,3,.667,0,7,7,7,1,3,0,9,16,2014/2015
"Gutiérrez,Jorge",15,27,.556,0,2,.000,15,25,.600,7,10,.700,5,13,18,15,5,9,0,16,37,2014/2015
"Hairston,P.J.",87,269,.323,49,163,.301,38,106,.358,31,36,.861,22,70,92,21,21,22,13,61,254,2014/2015
"Hamilton,Jordan",14,35,.400,10,21,.476,4,14,.286,0,0,,2,14,16,7,2,4,0,14,38,2014/2015
"Hamilton,Justin",85,178,.478,10,31,.323,75,147,.510,39,47,.830,57,77,134,36,27,26,30,70,219,2014/2015
"Hamilton,Justin",27,65,.415,6,19,.316,21,46,.457,6,7,.857,24,24,48,12,8,8,5,33,66,2014/2015
"Hamilton,Justin",58,113,.513,4,12,.333,54,101,.535,33,40,.825,33,53,86,24,19,18,25,37,153,2014/2015
"Hansbrough,Tyler",86,165,.521,1,7,.143,85,158,.538,97,139,.698,106,159,265,21,30,20,15,141,270,2014/2015
"Hardaway,Tim",279,717,.389,121,354,.342,158,363,.435,125,156,.801,12,144,156,127,20,82,14,119,804,2014/2015
"Harden,James",647,1470,.440,208,555,.375,439,915,.480,715,824,.868,75,384,459,565,154,321,60,208,2217,2014/2015
"Harkless,Maurice",63,158,.399,10,56,.179,53,102,.520,22,41,.537,38,68,106,25,32,27,9,66,158,2014/2015
"Harris,Devin",219,524,.418,95,266,.357,124,258,.481,132,162,.815,13,122,135,237,78,85,14,147,665,2014/2015
"Harris,Gary",66,217,.304,21,103,.204,45,114,.395,35,47,.745,21,43,64,29,39,38,7,71,188,2014/2015
"Harris,Joe",48,120,.400,31,84,.369,17,36,.472,9,15,.600,7,34,41,26,7,27,2,62,136,2014/2015
"Harris,Tobias",442,949,.466,87,239,.364,355,710,.500,193,245,.788,73,357,430,124,69,115,36,134,1164,2014/2015
"Haslem,Udonis",107,239,.448,2,10,.200,105,229,.459,45,64,.703,71,187,258,46,21,41,13,113,261,2014/2015
"Hawes,Spencer",163,415,.393,55,176,.313,108,239,.452,44,68,.647,30,228,258,88,24,61,53,173,425,2014/2015
"Hayes,Chuck",22,46,.478,0,0,,22,46,.478,6,11,.545,18,33,51,20,10,8,4,37,50,2014/2015
"Hayward,Gordon",484,1087,.445,120,330,.364,364,757,.481,375,462,.812,54,319,373,313,108,206,30,131,1463,2014/2015
"Haywood,Brendan",14,30,.467,0,0,,14,30,.467,7,13,.538,6,23,29,2,2,10,10,17,35,2014/2015
"Henderson,Gerald",370,847,.437,45,136,.331,325,711,.457,184,217,.848,36,237,273,206,51,110,22,135,969,2014/2015
"Henry,Xavier",3,13,.231,0,0,,3,13,.231,14,24,.583,2,2,4,3,3,3,0,6,20,2014/2015
"Henson,John",196,346,.566,0,0,,196,346,.566,78,137,.569,124,188,312,59,28,87,135,152,470,2014/2015
"Hibbert,Roy",317,710,.446,0,2,.000,317,708,.448,168,204,.824,156,384,540,84,18,107,125,216,802,2014/2015
"Hickson,J.J.",218,459,.475,0,2,.000,218,457,.477,116,201,.577,150,302,452,57,36,96,35,136,552,2014/2015
"Hilário,Nenê",307,601,.511,1,5,.200,306,596,.513,122,202,.604,84,261,345,123,66,124,22,180,737,2014/2015
"Hill,George",255,535,.477,69,193,.358,186,342,.544,113,143,.790,25,154,179,220,44,69,14,111,692,2014/2015
"Hill,Jordan",357,777,.459,3,11,.273,354,766,.462,124,168,.738,174,382,556,103,34,106,52,164,841,2014/2015
"Hill,Solomon",251,634,.396,68,208,.327,183,426,.430,159,193,.824,70,244,314,184,66,115,18,177,729,2014/2015
"Hinrich,Kirk",142,381,.373,58,168,.345,84,213,.394,35,50,.700,20,101,121,148,46,73,14,144,377,2014/2015
"Holiday,Jrue",238,534,.446,51,135,.378,187,399,.469,65,76,.855,32,103,135,274,63,91,23,110,592,2014/2015
"Holiday,Justin",91,235,.387,35,109,.321,56,126,.444,37,45,.822,12,61,73,48,40,29,12,54,254,2014/2015
"Hollins,Ryan",53,82,.646,0,0,,53,82,.646,31,54,.574,36,67,103,14,6,25,19,65,137,2014/2015
"Hood,Rodney",155,374,.414,62,170,.365,93,204,.456,61,80,.763,9,108,117,83,30,45,12,119,433,2014/2015
"Horford,Al",519,965,.538,11,36,.306,508,929,.547,107,141,.759,131,413,544,244,68,100,98,121,1156,2014/2015
"Howard,Dwight",251,423,.593,1,2,.500,250,421,.594,143,271,.528,110,321,431,50,28,115,53,137,646,2014/2015
"Hudson,Lester",6,14,.429,3,6,.500,3,8,.375,3,4,.750,1,7,8,5,6,3,1,4,18,2014/2015
"Hummel,Robbie",79,172,.459,16,51,.314,63,121,.521,24,29,.828,31,103,134,27,16,18,9,86,198,2014/2015
"Humphries,Kris",211,446,.473,0,7,.000,211,439,.481,87,117,.744,118,298,416,57,34,46,25,130,509,2014/2015
"Ibaka,Serge",374,786,.476,77,205,.376,297,581,.511,92,110,.836,135,364,499,55,30,97,155,194,917,2014/2015
"Iguodala,Andre",231,496,.466,74,212,.349,157,284,.553,68,114,.596,44,213,257,228,89,88,25,100,604,2014/2015
"İlyasova,Ersan",263,557,.472,74,190,.389,189,367,.515,69,107,.645,80,197,277,56,36,45,19,149,669,2014/2015
"Ingles,Joe",147,354,.415,72,202,.356,75,152,.493,30,40,.750,22,153,175,182,72,98,10,124,396,2014/2015
"Irving,Kyrie",578,1235,.468,157,378,.415,421,857,.491,315,365,.863,55,182,237,389,114,186,20,146,1628,2014/2015
"Jack,Jarrett",359,817,.439,39,146,.267,320,671,.477,200,227,.881,19,226,245,373,75,191,13,143,957,2014/2015
"Jackson,Reggie",432,996,.434,72,241,.299,360,755,.477,181,218,.830,56,271,327,462,62,186,9,167,1117,2014/2015
"Jackson,Reggie",249,576,.432,44,158,.278,205,418,.490,99,115,.861,28,173,201,214,42,91,5,94,641,2014/2015
"Jackson,Reggie",183,420,.436,28,83,.337,155,337,.460,82,103,.796,28,98,126,248,20,95,4,73,476,2014/2015
"James,Bernard",12,27,.444,0,0,,12,27,.444,20,23,.870,18,21,39,4,2,6,15,17,44,2014/2015
"James,LeBron",624,1279,.488,120,339,.354,504,940,.536,375,528,.710,51,365,416,511,109,272,49,135,1743,2014/2015
"Jefferson,Al",486,1010,.481,2,5,.400,484,1005,.482,108,165,.655,99,449,548,113,47,68,84,139,1082,2014/2015
"Jefferson,Cory",75,167,.449,2,15,.133,73,152,.480,31,54,.574,47,98,145,16,10,20,21,61,183,2014/2015
"Jefferson,Richard",144,324,.444,66,155,.426,78,169,.462,78,114,.684,25,158,183,61,32,52,11,115,432,2014/2015
"Jenkins,John",49,99,.495,21,52,.404,28,47,.596,16,19,.842,2,37,39,13,10,8,0,15,135,2014/2015
"Jennings,Brandon",218,543,.401,76,211,.360,142,332,.428,120,143,.839,21,83,104,272,44,90,4,64,632,2014/2015
"Jerebko,Jonas",169,379,.446,54,140,.386,115,239,.481,56,66,.848,93,189,282,71,46,44,18,135,448,2014/2015
"Jerebko,Jonas",91,198,.460,28,76,.368,63,122,.516,31,36,.861,47,95,142,41,27,26,11,77,241,2014/2015
"Jerebko,Jonas",78,181,.431,26,64,.406,52,117,.444,25,30,.833,46,94,140,30,19,18,7,58,207,2014/2015
"Jerrett,Grant",7,26,.269,1,15,.067,6,11,.545,1,1,1.000,2,7,9,3,2,3,2,11,16,2014/2015
"Jerrett,Grant",3,17,.176,1,13,.077,2,4,.500,0,0,,1,3,4,1,0,2,2,7,7,2014/2015
"Jerrett,Grant",4,9,.444,0,2,.000,4,7,.571,1,1,1.000,1,4,5,2,2,1,0,4,9,2014/2015
"Johnson,Amir",298,519,.574,19,46,.413,279,473,.590,79,129,.612,159,297,456,117,44,110,59,225,694,2014/2015
"Johnson,Chris",62,154,.403,28,95,.295,34,59,.576,14,16,.875,8,47,55,15,26,15,7,44,166,2014/2015
"Johnson,Chris",19,60,.317,10,39,.256,9,21,.429,6,8,.750,3,23,26,3,9,9,5,19,54,2014/2015
"Johnson,Chris",31,64,.484,13,38,.342,18,26,.692,6,6,1.000,3,15,18,7,12,6,0,18,81,2014/2015
"Johnson,Chris",12,30,.400,5,18,.278,7,12,.583,2,2,1.000,2,9,11,5,5,0,2,7,31,2014/2015
"Johnson,James",238,404,.589,11,51,.216,227,353,.643,67,102,.657,61,196,257,95,54,79,70,155,554,2014/2015
"Johnson,Joe",446,1025,.435,121,337,.359,325,688,.472,141,176,.801,53,331,384,292,59,137,14,120,1154,2014/2015
"Johnson,Nick",26,75,.347,5,21,.238,21,54,.389,17,25,.680,13,26,39,11,7,19,3,34,74,2014/2015
"Johnson,Tyler",70,167,.419,18,48,.375,52,119,.437,32,47,.681,14,67,81,42,33,30,9,42,190,2014/2015
"Johnson,Wesley",286,691,.414,91,259,.351,195,432,.451,90,112,.804,67,252,319,124,59,87,45,162,753,2014/2015
"Jones,Dahntay",6,21,.286,0,4,.000,6,17,.353,9,11,.818,1,10,11,2,3,1,0,23,21,2014/2015
"Jones,James",74,201,.368,63,175,.360,11,26,.423,39,46,.848,9,53,62,24,13,13,8,67,250,2014/2015
"Jones,Perry",73,184,.397,14,60,.233,59,124,.476,24,37,.649,6,70,76,18,17,24,8,50,184,2014/2015
"Jones,Terrence",158,299,.528,13,37,.351,145,262,.553,57,94,.606,78,142,220,36,18,37,59,78,386,2014/2015
"Jordan,DeAndre",379,534,.710,1,4,.250,378,530,.713,187,471,.397,397,829,1226,61,81,109,183,245,946,2014/2015
"Jordan,Jerome",50,94,.532,0,0,,50,94,.532,38,44,.864,52,53,105,13,8,22,15,58,138,2014/2015
"Joseph,Cory",207,411,.504,16,44,.364,191,367,.520,105,143,.734,44,148,192,188,46,67,17,105,535,2014/2015
"Kaman,Chris",283,549,.515,0,0,,283,549,.515,72,102,.706,149,335,484,65,18,108,54,140,638,2014/2015
"Kanter,Enes",482,928,.519,16,45,.356,466,883,.528,183,234,.782,277,394,671,55,36,145,29,189,1163,2014/2015
"Kanter,Enes",286,582,.491,13,41,.317,273,541,.505,93,118,.788,147,237,384,26,23,93,16,114,678,2014/2015
"Kanter,Enes",196,346,.566,3,4,.750,193,342,.564,90,116,.776,130,157,287,29,13,52,13,75,485,2014/2015
"Karasev,Sergey",54,134,.403,16,54,.296,38,80,.475,29,38,.763,22,44,66,46,23,24,1,45,153,2014/2015
"Kelly,Ryan",104,309,.337,45,134,.336,59,175,.337,79,95,.832,13,133,146,92,30,37,24,118,332,2014/2015
"Kidd-Gilchrist,Michael",224,482,.465,0,0,,224,482,.465,150,214,.701,109,307,416,77,30,63,38,115,598,2014/2015
"Kilpatrick,Sean",7,20,.350,4,13,.308,3,7,.429,4,4,1.000,1,5,6,4,3,2,0,3,22,2014/2015
"Kirilenko,Andrei",0,5,.000,0,0,,0,5,.000,3,4,.750,2,6,8,1,1,1,0,1,3,2014/2015
"Kirk,Alex",1,4,.250,0,0,,1,4,.250,2,2,1.000,1,0,1,1,0,0,0,1,4,2014/2015
"Knight,Brandon",375,888,.422,125,321,.389,250,567,.441,195,223,.874,28,216,244,330,90,189,10,114,1070,2014/2015
"Knight,Brandon",324,745,.435,104,254,.409,220,491,.448,171,194,.881,26,195,221,281,84,166,9,93,923,2014/2015
"Knight,Brandon",51,143,.357,21,67,.313,30,76,.395,24,29,.828,2,21,23,49,6,23,1,21,147,2014/2015
"Korver,Kyle",292,600,.487,221,449,.492,71,151,.470,106,118,.898,15,289,304,196,52,107,42,140,911,2014/2015
"Koufos,Kosta",182,358,.508,0,0,,182,358,.508,55,85,.647,121,305,426,37,29,69,63,148,419,2014/2015
"Kuzmić,Ognjen",8,12,.667,0,0,,8,12,.667,4,4,1.000,7,10,17,6,2,5,1,13,20,2014/2015
"Lamb,Jeremy",104,250,.416,38,111,.342,66,139,.475,49,55,.891,8,99,107,44,21,27,6,52,295,2014/2015
"Landry,Carl",190,369,.515,0,0,,190,369,.515,123,150,.820,99,169,268,26,15,54,17,132,503,2014/2015
"Larkin,Shane",187,432,.433,35,116,.302,152,316,.481,61,78,.782,29,147,176,226,93,83,9,150,470,2014/2015
"Lauvergne,Joffrey",36,89,.404,3,16,.188,33,73,.452,18,28,.643,27,50,77,13,8,22,10,43,93,2014/2015
"LaVine,Zach",286,677,.422,57,167,.341,229,510,.449,149,177,.842,27,187,214,276,54,193,10,158,778,2014/2015
"Lawson,Ty",404,926,.436,70,205,.341,334,721,.463,265,363,.730,42,192,234,720,92,185,9,128,1143,2014/2015
"Ledo,Ricky",32,96,.333,10,27,.370,22,69,.319,16,22,.727,16,20,36,19,6,26,1,21,90,2014/2015
"Ledo,Ricky",0,6,.000,0,3,.000,0,3,.000,1,2,.500,1,1,2,1,0,2,0,1,1,2014/2015
"Ledo,Ricky",32,90,.356,10,24,.417,22,66,.333,15,20,.750,15,19,34,18,6,24,1,20,89,2014/2015
"Lee,Courtney",288,643,.448,90,224,.402,198,419,.473,111,129,.860,21,157,178,151,75,78,12,129,777,2014/2015
"Lee,David",160,313,.511,0,2,.000,160,311,.514,68,104,.654,81,176,257,85,31,49,26,83,388,2014/2015
"Lee,Malcolm",0,1,.000,0,0,,0,1,.000,0,0,,0,0,0,0,0,0,0,0,0,2014/2015
"Len,Alex",179,353,.507,1,3,.333,178,350,.509,73,104,.702,142,312,454,32,34,74,105,213,432,2014/2015
"Leonard,Kawhi",394,822,.479,67,192,.349,327,630,.519,202,252,.802,85,376,461,161,148,97,48,128,1057,2014/2015
"Leonard,Meyers",125,245,.510,47,112,.420,78,133,.586,30,32,.938,46,204,250,32,10,39,14,113,327,2014/2015
"Leuer,Jon",121,273,.443,7,29,.241,114,244,.467,37,59,.627,50,157,207,46,17,35,9,86,286,2014/2015
"Lillard,Damian",590,1360,.434,196,572,.343,394,788,.500,344,398,.864,49,329,378,507,97,222,21,164,1720,2014/2015
"Lin,Jeremy",277,654,.424,65,176,.369,212,478,.444,213,268,.795,26,170,196,339,82,166,32,189,832,2014/2015
"Livingston,Shaun",198,396,.500,0,2,.000,198,394,.503,65,91,.714,43,140,183,259,49,102,20,110,461,2014/2015
"Lopez,Brook",506,987,.513,1,10,.100,505,977,.517,223,274,.814,214,321,535,50,43,104,126,206,1236,2014/2015
"Lopez,Robin",234,437,.535,0,1,.000,234,436,.537,98,127,.772,190,204,394,55,16,73,84,122,566,2014/2015
"Love,Kevin",413,952,.434,144,392,.367,269,560,.480,258,321,.804,142,589,731,168,51,122,39,140,1228,2014/2015
"Lowry,Kyle",430,1043,.412,132,391,.338,298,652,.457,252,312,.808,54,274,328,473,109,173,13,212,1244,2014/2015
"Lucas,Kalin",0,1,.000,0,0,,0,1,.000,0,0,,0,0,0,0,1,0,0,1,0,2014/2015
"Lucas III,John",42,104,.404,9,29,.310,33,75,.440,5,5,1.000,4,12,16,60,8,16,0,18,98,2014/2015
"Mack,Shelvin",117,292,.401,40,127,.315,77,165,.467,25,31,.806,8,71,79,155,30,49,2,32,299,2014/2015
"Mahinmi,Ian",117,212,.552,0,0,,117,212,.552,31,102,.304,105,251,356,33,30,59,46,172,265,2014/2015
"Marble,Devyn",14,44,.318,4,22,.182,10,22,.455,5,16,.313,5,26,31,17,9,9,2,14,37,2014/2015
"Marion,Shawn",119,267,.446,12,46,.261,107,221,.484,26,34,.765,64,138,202,51,27,33,27,58,276,2014/2015
"Marshall,Kendall",46,101,.455,18,46,.391,28,55,.509,8,9,.889,2,26,28,86,21,35,0,26,118,2014/2015
"Martin,Cartier",15,53,.283,6,33,.182,9,20,.450,0,0,,0,20,20,11,3,5,1,20,36,2014/2015
"Martin,Kenyon",9,22,.409,0,0,,9,22,.409,2,2,1.000,6,13,19,5,5,3,6,13,20,2014/2015
"Martin,Kevin",267,625,.427,75,191,.393,192,434,.442,170,193,.881,19,123,142,89,33,76,1,76,779,2014/2015
"Matthews,Wesley",337,752,.448,173,445,.389,164,307,.534,109,145,.752,38,184,222,139,77,81,10,132,956,2014/2015
"Maxiell,Jason",81,192,.422,0,0,,81,192,.422,41,71,.577,86,117,203,19,18,29,44,96,203,2014/2015
"Mayo,O.J.",296,701,.422,99,277,.357,197,424,.465,115,139,.827,30,157,187,197,57,128,18,165,806,2014/2015
"Mbah a Moute,Luc",251,636,.395,62,202,.307,189,434,.435,96,163,.589,82,246,328,106,81,99,21,104,660,2014/2015
"McAdoo,James Michael",24,44,.545,0,0,,24,44,.545,14,25,.560,15,22,37,2,5,6,9,21,62,2014/2015
"McCallum,Ray",206,470,.438,34,111,.306,172,359,.479,57,84,.679,52,128,180,188,45,85,11,92,503,2014/2015
"McCollum,CJ",159,365,.436,55,139,.396,104,226,.460,51,73,.699,14,77,91,64,43,48,8,81,424,2014/2015
"McDaniels,K.J.",172,434,.396,43,150,.287,129,284,.454,100,133,.752,65,135,200,72,44,105,70,126,487,2014/2015
"McDaniels,K.J.",167,419,.399,43,147,.293,124,272,.456,99,131,.756,64,131,195,70,44,104,68,121,476,2014/2015
"McDaniels,K.J.",5,15,.333,0,3,.000,5,12,.417,1,2,.500,1,4,5,2,0,1,2,5,11,2014/2015
"McDermott,Doug",43,107,.402,13,41,.317,30,66,.455,10,15,.667,6,37,43,6,4,17,1,29,109,2014/2015
"McGary,Mitch",88,165,.533,0,2,.000,88,163,.540,25,40,.625,53,112,165,14,16,31,16,72,201,2014/2015
"McGee,JaVale",42,79,.532,0,0,,42,79,.532,22,33,.667,18,43,61,3,2,18,20,30,106,2014/2015
"McGee,JaVale",34,61,.557,0,0,,34,61,.557,20,29,.690,14,34,48,1,2,13,19,28,88,2014/2015
"McGee,JaVale",8,18,.444,0,0,,8,18,.444,2,4,.500,4,9,13,2,0,5,1,2,18,2014/2015
"McLemore,Ben",363,831,.437,140,391,.358,223,440,.507,130,160,.813,31,210,241,140,77,138,19,219,996,2014/2015
"McNeal,Jerel",3,11,.273,1,2,.500,2,9,.222,2,2,1.000,0,3,3,2,3,5,1,5,9,2014/2015
"McRoberts,Josh",28,53,.528,8,19,.421,20,34,.588,8,13,.615,7,38,45,33,12,22,3,41,72,2014/2015
"Meeks,Jodie",222,534,.416,74,212,.349,148,322,.460,145,160,.906,12,92,104,79,59,57,6,76,663,2014/2015
"Mekel,Gal",3,20,.150,0,3,.000,3,17,.176,0,0,,0,1,1,13,2,2,0,1,6,2014/2015
"Middleton,Khris",406,869,.467,109,268,.407,297,601,.494,134,156,.859,48,299,347,182,122,113,11,183,1055,2014/2015
"Miles,C.J.",329,827,.398,154,446,.345,175,381,.459,130,161,.807,18,196,214,75,60,73,26,132,942,2014/2015
"Miller,Andre",145,290,.500,7,34,.206,138,256,.539,58,77,.753,37,116,153,284,32,104,6,103,355,2014/2015
"Miller,Andre",77,142,.542,1,8,.125,76,134,.567,28,39,.718,21,56,77,143,14,46,2,56,183,2014/2015
"Miller,Andre",68,148,.459,6,26,.231,62,122,.508,30,38,.789,16,60,76,141,18,58,4,47,172,2014/2015
"Miller,Darius",1,7,.143,0,1,.000,1,6,.167,0,0,,0,1,1,2,1,1,0,8,2,2014/2015
"Miller,Mike",37,114,.325,32,98,.327,5,16,.313,3,4,.750,4,87,91,46,14,23,4,74,109,2014/2015
"Miller,Quincy",9,38,.237,3,18,.167,6,20,.300,8,11,.727,4,16,20,8,7,5,5,9,29,2014/2015
"Miller,Quincy",4,18,.222,1,7,.143,3,11,.273,8,11,.727,2,10,12,3,6,3,3,4,17,2014/2015
"Miller,Quincy",5,20,.250,2,11,.182,3,9,.333,0,0,,2,6,8,5,1,2,2,5,12,2014/2015
"Mills,Patty",128,336,.381,62,182,.341,66,154,.429,33,40,.825,21,54,75,87,28,35,2,58,351,2014/2015
"Millsap,Elijah",81,238,.340,28,90,.311,53,148,.358,58,86,.674,28,122,150,58,56,67,16,124,248,2014/2015
"Millsap,Paul",443,930,.476,77,216,.356,366,714,.513,255,337,.757,139,431,570,223,130,166,69,201,1218,2014/2015
"Mirotić,Nikola",253,624,.405,99,313,.316,154,311,.495,228,284,.803,63,341,404,97,54,89,54,172,833,2014/2015
"Mohammed,Nazr",13,30,.433,0,0,,13,30,.433,1,3,.333,11,27,38,3,4,7,5,16,27,2014/2015
"Monroe,Greg",423,853,.496,0,0,,423,853,.496,252,336,.750,229,475,704,142,78,149,34,148,1098,2014/2015
"Moore,E'Twaun",62,139,.446,13,38,.342,49,101,.485,12,20,.600,12,34,46,33,20,14,6,45,149,2014/2015
"Moreland,Eric",1,1,1.000,0,0,,1,1,1.000,0,0,,0,1,1,0,0,0,0,1,2,2014/2015
"Morris,Darius",36,106,.340,7,33,.212,29,73,.397,4,9,.444,7,20,27,48,9,21,0,20,83,2014/2015
"Morris,Marcus",331,763,.434,112,313,.358,219,450,.487,71,113,.628,73,312,385,133,63,73,16,188,845,2014/2015
"Morris,Markieff",512,1100,.465,57,179,.318,455,921,.494,177,232,.763,110,396,506,192,101,170,39,245,1258,2014/2015
"Morrow,Anthony",285,615,.463,141,325,.434,144,290,.497,79,89,.888,40,155,195,60,54,38,11,135,790,2014/2015
"Motiejūnas,Donatas",353,700,.504,49,133,.368,304,567,.536,100,166,.602,137,284,421,130,56,123,34,203,855,2014/2015
"Mozgov,Timofey",314,566,.555,2,6,.333,312,560,.557,155,216,.718,203,388,591,55,33,116,97,227,785,2014/2015
"Mozgov,Timofey",117,232,.504,2,6,.333,115,226,.509,63,86,.733,91,181,272,16,15,47,41,114,299,2014/2015
"Mozgov,Timofey",197,334,.590,0,0,,197,334,.590,92,130,.708,112,207,319,39,18,69,56,113,486,2014/2015
"Muhammad,Shabazz",194,397,.489,20,51,.392,174,346,.503,104,145,.717,63,91,154,44,18,35,7,49,512,2014/2015
"Murry,Toure'",2,5,.400,0,0,,2,5,.400,2,2,1.000,1,0,1,1,1,4,0,2,6,2014/2015
"Murry,Toure'",0,1,.000,0,0,,0,1,.000,0,0,,0,0,0,0,0,0,0,0,0,2014/2015
"Murry,Toure'",2,4,.500,0,0,,2,4,.500,2,2,1.000,1,0,1,1,1,4,0,2,6,2014/2015
"Muscala,Mike",83,151,.550,9,22,.409,74,129,.574,22,25,.880,52,67,119,25,16,21,19,52,197,2014/2015
"Napier,Shabazz",87,228,.382,43,118,.364,44,110,.400,44,56,.786,17,96,113,130,40,81,4,76,261,2014/2015
"Neal,Gary",188,503,.374,50,164,.305,138,339,.407,117,135,.867,14,115,129,100,23,65,1,88,543,2014/2015
"Neal,Gary",143,398,.359,39,133,.293,104,265,.392,88,102,.863,14,80,94,80,16,55,1,70,413,2014/2015
"Neal,Gary",45,105,.429,11,31,.355,34,74,.459,29,33,.879,0,35,35,20,7,10,0,18,130,2014/2015
"Nelson,Jameer",205,504,.407,89,258,.345,116,246,.472,24,36,.667,33,113,146,253,47,109,6,136,523,2014/2015
"Nelson,Jameer",61,163,.374,38,103,.369,23,60,.383,7,8,.875,14,49,63,95,15,39,2,53,167,2014/2015
"Nelson,Jameer",9,41,.220,5,25,.200,4,16,.250,6,9,.667,3,14,17,33,7,9,0,13,29,2014/2015
"Nelson,Jameer",135,300,.450,46,130,.354,89,170,.524,11,19,.579,16,50,66,125,25,61,4,70,327,2014/2015
"Nicholson,Andrew",83,190,.437,13,41,.317,70,149,.470,15,25,.600,17,65,82,22,6,24,12,51,194,2014/2015
"Noah,Joakim",190,427,.445,0,2,.000,190,425,.447,105,174,.603,219,427,646,312,48,123,74,203,485,2014/2015
"Noel,Nerlens",302,653,.462,0,0,,302,653,.462,140,230,.609,185,426,611,128,133,146,142,208,744,2014/2015
"Nogueira,Lucas",2,8,.250,0,0,,2,8,.250,2,4,.500,2,9,11,1,2,2,0,6,6,2014/2015
"Novak,Steve",22,56,.393,19,48,.396,3,8,.375,0,2,.000,2,20,22,11,0,5,2,23,63,2014/2015
"Novak,Steve",16,35,.457,16,33,.485,0,2,.000,0,2,.000,1,15,16,6,0,3,1,13,48,2014/2015
"Novak,Steve",6,21,.286,3,15,.200,3,6,.500,0,0,,1,5,6,5,0,2,1,10,15,2014/2015
"Nowitzki,Dirk",487,1062,.459,104,274,.380,383,788,.486,255,289,.882,44,413,457,143,39,82,33,160,1333,2014/2015
"Nurkić,Jusuf",171,383,.446,0,2,.000,171,381,.449,84,132,.636,125,257,382,50,52,86,68,207,426,2014/2015
"O'Bryant,Johnny",44,120,.367,0,0,,44,120,.367,12,27,.444,26,38,64,17,5,25,4,44,100,2014/2015
"O'Quinn,Kyle",119,242,.492,12,43,.279,107,199,.538,44,57,.772,46,153,199,59,31,55,39,110,294,2014/2015
"Oladipo,Victor",473,1086,.436,84,248,.339,389,838,.464,262,320,.819,51,251,302,295,120,204,19,187,1292,2014/2015
"Olynyk,Kelly",251,528,.475,61,175,.349,190,353,.538,93,136,.684,92,211,303,109,64,98,39,213,656,2014/2015
"Onuaku,Arinze",12,14,.857,0,0,,12,14,.857,3,8,.375,7,14,21,4,1,2,3,6,27,2014/2015
"Pachulia,Zaza",240,529,.454,0,3,.000,240,526,.456,126,160,.788,197,303,500,178,80,133,21,170,606,2014/2015
"Papanikolaou,Kostas",69,197,.350,31,106,.292,38,91,.418,13,18,.722,39,79,118,85,29,55,13,71,182,2014/2015
"Pargo,Jannero",15,35,.429,9,22,.409,6,13,.462,2,2,1.000,0,3,3,8,0,3,0,8,41,2014/2015
"Parker,Jabari",129,263,.490,4,16,.250,125,247,.506,46,66,.697,50,88,138,42,31,47,5,42,308,2014/2015
"Parker,Tony",404,832,.486,38,89,.427,366,743,.493,130,166,.783,15,114,129,335,44,146,2,108,976,2014/2015
"Parsons,Chandler",383,829,.462,132,347,.380,251,482,.521,139,193,.720,64,259,323,161,69,96,19,140,1037,2014/2015
"Patterson,Patrick",240,535,.449,105,283,.371,135,252,.536,63,80,.788,127,306,433,155,60,54,44,149,648,2014/2015
"Paul,Chris",568,1170,.485,139,349,.398,429,821,.523,289,321,.900,52,324,376,838,156,190,15,203,1564,2014/2015
"Payne,Adreian",91,220,.414,1,9,.111,90,211,.427,30,46,.652,48,114,162,30,19,44,9,88,213,2014/2015
"Payne,Adreian",2,7,.286,0,1,.000,2,6,.333,1,2,.500,1,3,4,0,1,0,0,4,5,2014/2015
"Payne,Adreian",89,213,.418,1,8,.125,88,205,.429,29,44,.659,47,111,158,30,18,44,9,84,208,2014/2015
"Payton,Elfrid",301,708,.425,11,42,.262,290,666,.435,118,214,.551,107,242,349,533,142,203,20,193,731,2014/2015
"Peković,Nikola",139,328,.424,0,0,,139,328,.424,108,129,.837,89,145,234,27,19,42,12,59,386,2014/2015
"Perkins,Kendrick",102,227,.449,0,1,.000,102,226,.451,42,83,.506,91,229,320,51,16,95,42,162,246,2014/2015
"Perkins,Kendrick",82,186,.441,0,1,.000,82,185,.443,38,75,.507,80,199,279,43,14,74,38,135,202,2014/2015
"Perkins,Kendrick",20,41,.488,0,0,,20,41,.488,4,8,.500,11,30,41,8,2,21,4,27,44,2014/2015
"Pierce,Paul",293,656,.447,118,303,.389,175,353,.496,164,210,.781,45,249,294,144,46,92,24,160,868,2014/2015
"Plumlee,Mason",280,489,.573,0,3,.000,280,486,.576,157,317,.495,175,337,512,74,65,106,63,207,717,2014/2015
"Plumlee,Miles",136,254,.535,0,0,,136,254,.535,22,46,.478,112,208,320,34,41,51,66,111,294,2014/2015
"Plumlee,Miles",107,195,.549,0,0,,107,195,.549,19,38,.500,95,179,274,27,35,45,55,99,233,2014/2015
"Plumlee,Miles",29,59,.492,0,0,,29,59,.492,3,8,.375,17,29,46,7,6,6,11,12,61,2014/2015
"Pondexter,Quincy",188,447,.421,91,244,.373,97,203,.478,71,96,.740,53,142,195,94,19,51,24,150,538,2014/2015
"Pondexter,Quincy",48,135,.356,17,73,.233,31,62,.500,21,30,.700,20,37,57,28,5,10,5,47,134,2014/2015
"Pondexter,Quincy",140,312,.449,74,171,.433,66,141,.468,50,66,.758,33,105,138,66,14,41,19,103,404,2014/2015
"Porter,Otto",176,391,.450,35,104,.337,141,287,.491,58,79,.734,70,151,221,65,44,52,30,97,445,2014/2015
"Powell,Dwight",31,67,.463,3,11,.273,28,56,.500,25,33,.758,18,32,50,9,9,11,6,40,90,2014/2015
"Powell,Dwight",4,5,.800,0,0,,4,5,.800,1,2,.500,0,1,1,0,2,2,0,1,9,2014/2015
"Powell,Dwight",27,62,.435,3,11,.273,24,51,.471,24,31,.774,18,31,49,9,7,9,6,39,81,2014/2015
"Pressey,Phil",64,174,.368,16,65,.246,48,109,.440,33,49,.673,13,67,80,117,30,41,6,54,177,2014/2015
"Price,A.J.",51,137,.372,15,57,.263,36,80,.450,16,24,.667,6,26,32,46,7,14,0,15,133,2014/2015
"Price,A.J.",39,89,.438,15,39,.385,24,50,.480,12,18,.667,2,12,14,27,4,10,0,9,105,2014/2015
"Price,A.J.",9,34,.265,0,11,.000,9,23,.391,4,6,.667,4,11,15,13,3,3,0,1,22,2014/2015
"Price,A.J.",3,14,.214,0,7,.000,3,7,.429,0,0,,0,3,3,6,0,1,0,5,6,2014/2015
"Price,Ronnie",77,223,.345,31,109,.284,46,114,.404,36,45,.800,19,50,69,165,67,52,4,118,221,2014/2015
"Prigioni,Pablo",91,228,.399,57,166,.343,34,62,.548,35,41,.854,30,89,119,171,79,62,1,88,274,2014/2015
"Prigioni,Pablo",68,161,.422,43,115,.374,25,46,.543,22,26,.846,18,62,80,104,52,47,1,53,201,2014/2015
"Prigioni,Pablo",23,67,.343,14,51,.275,9,16,.563,13,15,.867,12,27,39,67,27,15,0,35,73,2014/2015
"Prince,Tayshaun",177,402,.440,31,67,.463,146,335,.436,49,65,.754,52,158,210,93,29,35,16,55,434,2014/2015
"Prince,Tayshaun",75,183,.410,15,33,.455,60,150,.400,25,30,.833,21,62,83,37,9,15,6,22,190,2014/2015
"Prince,Tayshaun",33,59,.559,5,8,.625,28,51,.549,5,6,.833,6,24,30,18,5,4,2,7,76,2014/2015
"Prince,Tayshaun",69,160,.431,11,26,.423,58,134,.433,19,29,.655,25,72,97,38,15,16,8,26,168,2014/2015
"Raduljica,Miroslav",3,8,.375,0,0,,3,8,.375,2,2,1.000,2,3,5,0,1,2,0,8,8,2014/2015
"Randle,Julius",1,3,.333,0,0,,1,3,.333,0,2,.000,0,0,0,0,0,1,0,1,2,2014/2015
"Randolph,Shavlik",9,35,.257,0,5,.000,9,30,.300,6,12,.500,16,22,38,4,5,3,3,16,24,2014/2015
"Randolph,Shavlik",6,25,.240,0,4,.000,6,21,.286,5,10,.500,12,14,26,3,4,2,2,13,17,2014/2015
"Randolph,Shavlik",3,10,.300,0,1,.000,3,9,.333,1,2,.500,4,8,12,1,1,1,1,3,7,2014/2015
"Randolph,Zach",454,932,.487,7,20,.350,447,912,.490,228,298,.765,225,522,747,153,69,156,14,175,1143,2014/2015
"Redick,J.J.",447,938,.477,200,458,.437,247,480,.515,183,203,.901,22,145,167,137,39,95,8,134,1277,2014/2015
"Rice,Glen",3,15,.200,1,7,.143,2,8,.250,4,6,.667,2,2,4,2,0,2,0,11,11,2014/2015
"Richardson,Jason",62,178,.348,31,96,.323,31,82,.378,17,22,.773,13,53,66,38,13,16,3,28,172,2014/2015
"Ridnour,Luke",75,176,.426,20,63,.317,55,113,.487,18,21,.857,8,60,68,96,20,38,4,67,188,2014/2015
"Rivers,Austin",203,496,.409,39,131,.298,164,365,.449,85,126,.675,27,125,152,155,48,65,14,146,530,2014/2015
"Rivers,Austin",86,222,.387,14,50,.280,72,172,.419,53,71,.746,12,56,68,87,18,30,7,65,239,2014/2015
"Rivers,Austin",117,274,.427,25,81,.309,92,193,.477,32,55,.582,15,69,84,68,30,35,7,81,291,2014/2015
"Roberson,Andre",92,201,.458,21,85,.247,71,116,.612,23,48,.479,60,195,255,70,53,46,29,141,228,2014/2015
"Roberts,Brian",176,452,.389,62,193,.321,114,259,.440,66,74,.892,13,96,109,162,33,57,6,75,480,2014/2015
"Robinson,Glenn",26,67,.388,5,19,.263,21,48,.438,16,24,.667,15,24,39,11,6,11,1,15,73,2014/2015
"Robinson,Glenn",8,24,.333,1,6,.167,7,18,.389,12,16,.750,4,10,14,3,3,3,0,5,29,2014/2015
"Robinson,Glenn",18,43,.419,4,13,.308,14,30,.467,4,8,.500,11,14,25,8,3,8,1,10,44,2014/2015
"Robinson,Nate",88,255,.345,31,112,.277,57,143,.399,31,46,.674,17,33,50,97,20,30,3,76,238,2014/2015
"Robinson,Nate",71,204,.348,24,92,.261,47,112,.420,26,40,.650,14,25,39,77,14,22,3,68,192,2014/2015
"Robinson,Nate",17,51,.333,7,20,.350,10,31,.323,5,6,.833,3,8,11,20,6,8,0,8,46,2014/2015
"Robinson,Thomas",126,260,.485,0,2,.000,126,258,.488,56,106,.528,95,208,303,33,32,59,20,104,308,2014/2015
"Robinson,Thomas",47,91,.516,0,0,,47,91,.516,21,48,.438,33,100,133,9,16,33,11,54,115,2014/2015
"Robinson,Thomas",79,169,.467,0,2,.000,79,167,.473,35,58,.603,62,108,170,24,16,26,9,50,193,2014/2015
"Rondo,Rajon",275,645,.426,27,86,.314,248,559,.444,31,78,.397,73,300,373,538,91,210,7,153,608,2014/2015
"Rondo,Rajon",81,200,.405,8,32,.250,73,168,.435,12,36,.333,25,140,165,237,37,75,3,42,182,2014/2015
"Rondo,Rajon",194,445,.436,19,54,.352,175,391,.448,19,42,.452,48,160,208,301,54,135,4,111,426,2014/2015
"Rose,Derrick",338,835,.405,76,271,.280,262,564,.465,152,187,.813,35,126,161,251,36,161,16,63,904,2014/2015
"Ross,Terrence",309,753,.410,145,390,.372,164,363,.452,44,56,.786,32,194,226,86,53,69,25,136,807,2014/2015
"Rubio,Ricky",78,219,.356,13,51,.255,65,168,.387,57,71,.803,19,106,125,193,38,64,1,59,226,2014/2015
"Rudež,Damjan",119,263,.452,69,170,.406,50,93,.538,16,23,.696,8,39,47,53,16,47,5,79,323,2014/2015
"Rush,Brandon",11,54,.204,3,27,.111,8,27,.296,5,11,.455,4,37,41,12,5,11,12,27,30,2014/2015
"Sacre,Robert",126,306,.412,0,1,.000,126,305,.413,55,82,.671,89,144,233,55,28,36,43,121,307,2014/2015
"Salmons,John",16,48,.333,8,26,.308,8,22,.364,2,4,.500,4,17,21,13,9,5,4,25,42,2014/2015
"Sampson,JaKarr",146,346,.422,31,127,.244,115,219,.525,63,94,.670,35,128,163,77,38,76,26,135,386,2014/2015
"Sanders,Larry",86,172,.500,0,0,,86,172,.500,24,48,.500,67,99,166,23,26,28,39,104,196,2014/2015
"Schröder,Dennis",284,665,.427,52,148,.351,232,517,.449,148,179,.827,29,135,164,317,49,150,4,127,768,2014/2015
"Scola,Luis",300,642,.467,5,20,.250,295,622,.474,158,226,.699,138,388,526,105,47,94,18,192,763,2014/2015
"Scott,Mike",201,453,.444,66,192,.344,135,261,.517,61,77,.792,45,154,199,75,25,39,3,83,529,2014/2015
"Sefolosha,Thabo",104,249,.418,25,78,.321,79,171,.462,45,58,.776,53,170,223,75,53,38,21,67,278,2014/2015
"Séraphin,Kevin",231,450,.513,0,2,.000,231,448,.516,58,82,.707,87,201,288,59,10,98,59,197,520,2014/2015
"Sessions,Ramon",125,334,.374,19,60,.317,106,274,.387,133,173,.769,23,121,144,182,29,86,0,73,402,2014/2015
"Sessions,Ramon",63,183,.344,6,28,.214,57,155,.368,64,88,.727,13,56,69,96,13,51,0,45,196,2014/2015
"Sessions,Ramon",62,151,.411,13,32,.406,49,119,.412,69,85,.812,10,65,75,86,16,35,0,28,206,2014/2015
"Shumpert,Iman",193,471,.410,67,196,.342,126,275,.458,43,64,.672,55,169,224,135,81,91,16,138,496,2014/2015
"Shumpert,Iman",88,215,.409,23,66,.348,65,149,.436,25,37,.676,22,59,81,78,30,42,3,67,224,2014/2015
"Shumpert,Iman",105,256,.410,44,130,.338,61,126,.484,18,27,.667,33,110,143,57,51,49,13,71,272,2014/2015
"Shved,Alexey",133,335,.397,47,139,.338,86,196,.439,121,150,.807,23,76,99,106,30,48,6,48,434,2014/2015
"Shved,Alexey",52,130,.400,17,57,.298,35,73,.479,48,57,.842,8,14,22,46,14,18,1,21,169,2014/2015
"Shved,Alexey",8,24,.333,4,12,.333,4,12,.333,9,11,.818,1,3,4,3,1,5,0,2,29,2014/2015
"Shved,Alexey",73,181,.403,26,70,.371,47,111,.423,64,82,.780,14,59,73,57,15,25,5,25,236,2014/2015
"Sims,Henry",238,502,.474,4,22,.182,234,480,.488,106,137,.774,121,238,359,79,39,99,30,135,586,2014/2015
"Singler,Kyle",172,446,.386,96,241,.398,76,205,.371,40,52,.769,33,161,194,85,47,55,21,153,480,2014/2015
"Singler,Kyle",140,350,.400,76,187,.406,64,163,.393,29,36,.806,23,116,139,67,33,42,14,98,385,2014/2015
"Singler,Kyle",32,96,.333,20,54,.370,12,42,.286,11,16,.688,10,45,55,18,14,13,7,55,95,2014/2015
"Sloan,Donald",145,355,.408,41,131,.313,104,224,.464,60,77,.779,12,131,143,190,23,65,0,47,391,2014/2015
"Smart,Marcus",175,477,.367,91,272,.335,84,205,.410,82,127,.646,61,161,222,208,99,90,18,176,523,2014/2015
"Smith,Greg",30,49,.612,0,0,,30,49,.612,20,39,.513,26,53,79,9,7,11,11,53,80,2014/2015
"Smith,Ish",143,367,.390,18,60,.300,125,307,.407,34,57,.596,15,85,100,180,36,78,6,50,338,2014/2015
"Smith,Ish",15,45,.333,1,5,.200,14,40,.350,6,9,.667,5,22,27,28,4,9,1,12,37,2014/2015
"Smith,Ish",128,322,.398,17,55,.309,111,267,.416,28,48,.583,10,63,73,152,32,69,5,38,301,2014/2015
"Smith,J.R.",315,755,.417,163,426,.383,152,329,.462,54,72,.750,30,188,218,195,82,97,22,163,847,2014/2015
"Smith,J.R.",101,251,.402,32,90,.356,69,161,.429,27,39,.692,4,54,58,81,18,45,4,44,261,2014/2015
"Smith,J.R.",214,504,.425,131,336,.390,83,168,.494,27,33,.818,26,134,160,114,64,52,18,119,586,2014/2015
"Smith,Jason",257,592,.434,15,42,.357,242,550,.440,127,153,.830,98,226,324,140,32,104,44,205,656,2014/2015
"Smith,Josh",414,987,.419,72,228,.316,342,759,.451,127,255,.498,152,378,530,277,87,206,116,228,1027,2014/2015
"Smith,Josh",153,391,.391,9,37,.243,144,354,.407,52,111,.468,52,150,202,132,37,72,48,82,367,2014/2015
"Smith,Josh",261,596,.438,63,191,.330,198,405,.489,75,144,.521,100,228,328,145,50,134,68,146,660,2014/2015
"Smith,Russ",8,25,.320,2,11,.182,6,14,.429,12,13,.923,1,5,6,8,3,12,0,13,30,2014/2015
"Smith,Russ",2,10,.200,1,6,.167,1,4,.250,0,0,,0,3,3,2,0,7,0,6,5,2014/2015
"Smith,Russ",6,15,.400,1,5,.200,5,10,.500,12,13,.923,1,2,3,6,3,5,0,7,25,2014/2015
"Snell,Tony",159,371,.429,73,197,.371,86,174,.494,44,55,.800,31,145,176,62,32,48,11,86,435,2014/2015
"Speights,Marreese",318,646,.492,5,18,.278,313,628,.498,150,178,.843,109,216,325,72,20,82,34,189,791,2014/2015
"Splitter,Tiago",169,303,.558,0,0,,169,303,.558,90,120,.750,91,161,252,78,35,60,37,103,428,2014/2015
"Stauskas,Nik",108,296,.365,48,149,.322,60,147,.408,55,64,.859,11,77,88,67,20,40,17,92,319,2014/2015
"Stephenson,Lance",207,550,.376,18,105,.171,189,445,.425,69,110,.627,39,238,277,240,38,128,8,134,501,2014/2015
"Stiemsma,Greg",6,8,.750,0,0,,6,8,.750,2,4,.500,9,6,15,3,2,7,0,15,14,2014/2015
"Stockton,David",2,6,.333,1,2,.500,1,4,.250,3,6,.500,0,2,2,9,2,4,0,1,8,2014/2015
"Stokes,Jarnell",21,37,.568,0,0,,21,37,.568,15,28,.536,16,18,34,4,5,7,5,25,57,2014/2015
"Stoudemire,Amar'e",273,490,.557,0,4,.000,273,486,.562,134,186,.720,110,219,329,45,29,78,38,161,680,2014/2015
"Stoudemire,Amar'e",169,311,.543,0,3,.000,169,308,.549,94,127,.740,83,162,245,37,20,63,34,111,432,2014/2015
"Stoudemire,Amar'e",104,179,.581,0,1,.000,104,178,.584,40,59,.678,27,57,84,8,9,15,4,50,248,2014/2015
"Stuckey,Rodney",332,754,.440,55,141,.390,277,613,.452,177,216,.819,36,212,248,219,56,118,10,131,896,2014/2015
"Sullinger,Jared",311,708,.439,52,184,.283,259,524,.494,96,129,.744,147,294,441,134,44,78,42,153,770,2014/2015
"Taylor,Jeffery",45,114,.395,11,36,.306,34,78,.436,26,41,.634,14,39,53,22,12,19,1,36,127,2014/2015
"Teague,Jeff",408,887,.460,71,207,.343,337,680,.496,275,319,.862,30,154,184,513,125,205,31,139,1162,2014/2015
"Teletović,Mirza",122,319,.382,62,193,.321,60,126,.476,33,46,.717,27,167,194,46,14,53,16,74,339,2014/2015
"Telfair,Sebastian",46,125,.368,18,60,.300,28,65,.431,24,34,.706,2,28,30,45,10,18,0,29,134,2014/2015
"Temple,Garrett",68,170,.400,33,88,.375,35,82,.427,35,48,.729,24,66,90,56,42,34,9,76,204,2014/2015
"Terry,Jason",188,446,.422,126,323,.390,62,123,.504,39,48,.813,15,106,121,147,66,74,19,116,541,2014/2015
"Thomas,Isaiah",335,797,.420,129,346,.373,206,451,.457,302,348,.868,33,120,153,284,57,143,5,150,1101,2014/2015
"Thomas,Isaiah",218,512,.426,81,207,.391,137,305,.449,184,211,.872,26,83,109,171,45,89,5,105,701,2014/2015
"Thomas,Isaiah",117,285,.411,48,139,.345,69,146,.473,118,137,.861,7,37,44,113,12,54,0,45,400,2014/2015
"Thomas,Lance",182,442,.412,7,22,.318,175,420,.417,72,99,.727,65,130,195,69,37,74,8,101,443,2014/2015
"Thomas,Lance",45,126,.357,0,1,.000,45,125,.360,23,33,.697,28,47,75,20,11,17,0,38,113,2014/2015
"Thomas,Lance",137,316,.434,7,21,.333,130,295,.441,49,66,.742,37,83,120,49,26,57,8,63,330,2014/2015
"Thomas,Malcolm",18,40,.450,0,7,.000,18,33,.545,9,13,.692,16,40,56,7,3,13,1,17,45,2014/2015
"Thomas,Tyrus",1,1,1.000,0,0,,1,1,1.000,2,2,1.000,0,0,0,1,0,0,0,0,4,2014/2015
"Thompson,Hollis",224,543,.413,115,287,.401,109,256,.426,63,89,.708,53,145,198,85,57,66,26,141,626,2014/2015
"Thompson,Jason",201,428,.470,0,1,.000,201,427,.471,89,143,.622,139,391,530,85,33,84,57,239,491,2014/2015
"Thompson,Klay",602,1299,.463,239,545,.439,363,754,.481,225,256,.879,27,220,247,222,87,149,60,122,1668,2014/2015
"Thompson,Tristan",267,488,.547,0,0,,267,488,.547,159,248,.641,274,383,657,39,34,83,61,189,693,2014/2015
"Thornton,Marcus",140,345,.406,54,143,.378,86,202,.426,46,56,.821,23,63,86,36,27,27,7,38,380,2014/2015
"Thornton,Marcus",127,305,.416,52,124,.419,75,181,.414,42,51,.824,19,54,73,34,21,22,7,35,348,2014/2015
"Thornton,Marcus",13,40,.325,2,19,.105,11,21,.524,4,5,.800,4,9,13,2,6,5,0,3,32,2014/2015
"Tolliver,Anthony",161,393,.410,106,290,.366,55,103,.534,54,69,.783,51,185,236,59,24,51,16,137,482,2014/2015
"Tolliver,Anthony",26,74,.351,24,62,.387,2,12,.167,4,6,.667,6,38,44,10,4,11,1,20,80,2014/2015
"Tolliver,Anthony",135,319,.423,82,228,.360,53,91,.582,50,63,.794,45,147,192,49,20,40,15,117,402,2014/2015
"Tucker,P.J.",261,596,.438,87,252,.345,174,344,.506,104,143,.727,114,388,502,122,107,96,23,179,713,2014/2015
"Turiaf,Ronny",0,0,,0,0,,0,0,,0,0,,0,1,1,2,0,0,0,0,0,2014/2015
"Türkoğlu,Hedo",83,188,.441,60,139,.432,23,49,.469,6,11,.545,5,94,99,37,19,29,7,66,232,2014/2015
"Turner,Evan",320,746,.429,33,119,.277,287,627,.458,106,141,.752,40,377,417,449,83,198,19,180,779,2014/2015
"Udoh,Ekpe",11,24,.458,0,0,,11,24,.458,7,9,.778,7,19,26,8,8,7,7,20,29,2014/2015
"Udrih,Beno",246,505,.487,26,97,.268,220,408,.539,87,102,.853,20,123,143,220,46,89,8,88,605,2014/2015
"Valančiūnas,Jonas",373,652,.572,0,1,.000,373,651,.573,217,276,.786,215,478,693,39,33,109,95,222,963,2014/2015
"Varejão,Anderson",111,200,.555,0,2,.000,111,198,.561,33,45,.733,57,113,170,35,19,35,16,58,255,2014/2015
"Vásquez,Greivis",296,725,.408,133,351,.379,163,374,.436,50,66,.758,22,194,216,302,46,119,10,177,775,2014/2015
"Villanueva,Charlie",150,362,.414,83,221,.376,67,141,.475,20,35,.571,30,119,149,19,15,28,22,64,403,2014/2015
"Vonleh,Noah",30,76,.395,5,13,.385,25,63,.397,18,26,.692,28,58,86,4,4,11,9,20,83,2014/2015
"Vučević,Nikola",631,1206,.523,2,6,.333,629,1200,.524,164,218,.752,238,572,810,147,54,148,54,220,1428,2014/2015
"Wade,Dwyane",509,1084,.470,29,102,.284,480,982,.489,284,370,.768,58,161,219,299,73,209,21,105,1331,2014/2015
"Waiters,Dion",375,946,.396,73,246,.297,302,700,.431,117,172,.680,41,151,192,163,90,113,21,155,940,2014/2015
"Waiters,Dion",138,342,.404,22,86,.256,116,256,.453,47,60,.783,12,45,57,74,44,50,10,59,345,2014/2015
"Waiters,Dion",237,604,.392,51,160,.319,186,444,.419,70,112,.625,29,106,135,89,46,63,11,96,595,2014/2015
"Walker,Henry",58,168,.345,45,132,.341,13,36,.361,14,18,.778,7,75,82,29,24,24,9,76,175,2014/2015
"Walker,Kemba",378,981,.385,85,280,.304,293,701,.418,234,283,.827,35,185,220,318,89,100,31,92,1075,2014/2015
"Wall,John",519,1166,.445,65,217,.300,454,949,.478,284,362,.785,36,330,366,792,138,304,45,180,1387,2014/2015
"Wallace,Gerald",14,34,.412,1,3,.333,13,31,.419,6,15,.400,17,40,57,11,15,18,4,19,35,2014/2015
"Warren,T.J.",113,214,.528,5,21,.238,108,193,.560,14,19,.737,41,44,85,25,18,27,9,51,245,2014/2015
"Watson,C.J.",181,417,.434,70,175,.400,111,242,.459,138,167,.826,18,145,163,208,57,100,9,107,570,2014/2015
"Wear,David",0,2,.000,0,1,.000,0,1,.000,0,0,,2,0,2,1,0,0,0,1,0,2014/2015
"Wear,Travis",84,209,.402,11,30,.367,73,179,.408,20,26,.769,31,75,106,40,15,35,11,55,199,2014/2015
"Webster,Martell",24,91,.264,10,43,.233,14,48,.292,48,64,.750,10,36,46,17,7,22,1,24,106,2014/2015
"West,David",323,686,.471,4,20,.200,319,666,.479,119,161,.739,108,341,449,223,48,120,48,160,769,2014/2015
"Westbrook,Russell",627,1471,.426,86,288,.299,541,1183,.457,546,654,.835,124,364,488,574,140,293,14,184,1886,2014/2015
"Whiteside,Hassan",243,387,.628,0,0,,243,387,.628,78,156,.500,145,337,482,6,27,58,123,129,564,2014/2015
"Whittington,Shayne",19,42,.452,1,6,.167,18,36,.500,18,23,.783,10,19,29,6,5,5,2,18,57,2014/2015
"Wiggins,Andrew",497,1137,.437,39,126,.310,458,1011,.453,354,466,.760,134,240,374,170,86,177,50,190,1387,2014/2015
"Wilcox,C.J.",16,38,.421,7,19,.368,9,19,.474,2,2,1.000,1,6,7,8,3,10,1,7,41,2014/2015
"Williams,Deron",298,771,.387,87,237,.367,211,534,.395,201,241,.834,29,208,237,448,64,154,17,157,884,2014/2015
"Williams,Derrick",217,485,.447,49,156,.314,168,329,.511,134,196,.684,41,161,202,50,34,56,4,67,617,2014/2015
"Williams,Elliot",14,37,.378,8,18,.444,6,19,.316,1,4,.250,0,8,8,12,4,4,0,12,37,2014/2015
"Williams,Elliot",6,13,.462,5,7,.714,1,6,.167,1,2,.500,0,3,3,4,2,4,0,1,18,2014/2015
"Williams,Elliot",8,24,.333,3,11,.273,5,13,.385,0,2,.000,0,5,5,8,2,0,0,11,19,2014/2015
"Williams,Lou",375,928,.404,152,447,.340,223,481,.464,340,395,.861,24,127,151,164,88,101,10,103,1242,2014/2015
"Williams,Marvin",210,495,.424,95,265,.358,115,230,.500,62,87,.713,58,328,386,100,69,60,36,146,577,2014/2015
"Williams,Mo",341,860,.397,119,348,.342,222,512,.434,163,187,.872,22,152,174,424,46,172,14,162,964,2014/2015
"Williams,Mo",180,447,.403,59,170,.347,121,277,.437,80,94,.851,13,85,98,261,30,102,8,103,499,2014/2015
"Williams,Mo",161,413,.390,60,178,.337,101,235,.430,83,93,.892,9,67,76,163,16,70,6,59,465,2014/2015
"Williams,Reggie",15,39,.385,3,19,.158,12,20,.600,4,4,1.000,5,12,17,10,1,2,0,12,37,2014/2015
"Williams,Shawne",121,300,.403,64,178,.360,57,122,.467,35,40,.875,36,130,166,44,25,30,21,135,341,2014/2015
"Williams,Shawne",102,240,.425,60,152,.395,42,88,.477,28,33,.848,27,112,139,36,21,23,17,116,292,2014/2015
"Williams,Shawne",19,60,.317,4,26,.154,15,34,.441,7,7,1.000,9,18,27,8,4,7,4,19,49,2014/2015
"Withey,Jeff",32,64,.500,0,0,,32,64,.500,34,50,.680,23,41,64,11,4,12,18,26,98,2014/2015
"Wolters,Nate",20,57,.351,0,7,.000,20,50,.400,2,6,.333,8,26,34,21,8,13,2,18,42,2014/2015
"Wolters,Nate",12,31,.387,0,5,.000,12,26,.462,1,4,.250,2,14,16,10,5,3,0,11,25,2014/2015
"Wolters,Nate",8,26,.308,0,2,.000,8,24,.333,1,2,.500,6,12,18,11,3,10,2,7,17,2014/2015
"Wright,Brandan",233,363,.642,0,3,.000,233,360,.647,78,112,.696,128,193,321,41,50,34,94,102,544,2014/2015
"Wright,Brandan",101,135,.748,0,0,,101,135,.748,36,48,.750,51,59,110,10,17,13,42,44,238,2014/2015
"Wright,Brandan",12,21,.571,0,0,,12,21,.571,2,4,.500,7,10,17,8,1,5,5,4,26,2014/2015
"Wright,Brandan",120,207,.580,0,3,.000,120,204,.588,40,60,.667,70,124,194,23,32,16,47,54,280,2014/2015
"Wright,Dorell",72,190,.379,41,108,.380,31,82,.378,34,42,.810,14,97,111,41,20,18,11,55,219,2014/2015
"Wroten,Tony",175,434,.403,37,142,.261,138,292,.473,120,180,.667,22,64,86,157,48,113,8,72,507,2014/2015
"Young,James",36,102,.353,17,66,.258,19,36,.528,16,29,.552,9,33,42,13,8,5,2,22,105,2014/2015
"Young,Nick",174,476,.366,83,225,.369,91,251,.363,132,148,.892,17,79,96,41,23,44,11,83,563,2014/2015
"Young,Thaddeus",451,968,.466,38,115,.330,413,853,.484,131,200,.655,127,284,411,173,124,117,25,171,1071,2014/2015
"Young,Thaddeus",289,641,.451,19,65,.292,270,576,.469,88,129,.682,75,170,245,135,86,75,17,115,685,2014/2015
"Young,Thaddeus",162,327,.495,19,50,.380,143,277,.516,43,71,.606,52,114,166,38,38,42,8,56,386,2014/2015
"Zeller,Cody",172,373,.461,1,1,1.000,171,372,.460,127,164,.774,97,265,362,100,34,62,49,156,472,2014/2015
"Zeller,Tyler",340,619,.549,0,0,,340,619,.549,153,186,.823,146,319,465,113,18,76,52,205,833,2014/2015
"Acy,Quincy",119,214,.556,19,49,.388,100,165,.606,50,68,.735,65,123,188,27,29,27,24,103,307,2015/2016
"Adams,Jordan",2,6,.333,0,1,.000,2,5,.400,3,5,.600,0,2,2,3,3,2,0,2,7,2015/2016
"Adams,Steven",261,426,.613,0,0,,261,426,.613,114,196,.582,219,314,533,62,42,84,89,223,636,2015/2016
"Afflalo,Arron",354,799,.443,91,238,.382,263,561,.469,110,131,.840,23,243,266,144,25,82,10,142,909,2015/2016
"Ajinça,Alexis",150,315,.476,0,1,.000,150,314,.478,52,62,.839,75,194,269,31,19,54,36,134,352,2015/2016
"Aldrich,Cole",134,225,.596,0,0,,134,225,.596,60,84,.714,86,202,288,50,47,64,68,139,328,2015/2016
"Aldridge,LaMarcus",536,1045,.513,0,16,.000,536,1029,.521,259,302,.858,176,456,632,110,38,99,81,151,1331,2015/2016
"Alexander,Cliff",5,10,.500,0,0,,5,10,.500,0,0,,2,4,6,0,1,1,2,1,10,2015/2016
"Allen,Lavoy",191,370,.516,0,0,,191,370,.516,46,73,.630,162,262,424,76,26,69,42,147,428,2015/2016
"Allen,Tony",215,469,.458,15,42,.357,200,427,.468,90,138,.652,104,192,296,70,110,78,18,175,535,2015/2016
"Aminu,Al-Farouq",299,719,.416,126,349,.361,173,370,.468,115,156,.737,98,401,499,138,72,120,53,171,839,2015/2016
"Amundson,Lou",19,53,.358,0,0,,19,53,.358,14,27,.519,23,26,49,12,6,15,7,44,52,2015/2016
"Andersen,Chris",38,72,.528,4,14,.286,34,58,.586,25,36,.694,36,62,98,12,15,9,13,29,105,2015/2016
"Andersen,Chris",4,10,.400,2,5,.400,2,5,.400,3,4,.750,3,6,9,3,1,2,3,4,13,2015/2016
"Andersen,Chris",34,62,.548,2,9,.222,32,53,.604,22,32,.688,33,56,89,9,14,7,10,25,92,2015/2016
"Anderson,Alan",21,59,.356,12,37,.324,9,22,.409,11,15,.733,1,26,27,14,4,2,1,25,65,2015/2016
"Anderson,James",67,178,.376,23,86,.267,44,92,.478,22,29,.759,13,73,86,41,21,42,14,54,179,2015/2016
"Anderson,Justin",71,175,.406,22,83,.265,49,92,.533,44,55,.800,18,114,132,29,19,24,25,45,208,2015/2016
"Anderson,Kyle",138,295,.468,12,37,.324,126,258,.488,62,83,.747,25,219,244,123,60,59,29,97,350,2015/2016
"Anderson,Ryan",397,929,.427,131,358,.366,266,571,.466,199,228,.873,131,265,396,73,38,90,25,109,1124,2015/2016
"Antetokounmpo,Giannis",513,1013,.506,28,109,.257,485,904,.537,296,409,.724,113,499,612,345,94,208,113,258,1350,2015/2016
"Antetokounmpo,Thanasis",3,4,.750,0,1,.000,3,3,1.000,0,0,,0,1,1,0,0,0,0,2,6,2015/2016
"Anthony,Carmelo",567,1307,.434,105,310,.339,462,997,.463,334,403,.829,98,458,556,299,62,176,38,180,1573,2015/2016
"Anthony,Joel",6,10,.600,0,0,,6,10,.600,6,8,.750,8,13,21,1,2,2,12,15,18,2015/2016
"Appling,Keith",2,8,.250,0,3,.000,2,5,.400,2,2,1.000,0,1,1,1,1,3,0,5,6,2015/2016
"Ariza,Trevor",357,859,.416,185,499,.371,172,360,.478,126,161,.783,67,299,366,188,160,113,26,177,1025,2015/2016
"Arthur,Darrell",221,489,.452,45,117,.385,176,372,.473,40,53,.755,86,207,293,96,53,66,48,185,527,2015/2016
"Aşık,Ömer",104,195,.533,0,0,,104,195,.533,61,112,.545,120,294,414,26,21,60,23,124,269,2015/2016
"Augustin,D.J.",148,350,.423,68,168,.405,80,182,.440,103,128,.805,8,87,95,198,38,84,4,85,467,2015/2016
"Augustin,D.J.",46,121,.380,24,61,.393,22,60,.367,26,34,.765,5,38,43,66,13,30,2,41,142,2015/2016
"Augustin,D.J.",102,229,.445,44,107,.411,58,122,.475,77,94,.819,3,49,52,132,25,54,2,44,325,2015/2016
"Ayres,Jeff",12,23,.522,0,1,.000,12,22,.545,6,6,1.000,4,18,22,5,0,6,3,18,30,2015/2016
"Babbitt,Luke",122,289,.422,44,109,.404,78,180,.433,39,50,.780,25,123,148,53,11,23,7,90,327,2015/2016
"Bairstow,Cameron",13,40,.325,1,5,.200,12,35,.343,7,8,.875,4,24,28,6,2,4,3,19,34,2015/2016
"Barbosa,Leandro",171,370,.462,39,110,.355,132,260,.508,52,62,.839,28,89,117,82,44,53,10,107,433,2015/2016
"Barea,J.J.",317,711,.446,100,260,.385,217,451,.481,74,96,.771,26,126,152,302,26,113,2,110,808,2015/2016
"Bargnani,Andrea",127,279,.455,3,16,.188,124,263,.471,47,57,.825,28,69,97,18,4,26,9,61,304,2015/2016
"Barnes,Harrison",295,633,.466,82,214,.383,213,419,.508,102,134,.761,77,248,325,117,41,57,10,136,774,2015/2016
"Barnes,Matt",264,693,.381,119,370,.322,145,323,.449,111,138,.804,84,336,420,163,78,121,57,234,758,2015/2016
"Barton,Will",425,983,.432,112,325,.345,313,658,.476,216,268,.806,59,417,476,203,71,139,39,147,1178,2015/2016
"Bass,Brandon",174,317,.549,0,2,.000,174,315,.552,125,148,.845,104,181,285,74,33,42,55,125,473,2015/2016
"Batum,Nicolas",372,873,.426,139,399,.348,233,474,.492,163,192,.849,55,373,428,403,65,205,43,114,1046,2015/2016
"Bayless,Jerryd",185,437,.423,101,231,.437,84,206,.408,70,90,.778,21,120,141,163,47,73,11,111,541,2015/2016
"Baynes,Aron",194,384,.505,0,2,.000,194,382,.508,126,165,.764,140,244,384,51,21,67,52,151,514,2015/2016
"Bazemore,Kent",320,725,.441,109,305,.357,211,420,.502,123,151,.815,28,351,379,171,98,138,38,176,872,2015/2016
"Beal,Bradley",359,799,.449,105,271,.387,254,528,.481,135,176,.767,41,147,188,162,54,112,11,117,958,2015/2016
"Beasley,Michael",107,205,.522,3,9,.333,104,196,.531,38,49,.776,29,69,98,16,11,24,9,39,255,2015/2016
"Belinelli,Marco",245,635,.386,91,297,.306,154,338,.456,115,138,.833,10,107,117,127,37,80,2,91,696,2015/2016
"Bennett,Anthony",8,27,.296,3,14,.214,5,13,.385,9,10,.900,6,17,23,0,5,4,0,8,28,2015/2016
"Beverley,Patrick",258,594,.434,124,310,.400,134,284,.472,60,88,.682,73,177,250,239,94,91,26,234,700,2015/2016
"Biyombo,Bismack",156,288,.542,0,1,.000,156,287,.544,142,226,.628,182,473,655,29,19,71,133,225,454,2015/2016
"Bjelica,Nemanja",110,235,.468,48,125,.384,62,110,.564,40,55,.727,49,161,210,83,26,47,21,154,308,2015/2016
"Black,Tarik",57,104,.548,0,0,,57,104,.548,19,45,.422,44,113,157,16,14,22,18,78,133,2015/2016
"Blair,DeJuan",28,68,.412,0,1,.000,28,67,.418,5,13,.385,20,37,57,11,8,15,2,53,61,2015/2016
"Blake,Steve",93,240,.388,52,151,.344,41,89,.461,16,20,.800,9,80,89,200,24,81,5,70,254,2015/2016
"Bledsoe,Eric",223,492,.453,48,129,.372,175,363,.482,138,172,.802,18,107,125,190,63,110,19,75,632,2015/2016
"Bogdanović,Bojan",324,749,.433,129,338,.382,195,411,.474,110,132,.833,36,219,255,99,29,115,5,119,887,2015/2016
"Bogut,Andrew",175,279,.627,1,1,1.000,174,278,.626,24,50,.480,121,371,492,162,33,83,114,221,375,2015/2016
"Bonner,Matt",29,57,.509,15,34,.441,14,23,.609,3,4,.750,3,24,27,9,6,3,1,16,76,2015/2016
"Booker,Devin",367,867,.423,99,289,.343,268,578,.464,215,256,.840,27,160,187,200,44,160,20,225,1048,2015/2016
"Booker,Trevor",190,388,.490,12,41,.293,178,347,.513,71,106,.670,166,286,452,84,59,81,41,169,463,2015/2016
"Bosh,Chris",358,767,.467,81,222,.365,277,545,.508,213,268,.795,48,342,390,128,36,78,34,101,1010,2015/2016
"Bradley,Avery",456,1019,.447,147,407,.361,309,612,.505,96,123,.780,48,172,220,158,117,109,19,164,1155,2015/2016
"Brand,Elton",31,72,.431,0,1,.000,31,71,.437,8,9,.889,9,54,63,18,9,11,8,32,70,2015/2016
"Brewer,Corey",212,552,.384,61,224,.272,151,328,.460,105,140,.750,42,157,199,109,84,78,19,168,590,2015/2016
"Brooks,Aaron",188,469,.401,66,185,.357,122,284,.430,49,64,.766,21,80,101,180,30,82,10,132,491,2015/2016
"Brown,Anthony",39,126,.310,20,70,.286,19,56,.339,17,20,.850,9,61,70,19,14,15,5,34,115,2015/2016
"Brown,Lorenzo",8,25,.320,1,8,.125,7,17,.412,3,4,.750,0,7,7,11,3,9,1,4,20,2015/2016
"Brown,Markel",127,322,.394,38,121,.314,89,201,.443,71,94,.755,23,99,122,91,38,54,15,94,363,2015/2016
"Bryant,Kobe",398,1113,.358,133,467,.285,265,646,.410,232,281,.826,41,206,247,184,62,129,13,115,1161,2015/2016
"Budinger,Chase",104,239,.435,24,86,.279,80,153,.523,39,56,.696,43,107,150,64,32,44,10,62,271,2015/2016
"Budinger,Chase",81,194,.418,20,69,.290,61,125,.488,34,48,.708,31,90,121,49,29,31,9,46,216,2015/2016
"Budinger,Chase",23,45,.511,4,17,.235,19,28,.679,5,8,.625,12,17,29,15,3,13,1,16,55,2015/2016
"Bullock,Reggie",43,98,.439,22,53,.415,21,45,.467,14,15,.933,14,54,68,27,10,8,2,29,122,2015/2016
"Burke,Trey",262,634,.413,88,256,.344,174,378,.460,67,82,.817,18,94,112,148,35,80,6,86,679,2015/2016
"Burks,Alec",137,334,.410,32,79,.405,105,255,.412,106,141,.752,16,93,109,63,18,51,4,71,412,2015/2016
"Butler,Caron",25,59,.424,3,18,.167,22,41,.537,10,12,.833,5,17,22,10,9,3,1,19,63,2015/2016
"Butler,Jimmy",470,1035,.454,64,205,.312,406,830,.489,395,475,.832,79,279,358,321,110,132,43,124,1399,2015/2016
"Butler,Rasual",49,104,.471,15,49,.306,34,55,.618,11,16,.688,3,53,56,24,13,8,23,11,124,2015/2016
"Caboclo,Bruno",1,12,.083,1,7,.143,0,5,.000,0,0,,1,1,2,1,2,4,1,2,3,2015/2016
"Calderón,José",209,455,.459,84,203,.414,125,252,.496,42,48,.875,22,207,229,298,63,87,7,135,544,2015/2016
"Caldwell-Pope,Kentavious",403,960,.420,114,369,.309,289,591,.489,185,228,.811,70,212,282,138,110,105,17,167,1105,2015/2016
"Canaan,Isaiah",260,722,.360,176,485,.363,84,237,.354,150,180,.833,20,154,174,137,56,91,12,133,846,2015/2016
"Capela,Clint",231,397,.582,0,1,.000,231,396,.583,80,211,.379,194,300,494,47,59,60,92,190,542,2015/2016
"Carroll,DeMarre",105,270,.389,46,118,.390,59,152,.388,30,50,.600,31,91,122,27,44,28,6,63,286,2015/2016
"Carter,Vince",133,343,.388,59,169,.349,74,174,.425,70,84,.833,31,115,146,56,38,35,16,101,395,2015/2016
"Carter-Williams,Michael",251,555,.452,15,55,.273,236,500,.472,106,162,.654,48,228,276,281,80,153,41,162,623,2015/2016
"Casspi,Omri",299,622,.481,112,274,.409,187,348,.537,103,159,.648,58,352,410,95,56,94,17,154,813,2015/2016
"Cauley-Stein,Willie",191,339,.563,0,2,.000,191,337,.567,81,125,.648,134,218,352,37,48,46,66,146,463,2015/2016
"Chalmers,Mario",182,444,.410,46,149,.309,136,295,.461,218,262,.832,24,133,157,230,88,110,13,181,628,2015/2016
"Chalmers,Mario",10,32,.313,1,11,.091,9,21,.429,12,13,.923,1,13,14,19,8,9,1,16,33,2015/2016
"Chalmers,Mario",172,412,.417,45,138,.326,127,274,.464,206,249,.827,23,120,143,211,80,101,12,165,595,2015/2016
"Chandler,Tyson",183,314,.583,0,1,.000,183,313,.585,106,171,.620,175,401,576,64,36,93,44,145,472,2015/2016
"Christmas,Rakeem",2,2,1.000,0,0,,2,2,1.000,0,0,,1,0,1,0,0,0,0,1,4,2015/2016
"Clark,Ian",89,202,.441,30,84,.357,59,118,.500,28,34,.824,13,55,68,64,17,43,13,58,236,2015/2016
"Clarke,Coty",2,4,.500,2,2,1.000,0,2,.000,0,0,,0,1,1,0,0,1,0,0,6,2015/2016
"Clarkson,Jordan",475,1098,.433,111,320,.347,364,778,.468,164,204,.804,93,220,313,192,88,135,7,168,1225,2015/2016
"Cole,Norris",196,484,.405,33,102,.324,163,382,.427,52,65,.800,10,141,151,167,37,75,5,102,477,2015/2016
"Collison,Darren",377,776,.486,87,217,.401,290,559,.519,194,226,.858,28,141,169,318,76,130,4,142,1035,2015/2016
"Collison,Nick",50,109,.459,0,2,.000,50,107,.467,23,33,.697,68,103,171,52,15,50,16,107,123,2015/2016
"Conley,Mike",294,696,.422,78,215,.363,216,481,.449,191,229,.834,26,138,164,342,67,84,16,100,857,2015/2016
"Connaughton,Pat",13,49,.265,5,21,.238,8,28,.286,5,5,1.000,11,21,32,10,2,10,0,6,36,2015/2016
"Copeland,Chris",17,51,.333,10,36,.278,7,15,.467,6,7,.857,1,9,10,11,2,6,0,17,50,2015/2016
"Cotton,Bryce",4,10,.400,0,3,.000,4,7,.571,0,0,,0,0,0,3,3,5,0,2,8,2015/2016
"Cotton,Bryce",2,8,.250,0,3,.000,2,5,.400,0,0,,0,0,0,3,3,5,0,2,4,2015/2016
"Cotton,Bryce",2,2,1.000,0,0,,2,2,1.000,0,0,,0,0,0,0,0,0,0,0,4,2015/2016
"Cousins,DeMarcus",601,1332,.451,70,210,.333,531,1122,.473,476,663,.718,158,589,747,214,101,249,92,236,1748,2015/2016
"Covington,Robert",274,712,.385,170,482,.353,104,230,.452,140,177,.791,65,354,419,97,105,143,40,232,858,2015/2016
"Crabbe,Allen",311,678,.459,112,285,.393,199,393,.506,98,113,.867,27,189,216,99,63,64,16,192,832,2015/2016
"Crawford,Jamal",379,939,.404,117,344,.340,262,595,.440,245,271,.904,20,125,145,183,52,113,12,122,1120,2015/2016
"Crowder,Jae",360,813,.443,122,363,.336,238,450,.529,196,239,.820,70,303,373,135,126,83,35,198,1038,2015/2016
"Cunningham,Dante",186,412,.451,55,174,.316,131,238,.550,57,82,.695,57,179,236,77,42,41,33,173,484,2015/2016
"Cunningham,Jared",36,105,.343,12,39,.308,24,66,.364,36,55,.655,3,35,38,20,14,21,2,41,120,2015/2016
"Cunningham,Jared",32,91,.352,10,32,.313,22,59,.373,30,48,.625,3,26,29,19,12,18,2,37,104,2015/2016
"Cunningham,Jared",4,14,.286,2,7,.286,2,7,.286,6,7,.857,0,9,9,1,2,3,0,4,16,2015/2016
"Curry,Seth",102,224,.455,50,111,.450,52,113,.460,45,54,.833,9,51,60,67,22,36,3,41,299,2015/2016
"Curry,Stephen",805,1598,.504,402,886,.454,403,712,.566,363,400,.908,68,362,430,527,169,262,15,161,2375,2015/2016
"Daniels,Troy",89,187,.476,59,122,.484,30,65,.462,5,9,.556,7,50,57,21,11,24,3,40,242,2015/2016
"Davis,Anthony",560,1136,.493,35,108,.324,525,1028,.511,326,430,.758,130,497,627,116,78,121,125,148,1481,2015/2016
"Davis,Ed",206,337,.611,0,0,,206,337,.611,114,204,.559,224,375,599,88,57,64,72,202,526,2015/2016
"Dawson,Branden",2,5,.400,0,0,,2,5,.400,1,1,1.000,2,2,4,0,0,0,1,2,5,2015/2016
"Dedmon,Dewayne",99,177,.559,0,0,,99,177,.559,57,76,.750,67,161,228,13,22,32,46,109,255,2015/2016
"Dejean-Jones,Bryce",28,69,.406,12,32,.375,16,37,.432,11,21,.524,8,40,48,15,10,11,2,17,79,2015/2016
"Dekker,Sam",0,0,,0,0,,0,0,,0,0,,0,1,1,0,1,0,0,0,0,2015/2016
"Dellavedova,Matthew",207,511,.405,98,239,.410,109,272,.401,57,66,.864,33,129,162,337,44,116,9,178,569,2015/2016
"Deng,Luol",339,745,.455,88,256,.344,251,489,.513,145,192,.755,108,335,443,140,74,81,29,122,911,2015/2016
"DeRozan,DeMar",614,1377,.446,47,139,.338,567,1238,.458,555,653,.850,64,285,349,315,81,175,21,167,1830,2015/2016
"Diaw,Boris",202,383,.527,25,69,.362,177,314,.564,56,76,.737,58,175,233,176,26,97,21,102,485,2015/2016
"Dieng,Gorgui",308,579,.532,6,20,.300,302,559,.540,205,248,.827,157,428,585,143,94,140,96,219,827,2015/2016
"Dinwiddie,Spencer",19,54,.352,1,10,.100,18,44,.409,19,33,.576,4,13,17,22,3,7,0,20,58,2015/2016
"Douglas,Toney",183,445,.411,81,203,.399,102,242,.421,84,99,.848,25,118,143,157,70,64,5,131,531,2015/2016
"Dragić,Goran",417,875,.477,64,205,.312,353,670,.527,120,165,.727,54,223,277,419,71,185,17,188,1018,2015/2016
"Drummond,Andre",552,1060,.521,2,6,.333,550,1054,.522,208,586,.355,395,803,1198,67,119,155,112,245,1314,2015/2016
"Dudley,Jared",233,487,.478,100,238,.420,133,249,.534,72,98,.735,54,232,286,170,75,80,18,190,638,2015/2016
"Dukan,Duje",2,10,.200,2,5,.400,0,5,.000,0,0,,2,2,4,1,1,0,0,2,6,2015/2016
"Duncan,Tim",215,441,.488,0,2,.000,215,439,.490,92,131,.702,115,332,447,163,47,90,78,125,522,2015/2016
"Dunleavy,Mike",77,188,.410,39,99,.394,38,89,.427,29,37,.784,8,75,83,39,14,26,10,66,222,2015/2016
"Durant,Kevin",698,1381,.505,186,481,.387,512,900,.569,447,498,.898,45,544,589,361,69,250,85,137,2029,2015/2016
"Early,Cleanthony",12,40,.300,4,15,.267,8,25,.320,3,4,.750,4,22,26,6,2,9,3,16,31,2015/2016
"Eddie,Jarell",20,65,.308,15,47,.319,5,18,.278,8,8,1.000,2,21,23,5,5,1,1,5,63,2015/2016
"Ellington,Wayne",218,561,.389,96,268,.358,122,293,.416,54,63,.857,20,154,174,83,48,45,5,82,586,2015/2016
"Ellis,Monta",436,1021,.427,87,282,.309,349,739,.472,162,206,.786,42,229,271,383,150,203,37,174,1121,2015/2016
"Ennis,James",54,113,.478,26,58,.448,28,55,.509,25,34,.735,21,21,42,21,16,19,5,28,159,2015/2016
"Ennis,James",0,0,,0,0,,0,0,,0,0,,0,0,0,1,0,0,0,1,0,2015/2016
"Ennis,James",4,13,.308,2,8,.250,2,5,.400,6,10,.600,4,3,7,2,4,2,2,1,16,2015/2016
"Ennis,James",50,100,.500,24,50,.480,26,50,.520,19,24,.792,17,18,35,18,12,17,3,26,143,2015/2016
"Ennis,Tyler",84,187,.449,13,39,.333,71,148,.480,25,34,.735,13,62,75,95,25,46,1,64,206,2015/2016
"Evans,Jeremy",26,48,.542,4,16,.250,22,32,.688,15,21,.714,11,43,54,2,6,7,9,19,71,2015/2016
"Evans,Tyreke",136,314,.433,33,85,.388,103,229,.450,74,93,.796,20,109,129,164,32,73,8,66,379,2015/2016
"Ezeli,Festus",125,228,.548,0,0,,125,228,.548,70,132,.530,91,166,257,32,18,38,50,94,320,2015/2016
"Faried,Kenneth",349,626,.558,1,2,.500,348,624,.558,136,222,.613,235,346,581,79,32,91,60,169,835,2015/2016
"Farmar,Jordan",42,100,.420,16,45,.356,26,55,.473,10,10,1.000,4,21,25,37,15,18,2,22,110,2015/2016
"Favors,Derrick",418,811,.515,0,4,.000,418,807,.518,180,254,.709,169,334,503,94,74,104,91,150,1016,2015/2016
"Felício,Cristiano",40,72,.556,0,4,.000,40,68,.588,25,35,.714,30,72,102,26,6,13,13,31,105,2015/2016
"Felton,Raymond",277,682,.406,60,213,.282,217,469,.463,149,176,.847,36,222,258,284,68,121,15,141,763,2015/2016
"Fournier,Evan",429,929,.462,156,390,.400,273,539,.506,199,238,.836,33,192,225,213,96,133,2,214,1213,2015/2016
"Foye,Randy",169,482,.351,75,250,.300,94,232,.405,61,74,.824,24,132,156,161,39,86,29,131,474,2015/2016
"Foye,Randy",117,333,.351,50,169,.296,67,164,.409,39,47,.830,16,89,105,112,26,58,16,83,323,2015/2016
"Foye,Randy",52,149,.349,25,81,.309,27,68,.397,22,27,.815,8,43,51,49,13,28,13,48,151,2015/2016
"Frazier,Tim",96,229,.419,16,48,.333,80,181,.442,53,74,.716,26,84,110,162,33,65,2,73,261,2015/2016
"Frazier,Tim",20,60,.333,3,17,.176,17,43,.395,8,15,.533,11,28,39,42,10,27,1,31,51,2015/2016
"Frazier,Tim",76,169,.450,13,31,.419,63,138,.457,45,59,.763,15,56,71,120,23,38,1,42,210,2015/2016
"Fredette,Jimmer",2,5,.400,1,2,.500,1,3,.333,4,5,.800,0,0,0,1,1,2,0,2,9,2015/2016
"Fredette,Jimmer",1,4,.250,0,1,.000,1,3,.333,0,0,,0,0,0,1,1,1,0,1,2,2015/2016
"Fredette,Jimmer",1,1,1.000,1,1,1.000,0,0,,4,5,.800,0,0,0,0,0,1,0,1,7,2015/2016
"Frye,Channing",152,347,.438,91,235,.387,61,112,.545,30,35,.857,35,199,234,71,29,43,28,127,425,2015/2016
"Frye,Channing",81,186,.435,48,121,.397,33,65,.508,19,21,.905,23,118,141,45,21,30,20,71,229,2015/2016
"Frye,Channing",71,161,.441,43,114,.377,28,47,.596,11,14,.786,12,81,93,26,8,13,8,56,196,2015/2016
"Gallinari,Danilo",287,700,.410,87,239,.364,200,461,.434,375,432,.868,52,229,281,135,42,77,19,87,1036,2015/2016
"Galloway,Langston",231,588,.393,77,224,.344,154,364,.423,86,114,.754,43,245,288,207,77,61,22,177,625,2015/2016
"Garnett,Kevin",54,115,.470,0,1,.000,54,114,.474,14,21,.667,15,135,150,62,28,16,10,70,122,2015/2016
"Gasol,Marc",328,707,.464,2,3,.667,326,704,.463,203,245,.829,58,304,362,196,50,118,70,141,861,2015/2016
"Gasol,Pau",467,995,.469,24,69,.348,443,926,.478,229,289,.792,155,638,793,294,42,164,146,148,1187,2015/2016
"Gay,Rudy",466,1007,.463,74,215,.344,392,792,.495,198,254,.780,103,353,456,120,100,139,51,184,1204,2015/2016
"Gee,Alonzo",132,255,.518,17,60,.283,115,195,.590,44,66,.667,60,185,245,72,63,55,13,169,325,2015/2016
"George,Paul",605,1449,.418,210,566,.371,395,883,.447,454,528,.860,79,484,563,329,152,265,29,230,1874,2015/2016
"Gibson,Taj",263,500,.526,0,3,.000,263,497,.529,101,146,.692,206,298,504,106,47,78,77,180,627,2015/2016
"Ginóbili,Manu",197,435,.453,70,179,.391,127,256,.496,91,112,.813,26,120,146,177,66,99,11,99,555,2015/2016
"Gobert,Rudy",198,354,.559,0,0,,198,354,.559,161,283,.569,208,460,668,91,45,114,135,163,557,2015/2016
"Gooden,Drew",33,103,.320,7,41,.171,26,62,.419,9,14,.643,28,57,85,13,8,13,11,40,82,2015/2016
"Goodwin,Archie",176,422,.417,23,99,.232,153,323,.474,130,193,.674,27,115,142,118,27,100,13,84,505,2015/2016
"Gordon,Aaron",274,579,.473,42,142,.296,232,437,.531,129,193,.668,154,353,507,128,59,66,55,153,719,2015/2016
"Gordon,Eric",231,552,.418,113,294,.384,118,258,.457,111,125,.888,10,89,99,121,43,73,14,98,686,2015/2016
"Gortat,Marcin",433,764,.567,0,1,.000,433,763,.567,146,207,.705,222,519,741,106,47,121,96,193,1012,2015/2016
"Goudelock,Andrew",9,20,.450,1,9,.111,8,11,.727,3,4,.750,1,1,2,4,6,7,2,4,22,2015/2016
"Grant,Jerami",251,599,.419,35,146,.240,216,453,.477,212,322,.658,99,262,361,135,54,110,127,215,749,2015/2016
"Grant,Jerian",154,391,.394,22,100,.220,132,291,.454,96,123,.780,23,120,143,177,50,87,10,97,426,2015/2016
"Green,Danny",211,561,.376,116,349,.332,95,212,.448,34,46,.739,48,255,303,141,79,75,64,141,572,2015/2016
"Green,Draymond",401,819,.490,100,258,.388,301,561,.537,229,329,.696,134,635,769,598,119,259,113,240,1131,2015/2016
"Green,Erick",5,13,.385,1,5,.200,4,8,.500,2,2,1.000,3,3,6,3,1,0,0,4,13,2015/2016
"Green,Erick",0,1,.000,0,1,.000,0,0,,0,0,,0,1,1,1,0,0,0,0,0,2015/2016
"Green,Erick",5,12,.417,1,4,.250,4,8,.500,2,2,1.000,3,2,5,2,1,0,0,4,13,2015/2016
"Green,Gerald",230,587,.392,84,260,.323,146,327,.446,72,92,.783,25,138,163,56,38,46,19,123,616,2015/2016
"Green,JaMychal",230,495,.465,15,45,.333,215,450,.478,103,137,.752,139,234,373,67,46,83,33,189,578,2015/2016
"Green,Jeff",354,824,.430,67,213,.315,287,611,.470,164,220,.745,74,258,332,138,58,93,40,164,939,2015/2016
"Green,Jeff",240,557,.431,42,136,.309,198,421,.470,124,155,.800,55,186,241,98,40,69,19,102,646,2015/2016
"Green,Jeff",114,267,.427,25,77,.325,89,190,.468,40,65,.615,19,72,91,40,18,24,21,62,293,2015/2016
"Griffin,Blake",301,603,.499,6,18,.333,295,585,.504,141,194,.727,51,243,294,170,28,83,17,95,749,2015/2016
"Gutiérrez,Jorge",6,11,.545,0,2,.000,6,9,.667,10,11,.909,0,7,7,17,3,6,0,3,22,2015/2016
"Hairston,P.J.",145,408,.355,70,241,.290,75,167,.449,50,64,.781,25,149,174,38,32,41,11,137,410,2015/2016
"Hairston,P.J.",99,276,.359,54,172,.314,45,104,.433,34,42,.810,18,110,128,29,24,24,7,106,286,2015/2016
"Hairston,P.J.",46,132,.348,16,69,.232,30,63,.476,16,22,.727,7,39,46,9,8,17,4,31,124,2015/2016
"Hamilton,Jordan",49,116,.422,13,45,.289,36,71,.507,14,21,.667,12,50,62,25,8,17,3,24,125,2015/2016
"Hansbrough,Tyler",32,71,.451,2,3,.667,30,68,.441,38,65,.585,40,49,89,8,12,12,7,55,104,2015/2016
"Hardaway,Tim",114,265,.430,48,142,.338,66,123,.537,50,56,.893,7,79,86,51,21,23,7,48,326,2015/2016
"Harden,James",710,1617,.439,236,657,.359,474,960,.494,720,837,.860,63,438,501,612,139,374,51,229,2376,2015/2016
"Harkless,Maurice",195,411,.474,39,140,.279,156,271,.576,69,111,.622,101,179,280,67,49,62,35,124,498,2015/2016
"Harper,Justin",4,10,.400,4,9,.444,0,1,.000,1,2,.500,0,1,1,0,1,2,0,3,13,2015/2016
"Harrell,Montrezl",58,90,.644,0,1,.000,58,89,.652,24,46,.522,25,40,65,17,11,17,11,48,140,2015/2016
"Harris,Devin",167,374,.447,52,158,.329,115,216,.532,101,140,.721,18,120,138,118,60,66,13,124,487,2015/2016
"Harris,Gary",359,765,.469,105,297,.354,254,468,.543,109,133,.820,54,166,220,147,97,98,18,143,932,2015/2016
"Harris,Joe",1,4,.250,1,4,.250,0,0,,0,0,,0,3,3,2,0,1,0,1,3,2015/2016
"Harris,Tobias",417,889,.469,80,239,.335,337,650,.518,202,243,.831,96,414,510,169,65,108,40,153,1116,2015/2016
"Harris,Tobias",251,541,.464,47,151,.311,204,390,.523,120,153,.784,71,271,342,99,47,78,28,91,669,2015/2016
"Harris,Tobias",166,348,.477,33,88,.375,133,260,.512,82,90,.911,25,143,168,70,18,30,12,62,447,2015/2016
"Harrison,Aaron",5,19,.263,3,10,.300,2,9,.222,5,12,.417,4,11,15,2,6,4,0,10,18,2015/2016
"Haslem,Udonis",23,61,.377,1,9,.111,22,52,.423,12,16,.750,10,65,75,14,5,5,2,25,59,2015/2016
"Hawes,Spencer",124,306,.405,38,102,.373,86,204,.422,54,65,.831,51,193,244,109,22,58,27,111,340,2015/2016
"Hayes,Chuck",1,2,.500,0,0,,1,2,.500,2,2,1.000,0,8,8,2,0,3,0,6,4,2015/2016
"Hayward,Gordon",521,1202,.433,143,410,.349,378,792,.477,393,477,.824,61,336,397,296,95,202,27,183,1578,2015/2016
"Henderson,Gerald",232,529,.439,48,136,.353,184,393,.468,112,146,.767,30,181,211,75,39,68,19,87,624,2015/2016
"Henson,John",164,291,.564,0,1,.000,164,290,.566,69,117,.590,87,134,221,54,18,64,109,131,397,2015/2016
"Hezonja,Mario",181,418,.433,67,192,.349,114,226,.504,49,54,.907,28,148,176,109,39,97,17,124,478,2015/2016
"Hibbert,Roy",182,411,.443,0,2,.000,182,409,.445,117,145,.807,132,266,398,95,32,76,110,252,481,2015/2016
"Hickson,J.J.",80,155,.516,0,1,.000,80,154,.519,46,103,.447,39,93,132,23,15,25,14,47,206,2015/2016
"Hickson,J.J.",55,109,.505,0,0,,55,109,.505,27,59,.458,22,65,87,16,10,16,12,35,137,2015/2016
"Hickson,J.J.",25,46,.543,0,1,.000,25,45,.556,19,44,.432,17,28,45,7,5,9,2,12,69,2015/2016
"Hilário,Nenê",209,384,.544,0,3,.000,209,381,.549,107,185,.578,52,207,259,97,54,76,26,156,525,2015/2016
"Hill,George",326,739,.441,128,314,.408,198,425,.466,114,150,.760,58,240,298,259,83,101,17,149,894,2015/2016
"Hill,Jordan",278,549,.506,0,1,.000,278,548,.507,89,125,.712,156,295,451,87,36,92,37,155,645,2015/2016
"Hill,Solomon",93,208,.447,24,74,.324,69,134,.515,36,42,.857,39,127,166,57,37,33,11,68,246,2015/2016
"Hilliard,Darrun",52,131,.397,19,50,.380,33,81,.407,29,40,.725,5,40,45,27,9,19,1,28,152,2015/2016
"Hinrich,Kirk",49,129,.380,24,62,.387,25,67,.373,15,16,.938,8,62,70,73,15,30,2,64,137,2015/2016
"Hinrich,Kirk",47,118,.398,23,56,.411,24,62,.387,15,16,.938,7,51,58,59,13,27,1,63,132,2015/2016
"Hinrich,Kirk",2,11,.182,1,6,.167,1,5,.200,0,0,,1,11,12,14,2,3,1,1,5,2015/2016
"Holiday,Jrue",410,935,.439,87,259,.336,323,676,.478,182,216,.843,27,168,195,391,88,167,22,148,1089,2015/2016
"Holiday,Justin",88,228,.386,36,105,.343,52,123,.423,27,37,.730,12,78,90,56,32,39,19,61,239,2015/2016
"Holiday,Justin",24,73,.329,10,45,.222,14,28,.500,5,10,.500,4,23,27,11,13,13,4,21,63,2015/2016
"Holiday,Justin",64,155,.413,26,60,.433,38,95,.400,22,27,.815,8,55,63,45,19,26,15,40,176,2015/2016
"Hollins,Ryan",49,79,.620,0,0,,49,79,.620,26,42,.619,47,51,98,10,6,24,21,62,124,2015/2016
"Hollins,Ryan",4,7,.571,0,0,,4,7,.571,0,0,,7,4,11,0,0,3,1,4,8,2015/2016
"Hollins,Ryan",45,72,.625,0,0,,45,72,.625,26,42,.619,40,47,87,10,6,21,20,58,116,2015/2016
"Hollis-Jefferson,Rondae",63,138,.457,4,14,.286,59,124,.476,37,52,.712,39,115,154,43,39,26,16,61,167,2015/2016
"Holmes,Richaun",114,222,.514,8,44,.182,106,178,.596,51,74,.689,62,73,135,33,19,32,40,92,287,2015/2016
"Hood,Rodney",408,972,.420,161,449,.359,247,523,.472,172,200,.860,38,229,267,213,73,125,16,202,1149,2015/2016
"Horford,Al",529,1048,.505,88,256,.344,441,792,.557,103,129,.798,148,448,596,263,68,107,121,163,1249,2015/2016
"Howard,Dwight",372,600,.620,0,6,.000,372,594,.626,232,474,.489,238,597,835,98,69,166,113,219,976,2015/2016
"Huertas,Marcelo",97,230,.422,16,61,.262,81,169,.479,27,29,.931,18,72,90,182,26,80,7,76,237,2015/2016
"Huestis,Josh",5,12,.417,4,6,.667,1,6,.167,0,4,.000,2,8,10,0,1,3,2,3,14,2015/2016
"Humphries,Kris",121,295,.410,34,108,.315,87,187,.465,67,84,.798,57,161,218,36,16,38,23,94,343,2015/2016
"Humphries,Kris",64,158,.405,23,67,.343,41,91,.451,29,31,.935,26,89,115,16,3,20,14,42,180,2015/2016
"Humphries,Kris",10,36,.278,3,10,.300,7,26,.269,6,8,.750,11,21,32,7,3,4,2,8,29,2015/2016
"Humphries,Kris",47,101,.465,8,31,.258,39,70,.557,32,45,.711,20,51,71,13,10,14,7,44,134,2015/2016
"Hunter,R.J.",36,98,.367,19,63,.302,17,35,.486,6,7,.857,2,35,37,13,14,11,4,29,97,2015/2016
"Ibaka,Serge",416,869,.479,60,184,.326,356,685,.520,91,121,.752,141,392,533,66,38,108,148,211,983,2015/2016
"Iguodala,Andre",176,368,.478,54,154,.351,122,214,.570,51,83,.614,52,211,263,219,73,79,19,102,457,2015/2016
"İlyasova,Ersan",280,661,.424,96,259,.371,184,402,.458,111,154,.721,144,259,403,67,52,71,33,171,767,2015/2016
"İlyasova,Ersan",216,508,.425,78,215,.363,138,293,.471,79,109,.725,99,183,282,55,38,59,27,120,589,2015/2016
"İlyasova,Ersan",64,153,.418,18,44,.409,46,109,.422,32,45,.711,45,76,121,12,14,12,6,51,178,2015/2016
"Ingles,Joe",124,291,.426,81,210,.386,43,81,.531,13,18,.722,19,132,151,96,55,65,4,98,342,2015/2016
"Inglis,Damien",13,37,.351,3,13,.231,10,24,.417,7,8,.875,2,29,31,10,6,11,3,11,36,2015/2016
"Irving,Kyrie",394,879,.448,84,262,.321,310,617,.502,169,191,.885,44,113,157,249,56,124,18,107,1041,2015/2016
"Jack,Jarrett",140,358,.391,31,102,.304,109,256,.426,100,112,.893,9,127,136,236,34,94,7,77,411,2015/2016
"Jackson,Reggie",540,1244,.434,118,334,.353,422,910,.464,291,337,.864,58,195,253,492,59,223,11,187,1489,2015/2016
"James,LeBron",737,1416,.520,87,282,.309,650,1134,.573,359,491,.731,111,454,565,514,104,249,49,143,1920,2015/2016
"Jefferson,Al",245,505,.485,0,0,,245,505,.485,72,111,.649,57,244,301,70,30,34,41,117,562,2015/2016
"Jefferson,Cory",9,22,.409,0,1,.000,9,21,.429,4,6,.667,6,10,16,0,0,0,1,8,22,2015/2016
"Jefferson,Richard",143,312,.458,66,173,.382,77,139,.554,58,87,.667,15,113,128,59,33,43,14,129,410,2015/2016
"Jenkins,John",71,160,.444,16,51,.314,55,109,.505,20,24,.833,8,49,57,35,8,27,1,22,178,2015/2016
"Jenkins,John",29,70,.414,3,19,.158,26,51,.510,8,9,.889,4,18,22,9,3,11,0,11,69,2015/2016
"Jenkins,John",42,90,.467,13,32,.406,29,58,.500,12,15,.800,4,31,35,26,5,16,1,11,109,2015/2016
"Jennings,Brandon",112,304,.368,51,155,.329,61,149,.409,57,78,.731,16,80,96,170,29,57,7,57,332,2015/2016
"Jennings,Brandon",53,143,.371,24,77,.312,29,66,.439,27,38,.711,5,41,46,70,11,22,2,24,157,2015/2016
"Jennings,Brandon",59,161,.366,27,78,.346,32,83,.386,30,40,.750,11,39,50,100,18,35,5,33,175,2015/2016
"Jerebko,Jonas",118,286,.413,43,108,.398,75,178,.421,61,78,.782,77,211,288,62,20,52,24,137,340,2015/2016
"Johnson,Amir",249,426,.585,10,43,.233,239,383,.624,69,121,.570,178,327,505,138,52,94,83,214,577,2015/2016
"Johnson,Chris",72,194,.371,27,99,.273,45,95,.474,34,42,.810,27,105,132,45,32,40,20,100,205,2015/2016
"Johnson,James",114,240,.475,20,66,.303,94,174,.540,39,68,.574,28,98,126,67,29,54,33,84,287,2015/2016
"Johnson,Joe",377,859,.439,120,313,.383,257,546,.471,118,142,.831,49,243,292,318,61,159,4,146,992,2015/2016
"Johnson,Joe",247,608,.406,85,229,.371,162,379,.427,92,108,.852,34,190,224,232,40,116,2,100,671,2015/2016
"Johnson,Joe",130,251,.518,35,84,.417,95,167,.569,26,34,.765,15,53,68,86,21,43,2,46,321,2015/2016
"Johnson,Orlando",9,34,.265,2,10,.200,7,24,.292,6,8,.750,4,11,15,2,3,4,3,9,26,2015/2016
"Johnson,Orlando",5,17,.294,1,5,.200,4,12,.333,5,6,.833,3,6,9,0,2,1,3,5,16,2015/2016
"Johnson,Orlando",4,17,.235,1,5,.200,3,12,.250,1,2,.500,1,5,6,2,1,3,0,4,10,2015/2016
"Johnson,Stanley",225,600,.375,63,205,.307,162,395,.410,80,102,.784,58,248,306,118,55,114,12,178,593,2015/2016
"Johnson,Tyler",118,243,.486,27,71,.380,91,172,.529,51,64,.797,28,81,109,79,24,47,14,66,314,2015/2016
"Johnson,Wesley",208,515,.404,103,309,.333,105,206,.510,30,46,.652,37,211,248,49,89,54,56,173,549,2015/2016
"Jokić,Nikola",307,600,.512,28,84,.333,279,516,.541,154,190,.811,181,379,560,189,79,104,50,208,796,2015/2016
"Jones,Dahntay",6,14,.429,1,2,.500,5,12,.417,0,0,,1,4,5,2,1,0,2,6,13,2015/2016
"Jones,James",58,142,.408,41,104,.394,17,38,.447,21,26,.808,8,42,50,14,11,13,10,50,178,2015/2016
"Jones,Terrence",166,367,.452,25,79,.316,141,288,.490,77,116,.664,62,149,211,41,23,49,39,86,434,2015/2016
"Jones,Tyus",56,156,.359,16,53,.302,40,103,.388,28,39,.718,7,40,47,108,31,33,3,33,156,2015/2016
"Jordan,DeAndre",357,508,.703,0,1,.000,357,507,.704,266,619,.430,267,792,1059,90,51,107,177,207,980,2015/2016
"Joseph,Cory",257,585,.439,30,110,.273,227,475,.478,133,174,.764,39,171,210,250,63,102,20,131,677,2015/2016
"Kaman,Chris",20,43,.465,1,4,.250,19,39,.487,3,3,1.000,7,17,24,11,1,8,1,15,44,2015/2016
"Kaminsky,Frank",215,525,.410,68,202,.337,147,323,.455,108,148,.730,69,266,335,98,38,58,43,126,606,2015/2016
"Kanter,Enes",414,719,.576,10,21,.476,404,698,.579,200,251,.797,249,415,664,33,26,115,33,166,1038,2015/2016
"Karasev,Sergey",30,74,.405,11,37,.297,19,37,.514,26,28,.929,8,50,58,35,6,22,2,27,97,2015/2016
"Kaun,Sasha",9,17,.529,0,0,,9,17,.529,5,11,.455,12,14,26,3,4,7,5,11,23,2015/2016
"Kelly,Ryan",55,149,.369,5,37,.135,50,112,.446,37,54,.685,21,100,121,20,13,18,10,39,152,2015/2016
"Kidd-Gilchrist,Michael",33,61,.541,3,7,.429,30,54,.556,20,29,.690,12,33,45,9,3,8,3,9,89,2015/2016
"Kilpatrick,Sean",123,270,.456,39,114,.342,84,156,.538,60,67,.896,12,44,56,29,12,31,2,37,345,2015/2016
"Kilpatrick,Sean",8,21,.381,4,17,.235,4,4,1.000,7,8,.875,2,4,6,3,2,4,0,7,27,2015/2016
"Kilpatrick,Sean",115,249,.462,35,97,.361,80,152,.526,53,59,.898,10,40,50,26,10,27,2,30,318,2015/2016
"Knight,Brandon",371,895,.415,120,351,.342,251,544,.461,156,183,.852,36,166,202,263,61,177,20,124,1018,2015/2016
"Korver,Kyle",268,616,.435,158,397,.398,110,219,.502,45,54,.833,14,246,260,164,60,98,35,161,739,2015/2016
"Koufos,Kosta",236,444,.532,0,0,,236,444,.532,57,104,.548,169,254,423,33,40,48,70,185,529,2015/2016
"Lamb,Jeremy",230,510,.451,56,181,.309,174,329,.529,64,88,.727,44,208,252,77,42,50,30,105,580,2015/2016
"Landry,Carl",139,250,.556,6,13,.462,133,237,.561,67,91,.736,49,97,146,32,12,22,9,69,351,2015/2016
"Larkin,Shane",222,502,.442,39,108,.361,183,394,.464,83,107,.776,28,152,180,342,95,146,12,121,566,2015/2016
"Lauvergne,Joffrey",195,380,.513,13,53,.245,182,327,.557,62,69,.899,77,213,290,56,13,54,15,115,465,2015/2016
"LaVine,Zach",433,959,.452,123,316,.389,310,643,.482,161,203,.793,27,201,228,251,69,155,17,193,1150,2015/2016
"Lawson,Ty",139,354,.393,36,108,.333,103,246,.419,59,86,.686,26,94,120,237,53,95,7,87,373,2015/2016
"Lawson,Ty",111,287,.387,31,94,.330,80,193,.415,56,80,.700,20,69,89,180,43,82,6,71,309,2015/2016
"Lawson,Ty",28,67,.418,5,14,.357,23,53,.434,3,6,.500,6,25,31,57,10,13,1,16,64,2015/2016
"Lee,Courtney",290,639,.454,82,217,.378,208,422,.493,99,118,.839,29,176,205,136,85,72,28,134,761,2015/2016
"Lee,Courtney",192,419,.458,51,138,.370,141,281,.502,76,92,.826,19,99,118,76,52,49,16,79,511,2015/2016
"Lee,Courtney",98,220,.445,31,79,.392,67,141,.475,23,26,.885,10,77,87,60,33,23,12,55,250,2015/2016
"Lee,David",178,335,.531,0,1,.000,178,334,.533,71,93,.763,101,204,305,84,22,66,28,114,427,2015/2016
"Lee,David",87,192,.453,0,1,.000,87,191,.455,40,51,.784,41,89,130,54,12,38,13,51,214,2015/2016
"Lee,David",91,143,.636,0,0,,91,143,.636,31,42,.738,60,115,175,30,10,28,15,63,213,2015/2016
"Len,Alex",264,624,.423,1,7,.143,263,617,.426,174,239,.728,178,416,594,97,38,145,62,230,703,2015/2016
"Leonard,Kawhi",551,1090,.506,129,291,.443,422,799,.528,292,334,.874,95,398,493,186,128,105,71,133,1523,2015/2016
"Leonard,Meyers",195,435,.448,86,228,.377,109,207,.527,35,46,.761,51,263,314,92,8,77,18,183,511,2015/2016
"Leuer,Jon",224,466,.481,42,110,.382,182,356,.511,77,101,.762,76,297,373,72,38,75,30,125,567,2015/2016
"Lillard,Damian",618,1474,.419,229,610,.375,389,864,.450,414,464,.892,45,257,302,512,65,242,28,165,1879,2015/2016
"Lin,Jeremy",300,728,.412,76,226,.336,224,502,.446,238,292,.815,42,211,253,235,58,150,42,165,914,2015/2016
"Livingston,Shaun",203,379,.536,2,12,.167,201,367,.548,80,93,.860,42,127,169,237,57,78,27,140,488,2015/2016
"Looney,Kevon",4,7,.571,1,2,.500,3,5,.600,0,0,,4,6,10,0,0,1,0,2,9,2015/2016
"Lopez,Brook",591,1157,.511,2,14,.143,589,1143,.515,317,403,.787,204,369,573,147,58,175,124,215,1501,2015/2016
"Lopez,Robin",357,662,.539,0,1,.000,357,661,.540,128,161,.795,268,334,602,114,16,133,129,182,842,2015/2016
"Love,Kevin",409,977,.419,158,439,.360,251,538,.467,258,314,.822,149,613,762,186,58,142,41,159,1234,2015/2016
"Lowry,Kyle",512,1198,.427,212,547,.388,300,651,.461,398,491,.811,55,310,365,494,158,225,34,211,1634,2015/2016
"Lyles,Trey",191,436,.438,49,128,.383,142,308,.461,57,82,.695,59,240,299,59,26,65,18,114,488,2015/2016
"Mack,Shelvin",182,415,.439,39,125,.312,143,290,.493,45,61,.738,13,115,128,187,34,95,3,72,448,2015/2016
"Mack,Shelvin",40,95,.421,4,27,.148,36,68,.529,9,12,.750,2,20,22,38,8,14,0,7,93,2015/2016
"Mack,Shelvin",142,320,.444,35,98,.357,107,222,.482,36,49,.735,11,95,106,149,26,81,3,65,355,2015/2016
"Mahinmi,Ian",264,448,.589,0,0,,264,448,.589,132,225,.587,138,369,507,104,65,100,75,220,660,2015/2016
"Marble,Devyn",21,71,.296,8,32,.250,13,39,.333,10,24,.417,6,32,38,12,13,7,1,25,60,2015/2016
"Marjanović,Boban",105,174,.603,0,0,,105,174,.603,87,114,.763,73,121,194,21,12,29,23,54,297,2015/2016
"Marshall,Kendall",43,118,.364,16,49,.327,27,69,.391,9,13,.692,2,26,28,73,16,43,2,30,111,2015/2016
"Martin,Jarell",54,116,.466,0,2,.000,54,114,.474,45,62,.726,39,47,86,15,8,19,7,58,153,2015/2016
"Martin,Kevin",156,419,.372,49,136,.360,107,283,.378,153,172,.890,14,96,110,58,26,54,3,83,514,2015/2016
"Martin,Kevin",126,334,.377,38,103,.369,88,231,.381,125,142,.880,10,71,81,46,17,41,1,68,415,2015/2016
"Martin,Kevin",30,85,.353,11,33,.333,19,52,.365,28,30,.933,4,25,29,12,9,13,2,15,99,2015/2016
"Matthews,Wesley",331,854,.388,189,525,.360,142,329,.432,126,146,.863,27,211,238,151,78,78,17,179,977,2015/2016
"Mayo,O.J.",119,321,.371,52,162,.321,67,159,.421,31,40,.775,13,92,105,118,48,72,8,126,321,2015/2016
"Mbah a Moute,Luc",94,207,.454,13,40,.325,81,167,.485,30,57,.526,60,111,171,30,44,34,19,100,231,2015/2016
"McAdoo,James Michael",45,84,.536,1,2,.500,44,82,.537,26,49,.531,30,28,58,17,10,16,8,39,117,2015/2016
"McCallum,Ray",55,146,.377,15,42,.357,40,104,.385,12,15,.800,8,39,47,60,12,24,7,29,137,2015/2016
"McCallum,Ray",27,67,.403,5,16,.313,22,51,.431,9,10,.900,6,25,31,33,5,11,4,14,68,2015/2016
"McCallum,Ray",28,79,.354,10,26,.385,18,53,.340,3,5,.600,2,14,16,27,7,13,3,15,69,2015/2016
"McCollum,CJ",641,1431,.448,197,472,.417,444,959,.463,187,226,.827,47,212,259,341,97,196,23,187,1666,2015/2016
"McConnell,T.J.",218,464,.470,31,89,.348,187,375,.499,26,41,.634,43,207,250,367,95,140,10,114,493,2015/2016
"McCullough,Chris",44,109,.404,13,34,.382,31,75,.413,11,23,.478,25,43,68,9,28,15,12,39,112,2015/2016
"McDaniels,K.J.",29,72,.403,7,25,.280,22,47,.468,24,30,.800,16,26,42,10,7,17,6,30,89,2015/2016
"McDermott,Doug",291,644,.452,110,259,.425,181,385,.470,72,84,.857,37,158,195,59,14,53,6,127,764,2015/2016
"McGary,Mitch",11,23,.478,0,4,.000,11,19,.579,4,10,.400,4,14,18,3,1,7,2,10,26,2015/2016
"McGee,JaVale",77,134,.575,0,1,.000,77,133,.579,18,36,.500,53,80,133,3,5,21,26,49,172,2015/2016
"McLemore,Ben",195,455,.429,67,185,.362,128,270,.474,74,103,.718,34,114,148,79,52,99,10,140,531,2015/2016
"McRae,Jordan",34,78,.436,10,22,.455,24,56,.429,21,28,.750,4,16,20,25,3,15,1,17,99,2015/2016
"McRae,Jordan",11,26,.423,3,11,.273,8,15,.533,12,15,.800,2,6,8,10,3,6,0,7,37,2015/2016
"McRae,Jordan",23,52,.442,7,11,.636,16,41,.390,9,13,.692,2,10,12,15,0,9,1,10,62,2015/2016
"McRoberts,Josh",55,148,.372,12,49,.245,43,99,.434,28,40,.700,22,83,105,81,18,30,7,68,150,2015/2016
"Meeks,Jodie",7,20,.350,4,9,.444,3,11,.273,4,4,1.000,1,4,5,3,0,1,0,2,22,2015/2016
"Mejri,Salah",49,78,.628,0,1,.000,49,77,.636,27,46,.587,41,82,123,10,8,23,36,54,125,2015/2016
"Mickey,Jordan",8,22,.364,0,0,,8,22,.364,5,10,.500,6,7,13,1,0,1,11,5,21,2015/2016
"Middleton,Khris",507,1142,.444,143,361,.396,364,781,.466,277,312,.888,44,258,302,331,131,180,19,204,1434,2015/2016
"Miles,C.J.",259,634,.409,142,387,.367,117,247,.474,93,124,.750,25,150,175,63,53,70,29,142,753,2015/2016
"Miller,Andre",59,106,.557,2,8,.250,57,98,.582,24,32,.750,12,39,51,87,16,37,0,46,144,2015/2016
"Miller,Andre",36,58,.621,1,4,.250,35,54,.648,15,19,.789,6,18,24,58,9,25,0,32,88,2015/2016
"Miller,Andre",23,48,.479,1,4,.250,22,44,.500,9,13,.692,6,21,27,29,7,12,0,14,56,2015/2016
"Miller,Mike",22,62,.355,19,52,.365,3,10,.300,0,0,,6,47,53,40,13,17,4,53,63,2015/2016
"Mills,Patty",260,612,.425,123,320,.384,137,292,.469,47,58,.810,27,131,158,226,59,76,6,102,690,2015/2016
"Millsap,Elijah",11,39,.282,1,12,.083,10,27,.370,13,18,.722,6,29,35,19,7,9,3,33,36,2015/2016
"Millsap,Paul",501,1066,.470,74,232,.319,427,834,.512,309,408,.757,198,534,732,265,147,191,139,237,1385,2015/2016
"Mirotić,Nikola",248,609,.407,135,346,.390,113,263,.430,146,181,.807,58,304,362,100,58,102,46,151,777,2015/2016
"Mohammed,Nazr",3,5,.600,0,0,,3,5,.600,2,2,1.000,1,3,4,0,0,3,0,4,8,2015/2016
"Monroe,Greg",491,941,.522,0,1,.000,491,940,.522,228,308,.740,218,478,696,178,72,129,67,163,1210,2015/2016
"Montero,Luis",5,19,.263,1,9,.111,4,10,.400,3,4,.750,0,4,4,1,0,4,0,1,14,2015/2016
"Moore,E'Twaun",187,389,.481,47,104,.452,140,285,.491,22,35,.629,19,114,133,99,37,53,18,103,443,2015/2016
"Moreland,Eric",3,6,.500,0,0,,3,6,.500,2,4,.500,3,8,11,1,0,3,4,4,8,2015/2016
"Morris,Marcus",410,945,.434,108,298,.362,302,647,.467,203,271,.749,91,313,404,201,67,140,23,170,1131,2015/2016
"Morris,Markieff",305,718,.425,47,155,.303,258,563,.458,108,147,.735,73,279,352,124,58,135,34,184,765,2015/2016
"Morris,Markieff",171,431,.397,22,76,.289,149,355,.420,66,92,.717,43,151,194,87,33,90,17,104,430,2015/2016
"Morris,Markieff",134,287,.467,25,79,.316,109,208,.524,42,55,.764,30,128,158,37,25,45,17,80,335,2015/2016
"Morrow,Anthony",136,333,.408,79,204,.387,57,129,.442,29,39,.744,10,52,62,24,22,17,5,64,380,2015/2016
"Motiejūnas,Donatas",90,205,.439,16,57,.281,74,148,.500,34,53,.642,37,72,109,41,17,44,5,69,230,2015/2016
"Mozgov,Timofey",203,359,.565,1,7,.143,202,352,.574,68,95,.716,110,227,337,33,22,71,57,159,475,2015/2016
"Mudiay,Emmanuel",329,905,.364,74,232,.319,255,673,.379,140,209,.670,32,200,232,372,65,217,35,141,872,2015/2016
"Muhammad,Shabazz",317,681,.465,44,152,.289,273,529,.516,185,242,.764,100,167,267,52,24,70,7,94,863,2015/2016
"Munford,Xavier",32,77,.416,9,23,.391,23,54,.426,7,14,.500,3,28,31,22,13,15,3,25,80,2015/2016
"Muscala,Mike",76,152,.500,12,39,.308,64,113,.566,31,39,.795,38,79,117,34,13,27,27,72,195,2015/2016
"Nance,Larry",158,300,.527,1,10,.100,157,290,.541,32,47,.681,101,211,312,44,54,41,23,124,349,2015/2016
"Napier,Shabazz",68,201,.338,34,104,.327,34,97,.351,33,45,.733,9,46,55,97,23,46,1,38,203,2015/2016
"Neal,Gary",151,325,.465,41,100,.410,110,225,.489,47,55,.855,11,72,83,47,20,29,1,55,390,2015/2016
"Nelson,Jameer",113,307,.368,43,144,.299,70,163,.429,30,35,.857,19,96,115,190,25,66,5,100,299,2015/2016
"Neto,Raul",180,418,.431,64,162,.395,116,256,.453,52,70,.743,17,103,120,174,62,109,2,122,476,2015/2016
"Nicholson,Andrew",146,310,.471,41,114,.360,105,196,.536,51,65,.785,34,167,201,25,10,41,22,69,384,2015/2016
"Noah,Joakim",51,133,.383,0,1,.000,51,132,.386,22,45,.489,87,168,255,110,18,52,29,77,124,2015/2016
"Noel,Nerlens",306,587,.521,1,2,.500,305,585,.521,134,227,.590,154,388,542,122,118,158,100,192,747,2015/2016
"Nogueira,Lucas",28,44,.636,1,3,.333,27,41,.659,8,15,.533,18,28,46,7,12,11,12,29,65,2015/2016
"Novak,Steve",8,18,.444,7,15,.467,1,3,.333,1,1,1.000,0,5,5,0,0,1,0,3,24,2015/2016
"Novak,Steve",6,12,.500,5,9,.556,1,3,.333,0,0,,0,4,4,0,0,1,0,1,17,2015/2016
"Novak,Steve",2,6,.333,2,6,.333,0,0,,1,1,1.000,0,1,1,0,0,0,0,2,7,2015/2016
"Nowitzki,Dirk",498,1112,.448,126,342,.368,372,770,.483,250,280,.893,52,437,489,132,52,84,52,161,1372,2015/2016
"Nurkić,Jusuf",101,242,.417,0,3,.000,101,239,.423,61,99,.616,65,110,175,40,24,55,44,91,263,2015/2016
"O'Brien,J.J.",0,1,.000,0,0,,0,1,.000,0,0,,0,1,1,0,1,0,0,1,0,2015/2016
"O'Bryant,Johnny",86,209,.411,1,1,1.000,85,208,.409,27,40,.675,65,111,176,32,18,31,8,100,200,2015/2016
"O'Quinn,Kyle",129,271,.476,5,22,.227,124,249,.498,46,60,.767,76,174,250,72,20,61,49,107,309,2015/2016
"Okafor,Jahlil",397,781,.508,1,6,.167,396,775,.511,133,194,.686,122,251,373,65,22,124,61,140,928,2015/2016
"Oladipo,Victor",425,970,.438,98,282,.348,327,688,.475,205,247,.830,48,297,345,282,116,153,54,174,1153,2015/2016
"Olynyk,Kelly",253,556,.455,85,210,.405,168,346,.486,96,128,.750,72,209,281,105,52,74,33,163,687,2015/2016
"Oubre,Kelly",90,211,.427,25,79,.316,65,132,.492,31,49,.633,25,108,133,13,22,34,7,100,236,2015/2016
"Pachulia,Zaza",219,470,.466,0,3,.000,219,467,.469,212,276,.768,249,469,718,128,64,119,22,181,650,2015/2016
"Papanikolaou,Kostas",24,66,.364,10,32,.313,14,34,.412,9,14,.643,8,32,40,16,13,21,5,24,67,2015/2016
"Parker,Jabari",443,899,.493,9,35,.257,434,864,.502,175,228,.768,123,272,395,130,69,116,29,154,1070,2015/2016
"Parker,Tony",350,710,.493,27,65,.415,323,645,.501,130,171,.760,17,159,176,379,54,131,11,114,857,2015/2016
"Parsons,Chandler",320,651,.492,104,251,.414,216,400,.540,93,136,.684,29,256,285,169,46,95,21,114,837,2015/2016
"Patterson,Lamar",28,80,.350,12,49,.245,16,31,.516,16,22,.727,4,46,50,39,9,23,2,45,84,2015/2016
"Patterson,Patrick",204,493,.414,106,293,.362,98,200,.490,29,34,.853,77,265,342,94,53,65,32,128,543,2015/2016
"Paul,Chris",515,1114,.462,122,329,.371,393,785,.501,294,328,.896,39,271,310,738,152,194,13,185,1446,2015/2016
"Payne,Adreian",53,145,.366,9,32,.281,44,113,.389,17,26,.654,20,91,111,29,16,36,11,77,132,2015/2016
"Payne,Cameron",114,278,.410,36,111,.324,78,167,.467,19,24,.792,9,76,85,108,36,44,6,80,283,2015/2016
"Payton,Elfrid",318,730,.436,30,92,.326,288,638,.451,112,190,.589,77,184,261,468,89,177,20,159,778,2015/2016
"Peković,Nikola",19,50,.380,0,0,,19,50,.380,16,20,.800,7,14,21,11,1,9,0,22,54,2015/2016
"Perkins,Kendrick",40,75,.533,0,0,,40,75,.533,11,25,.440,25,103,128,31,11,41,11,64,91,2015/2016
"Pierce,Paul",144,397,.363,75,242,.310,69,155,.445,54,66,.818,12,174,186,71,33,58,17,129,417,2015/2016
"Pleiß,Tibor",11,25,.440,0,2,.000,11,23,.478,2,2,1.000,6,9,15,2,1,8,2,19,24,2015/2016
"Plumlee,Mason",267,517,.516,0,4,.000,267,513,.520,215,335,.642,201,427,628,226,68,154,85,253,749,2015/2016
"Plumlee,Miles",140,233,.601,0,0,,140,233,.601,34,59,.576,94,138,232,16,21,40,50,73,314,2015/2016
"Porter,Otto",339,717,.473,98,267,.367,241,450,.536,95,126,.754,97,294,391,120,105,70,32,163,871,2015/2016
"Portis,Bobby",186,436,.427,16,52,.308,170,384,.443,48,66,.727,123,214,337,52,25,54,22,100,436,2015/2016
"Porziņģis,Kristaps",373,886,.421,81,243,.333,292,643,.454,201,240,.838,132,394,526,94,53,121,134,205,1028,2015/2016
"Powell,Dwight",146,296,.493,2,16,.125,144,280,.514,105,142,.739,84,189,273,44,36,40,24,118,399,2015/2016
"Powell,Norman",97,229,.424,36,89,.404,61,140,.436,43,53,.811,16,95,111,47,29,32,10,59,273,2015/2016
"Pressey,Phil",30,78,.385,4,18,.222,26,60,.433,13,25,.520,3,28,31,75,18,33,4,28,77,2015/2016
"Pressey,Phil",21,55,.382,4,13,.308,17,42,.405,9,18,.500,0,23,23,46,11,19,1,14,55,2015/2016
"Pressey,Phil",9,23,.391,0,5,.000,9,18,.500,4,7,.571,3,5,8,29,7,14,3,14,22,2015/2016
"Price,Ronnie",116,302,.384,68,196,.347,48,106,.453,31,41,.756,25,74,99,147,74,70,13,161,331,2015/2016
"Prigioni,Pablo",55,147,.374,28,95,.295,27,52,.519,7,8,.875,38,76,114,130,53,49,1,82,145,2015/2016
"Prince,Tayshaun",102,229,.445,4,23,.174,98,206,.476,13,19,.684,32,115,147,73,36,27,13,62,221,2015/2016
"Randle,Julius",358,835,.429,10,36,.278,348,799,.436,193,270,.715,172,657,829,144,53,149,29,242,919,2015/2016
"Randolph,Zach",431,907,.475,6,26,.231,425,881,.482,172,216,.796,179,350,529,142,43,105,13,146,1040,2015/2016
"Redick,J.J.",422,880,.480,200,421,.475,222,459,.484,182,205,.888,10,129,139,106,42,78,5,135,1226,2015/2016
"Reed,Willie",76,133,.571,0,0,,76,133,.571,30,55,.545,49,73,122,10,6,16,30,47,182,2015/2016
"Richardson,Josh",123,272,.452,53,115,.461,70,157,.446,42,63,.667,21,86,107,73,36,35,25,107,341,2015/2016
"Rivers,Austin",226,516,.438,62,185,.335,164,331,.495,79,116,.681,22,108,130,99,48,61,9,137,593,2015/2016
"Roberson,Andre",136,274,.496,32,103,.311,104,171,.608,33,54,.611,79,172,251,47,53,35,42,133,337,2015/2016
"Roberts,Brian",74,165,.448,15,42,.357,59,123,.480,42,47,.894,6,35,41,54,10,23,2,35,205,2015/2016
"Roberts,Brian",51,115,.443,9,27,.333,42,88,.477,34,37,.919,4,25,29,38,7,16,1,23,145,2015/2016
"Roberts,Brian",23,50,.460,6,15,.400,17,35,.486,8,10,.800,2,10,12,16,3,7,1,12,60,2015/2016
"Robinson,Glenn",65,151,.430,14,37,.378,51,114,.447,27,39,.692,12,56,68,26,17,18,9,21,171,2015/2016
"Robinson,Nate",0,1,.000,0,1,.000,0,0,,0,0,,0,0,0,4,1,0,0,5,0,2015/2016
"Robinson,Thomas",130,291,.447,0,1,.000,130,290,.448,47,109,.431,136,223,359,46,39,69,36,111,307,2015/2016
"Rondo,Rajon",355,782,.454,62,170,.365,293,612,.479,87,150,.580,77,358,435,839,141,278,10,175,859,2015/2016
"Rose,Derrick",447,1048,.427,44,150,.293,403,898,.449,142,179,.793,46,179,225,311,44,175,14,84,1080,2015/2016
"Ross,Terrence",270,626,.431,131,339,.386,139,287,.484,49,62,.790,21,164,185,56,54,46,25,120,720,2015/2016
"Rozier,Terry",29,106,.274,6,27,.222,23,79,.291,8,10,.800,24,39,63,37,6,19,1,23,72,2015/2016
"Rubio,Ricky",219,586,.374,62,190,.326,157,396,.396,266,314,.847,40,286,326,658,162,193,10,201,766,2015/2016
"Rudež,Damjan",25,62,.403,17,50,.340,8,12,.667,8,8,1.000,5,15,20,11,3,13,1,33,75,2015/2016
"Rush,Brandon",111,260,.427,65,157,.414,46,103,.447,18,28,.643,21,160,181,57,20,33,23,57,305,2015/2016
"Russell,D'Angelo",392,956,.410,130,370,.351,262,586,.447,140,190,.737,47,227,274,266,93,196,13,142,1054,2015/2016
"Sacre,Robert",31,75,.413,0,0,,31,75,.413,25,38,.658,32,40,72,14,4,12,10,43,87,2015/2016
"Sampson,JaKarr",140,317,.442,14,63,.222,126,254,.496,80,122,.656,46,144,190,46,23,70,33,142,374,2015/2016
"Sampson,JaKarr",86,202,.426,6,34,.176,80,168,.476,62,97,.639,30,99,129,30,11,51,16,91,240,2015/2016
"Sampson,JaKarr",54,115,.470,8,29,.276,46,86,.535,18,25,.720,16,45,61,16,12,19,17,51,134,2015/2016
"Schröder,Dennis",329,781,.421,77,239,.322,252,542,.465,144,182,.791,25,179,204,349,70,183,9,138,879,2015/2016
"Scola,Luis",269,598,.450,65,161,.404,204,437,.467,61,84,.726,84,276,360,66,46,68,27,178,664,2015/2016
"Scott,Mike",176,376,.468,62,158,.392,114,218,.523,50,63,.794,53,153,206,78,25,42,17,102,464,2015/2016
"Sefolosha,Thabo",188,372,.505,42,124,.339,146,248,.589,62,99,.626,52,282,334,107,85,68,37,109,480,2015/2016
"Séraphin,Kevin",84,205,.410,0,2,.000,84,203,.414,19,23,.826,31,95,126,47,8,43,36,67,187,2015/2016
"Sessions,Ramon",280,592,.473,36,111,.324,244,481,.507,214,283,.756,25,178,203,239,46,115,5,102,810,2015/2016
"Shumpert,Iman",114,305,.374,43,146,.295,71,159,.447,40,51,.784,32,171,203,92,54,57,19,119,311,2015/2016
"Simmons,Jonathon",122,242,.504,18,47,.383,104,195,.533,69,92,.750,16,80,96,58,24,53,5,103,331,2015/2016
"Sims,Henry",33,77,.429,0,0,,33,77,.429,25,30,.833,21,51,72,9,9,12,14,37,91,2015/2016
"Singler,Kyle",86,221,.389,30,97,.309,56,124,.452,29,44,.659,50,91,141,24,30,32,9,120,231,2015/2016
"Sloan,Donald",154,350,.440,38,99,.384,116,251,.462,78,104,.750,17,156,173,268,32,80,4,73,424,2015/2016
"Smart,Marcus",184,529,.348,61,241,.253,123,288,.427,129,166,.777,76,179,255,185,91,80,18,183,558,2015/2016
"Smith,Greg",18,32,.563,0,0,,18,32,.563,7,17,.412,12,30,42,6,4,7,1,28,43,2015/2016
"Smith,Ish",397,967,.411,56,170,.329,341,797,.428,122,176,.693,43,262,305,502,88,175,24,133,972,2015/2016
"Smith,Ish",98,228,.430,10,33,.303,88,195,.451,33,43,.767,14,78,92,154,24,45,6,38,239,2015/2016
"Smith,Ish",299,739,.405,46,137,.336,253,602,.420,89,133,.669,29,184,213,348,64,130,18,95,733,2015/2016
"Smith,J.R.",353,850,.415,204,510,.400,149,340,.438,45,71,.634,43,174,217,130,81,59,21,204,955,2015/2016
"Smith,Jason",244,503,.485,4,16,.250,240,487,.493,54,67,.806,53,166,219,62,33,57,65,163,546,2015/2016
"Smith,Josh",127,349,.364,41,143,.287,86,206,.417,37,67,.552,51,141,192,90,34,77,47,118,332,2015/2016
"Smith,Josh",69,180,.383,18,58,.310,51,122,.418,25,42,.595,33,92,125,42,18,41,34,62,181,2015/2016
"Smith,Josh",58,169,.343,23,85,.271,35,84,.417,12,25,.480,18,49,67,48,16,36,13,56,151,2015/2016
"Smith,Russ",7,22,.318,1,5,.200,6,17,.353,8,13,.615,1,8,9,11,5,7,1,5,23,2015/2016
"Snell,Tony",126,339,.372,56,155,.361,70,184,.380,30,33,.909,19,180,199,63,16,52,17,100,338,2015/2016
"Speights,Marreese",197,456,.432,24,62,.387,173,394,.439,94,114,.825,77,162,239,61,19,66,34,117,512,2015/2016
"Splitter,Tiago",81,155,.523,0,2,.000,81,153,.529,39,48,.813,45,75,120,30,20,24,12,71,201,2015/2016
"Stauskas,Nik",210,545,.385,106,325,.326,104,220,.473,91,118,.771,23,160,183,138,44,94,20,115,617,2015/2016
"Stephenson,Lance",228,474,.481,30,78,.385,198,396,.500,87,111,.784,40,183,223,133,43,94,9,135,573,2015/2016
"Stephenson,Lance",82,166,.494,19,47,.404,63,119,.529,21,30,.700,19,89,108,60,24,48,3,79,204,2015/2016
"Stephenson,Lance",146,308,.474,11,31,.355,135,277,.487,66,81,.815,21,94,115,73,19,46,6,56,369,2015/2016
"Stepheson,Alex",9,27,.333,0,0,,9,27,.333,4,12,.333,19,9,28,2,1,0,5,12,22,2015/2016
"Stepheson,Alex",1,1,1.000,0,0,,1,1,1.000,0,2,.000,1,1,2,0,0,0,2,4,2,2015/2016
"Stepheson,Alex",8,26,.308,0,0,,8,26,.308,4,10,.400,18,8,26,2,1,0,3,8,20,2015/2016
"Stokes,Jarnell",3,5,.600,0,0,,3,5,.600,1,2,.500,1,3,4,1,1,0,0,1,7,2015/2016
"Stokes,Jarnell",0,0,,0,0,,0,0,,0,0,,1,1,2,0,0,0,0,0,0,2015/2016
"Stokes,Jarnell",3,5,.600,0,0,,3,5,.600,1,2,.500,0,2,2,1,1,0,0,1,7,2015/2016
"Stoudemire,Amar'e",125,221,.566,0,0,,125,221,.566,50,67,.746,65,157,222,27,18,47,41,92,300,2015/2016
"Stuckey,Rodney",183,443,.413,20,83,.241,163,360,.453,131,158,.829,19,137,156,142,43,76,8,77,517,2015/2016
"Sullinger,Jared",351,806,.435,29,103,.282,322,703,.458,103,161,.640,194,479,673,187,75,102,47,209,834,2015/2016
"Tavares,Edy",11,19,.579,0,0,,11,19,.579,3,8,.375,7,14,21,3,1,5,6,8,25,2015/2016
"Teague,Jeff",434,988,.439,110,275,.400,324,713,.454,261,312,.837,33,181,214,470,97,218,24,167,1239,2015/2016
"Teletović,Mirza",332,777,.427,181,460,.393,151,317,.476,120,155,.774,55,247,302,89,32,84,21,159,965,2015/2016
"Temple,Garrett",201,505,.398,89,258,.345,112,247,.453,91,125,.728,36,176,212,140,69,64,18,195,582,2015/2016
"Terry,Jason",151,376,.402,93,261,.356,58,115,.504,27,33,.818,14,65,79,103,47,49,9,91,422,2015/2016
"Thomas,Isaiah",591,1382,.428,167,465,.359,424,917,.462,474,544,.871,46,197,243,509,91,220,9,167,1823,2015/2016
"Thomas,Lance",169,382,.442,44,109,.404,125,273,.458,102,119,.857,34,97,131,53,22,57,7,109,484,2015/2016
"Thompson,Hollis",270,680,.397,149,392,.380,121,288,.420,69,96,.719,54,218,272,99,36,76,24,187,758,2015/2016
"Thompson,Jason",52,108,.481,5,15,.333,47,93,.505,38,54,.704,32,102,134,29,12,15,20,80,147,2015/2016
"Thompson,Jason",20,42,.476,0,0,,20,42,.476,20,32,.625,10,44,54,19,4,7,8,40,60,2015/2016
"Thompson,Jason",32,66,.485,5,15,.333,27,51,.529,18,22,.818,22,58,80,10,8,8,12,40,87,2015/2016
"Thompson,Klay",651,1386,.470,276,650,.425,375,736,.510,193,221,.873,35,271,306,166,60,138,49,152,1771,2015/2016
"Thompson,Tristan",247,420,.588,0,0,,247,420,.588,149,242,.616,268,470,738,62,38,61,51,202,643,2015/2016
"Thornton,Marcus",216,542,.399,91,270,.337,125,272,.460,67,79,.848,38,112,150,85,47,51,4,90,590,2015/2016
"Thornton,Marcus",174,435,.400,73,216,.338,101,219,.461,51,58,.879,31,84,115,66,34,40,3,73,472,2015/2016
"Thornton,Marcus",42,107,.393,18,54,.333,24,53,.453,16,21,.762,7,28,35,19,13,11,1,17,118,2015/2016
"Tolliver,Anthony",128,332,.386,98,272,.360,30,60,.500,29,47,.617,39,190,229,52,26,28,16,86,383,2015/2016
"Toupane,Axel",25,70,.357,13,40,.325,12,30,.400,13,17,.765,8,23,31,15,7,6,6,40,76,2015/2016
"Towns,Karl-Anthony",625,1153,.542,30,88,.341,595,1065,.559,223,275,.811,229,629,858,161,58,183,138,245,1503,2015/2016
"Tucker,P.J.",239,582,.411,68,206,.330,171,376,.455,106,142,.746,165,347,512,177,106,111,20,202,652,2015/2016
"Turner,Evan",343,753,.456,20,83,.241,323,670,.482,148,179,.827,50,347,397,359,80,169,28,139,854,2015/2016
"Turner,Myles",264,530,.498,3,14,.214,261,516,.506,88,121,.727,68,264,332,41,25,67,86,158,619,2015/2016
"Udrih,Beno",86,198,.434,15,44,.341,71,154,.461,18,20,.900,8,64,72,116,14,53,1,51,205,2015/2016
"Udrih,Beno",20,46,.435,4,11,.364,16,35,.457,3,3,1.000,2,7,9,26,3,11,1,11,47,2015/2016
"Udrih,Beno",66,152,.434,11,33,.333,55,119,.462,15,17,.882,6,57,63,90,11,42,0,40,158,2015/2016
"Valančiūnas,Jonas",303,536,.565,0,0,,303,536,.565,162,213,.761,184,363,547,42,25,85,80,158,768,2015/2016
"Varejão,Anderson",53,124,.427,0,1,.000,53,123,.431,32,50,.640,37,104,141,35,16,22,10,70,138,2015/2016
"Varejão,Anderson",32,76,.421,0,1,.000,32,75,.427,16,21,.762,24,67,91,20,11,16,5,35,80,2015/2016
"Varejão,Anderson",21,48,.438,0,0,,21,48,.438,16,29,.552,13,37,50,15,5,6,5,35,58,2015/2016
"Vásquez,Greivis",45,138,.326,18,73,.247,27,65,.415,22,26,.846,5,42,47,91,10,40,0,42,130,2015/2016
"Vaughn,Rashad",81,266,.305,43,147,.293,38,119,.319,12,15,.800,11,77,88,39,29,28,16,73,217,2015/2016
"Villanueva,Charlie",125,327,.382,47,172,.273,78,155,.503,22,24,.917,24,128,152,24,18,31,15,71,319,2015/2016
"Vonleh,Noah",117,278,.421,11,46,.239,106,232,.457,38,51,.745,91,214,305,30,27,50,26,152,283,2015/2016
"Vučević,Nikola",533,1046,.510,2,9,.222,531,1037,.512,113,150,.753,174,402,576,179,53,123,70,173,1181,2015/2016
"Vujačić,Sasha",106,277,.383,52,143,.364,54,134,.403,32,39,.821,26,123,149,84,34,44,5,83,296,2015/2016
"Wade,Dwyane",540,1183,.456,7,44,.159,533,1139,.468,322,406,.793,82,220,302,344,79,203,42,116,1409,2015/2016
"Waiters,Dion",282,706,.399,86,240,.358,196,466,.421,112,157,.713,36,166,202,154,81,120,15,143,762,2015/2016
"Walker,Kemba",568,1331,.427,182,490,.371,386,841,.459,371,438,.847,56,301,357,421,126,171,39,111,1689,2015/2016
"Wall,John",572,1349,.424,115,328,.351,457,1021,.448,272,344,.791,42,337,379,789,145,318,59,159,1531,2015/2016
"Warren,T.J.",221,441,.501,28,70,.400,193,371,.520,45,64,.703,57,90,147,44,37,32,16,94,515,2015/2016
"Watson,C.J.",47,137,.343,14,48,.292,33,89,.371,34,39,.872,10,56,66,88,19,25,5,49,142,2015/2016
"Weber,Briante",14,39,.359,0,5,.000,14,34,.412,3,4,.750,8,17,25,21,9,9,3,12,31,2015/2016
"Weber,Briante",13,38,.342,0,5,.000,13,33,.394,3,4,.750,8,16,24,20,9,9,3,11,29,2015/2016
"Weber,Briante",1,1,1.000,0,0,,1,1,1.000,0,0,,0,1,1,1,0,0,0,1,2,2015/2016
"Weems,Sonny",42,110,.382,15,41,.366,27,69,.391,8,15,.533,7,46,53,49,10,41,1,47,107,2015/2016
"Weems,Sonny",35,89,.393,13,32,.406,22,57,.386,7,13,.538,6,35,41,47,10,37,1,40,90,2015/2016
"Weems,Sonny",7,21,.333,2,9,.222,5,12,.417,1,2,.500,1,11,12,2,0,4,0,7,17,2015/2016
"West,David",244,448,.545,3,7,.429,241,441,.546,63,80,.788,72,237,309,143,44,68,55,142,554,2015/2016
"Westbrook,Russell",656,1444,.454,101,341,.296,555,1103,.503,465,573,.812,145,481,626,834,163,342,20,200,1878,2015/2016
"Whiteside,Hassan",413,682,.606,0,0,,413,682,.606,214,329,.650,238,627,865,30,44,137,269,201,1040,2015/2016
"Whittington,Shayne",5,11,.455,0,2,.000,5,9,.556,1,2,.500,5,7,12,3,1,5,1,7,11,2015/2016
"Wiggins,Andrew",594,1294,.459,57,190,.300,537,1104,.486,430,565,.761,105,186,291,164,78,182,46,165,1675,2015/2016
"Wilcox,C.J.",26,66,.394,9,23,.391,17,43,.395,9,12,.750,1,11,12,10,10,2,2,15,70,2015/2016
"Williams,Alan",10,24,.417,0,0,,10,24,.417,9,14,.643,14,24,38,5,4,6,5,15,29,2015/2016
"Williams,Deron",321,775,.414,97,282,.344,224,493,.454,179,206,.869,19,171,190,378,61,150,14,155,918,2015/2016
"Williams,Derrick",254,565,.450,44,150,.293,210,415,.506,194,256,.758,47,249,296,75,29,61,9,69,746,2015/2016
"Williams,Elliot",2,10,.200,1,4,.250,1,6,.167,3,4,.750,1,3,4,4,0,1,0,2,8,2015/2016
"Williams,Lou",283,693,.408,110,320,.344,173,373,.464,352,424,.830,31,138,169,167,62,107,19,107,1028,2015/2016
"Williams,Marvin",338,747,.452,152,378,.402,186,369,.504,120,144,.833,127,394,521,110,58,62,77,133,948,2015/2016
"Williams,Mo",132,302,.437,36,102,.353,96,200,.480,38,42,.905,6,66,72,98,14,57,5,60,338,2015/2016
"Winslow,Justise",195,462,.422,32,116,.276,163,346,.471,80,117,.684,81,322,403,117,68,95,26,184,502,2015/2016
"Withey,Jeff",87,162,.537,0,2,.000,87,160,.544,43,59,.729,56,117,173,20,21,28,53,75,217,2015/2016
"Wood,Christian",22,53,.415,4,11,.364,18,42,.429,13,21,.619,13,25,38,3,5,2,7,11,61,2015/2016
"World Peace,Metta",55,177,.311,26,84,.310,29,93,.312,40,57,.702,19,70,89,27,22,15,11,67,176,2015/2016
"Wright,Brandan",35,52,.673,0,0,,35,52,.673,13,24,.542,14,29,43,6,5,10,15,21,83,2015/2016
"Wright,Delon",36,80,.450,5,13,.385,31,67,.463,26,35,.743,8,29,37,31,8,16,3,7,103,2015/2016
"Wroten,Tony",22,65,.338,3,17,.176,19,48,.396,20,37,.541,2,19,21,20,3,29,0,11,67,2015/2016
"Young,James",11,36,.306,6,26,.231,5,10,.500,1,4,.250,4,22,26,9,6,5,1,17,29,2015/2016
"Young,Joe",62,169,.367,10,46,.217,52,123,.423,20,25,.800,6,44,50,65,15,33,0,30,154,2015/2016
"Young,Nick",126,372,.339,77,237,.325,49,135,.363,63,76,.829,14,83,97,34,23,30,7,50,392,2015/2016
"Young,Thaddeus",495,963,.514,7,30,.233,488,933,.523,105,163,.644,176,484,660,135,112,136,37,182,1102,2015/2016
"Zeller,Cody",231,437,.529,1,10,.100,230,427,.539,175,232,.754,138,317,455,71,57,68,63,204,638,2015/2016
"Zeller,Tyler",138,290,.476,0,0,,138,290,.476,88,108,.815,62,116,178,29,10,46,22,97,364,2015/2016
"Abrines,Álex",134,341,.393,94,247,.381,40,94,.426,44,49,.898,18,68,86,40,37,33,8,114,406,2016/2017
"Acy,Quincy",70,170,.412,37,90,.411,33,80,.413,45,60,.750,20,95,115,18,14,21,15,67,222,2016/2017
"Acy,Quincy",5,17,.294,1,7,.143,4,10,.400,2,3,.667,2,6,8,0,0,2,0,9,13,2016/2017
"Acy,Quincy",65,153,.425,36,83,.434,29,70,.414,43,57,.754,18,89,107,18,14,19,15,58,209,2016/2017
"Adams,Steven",374,655,.571,0,1,.000,374,654,.572,157,257,.611,281,332,613,86,89,146,78,195,905,2016/2017
"Afflalo,Arron",185,420,.440,62,151,.411,123,269,.457,83,93,.892,9,116,125,78,21,42,6,104,515,2016/2017
"Ajinça,Alexis",89,178,.500,0,4,.000,89,174,.511,29,40,.725,46,131,177,12,20,31,22,77,207,2016/2017
"Aldrich,Cole",45,86,.523,0,0,,45,86,.523,15,22,.682,51,107,158,25,25,17,23,85,105,2016/2017
"Aldridge,LaMarcus",500,1049,.477,23,56,.411,477,993,.480,220,271,.812,172,351,523,139,46,98,88,158,1243,2016/2017
"Allen,Lavoy",77,168,.458,0,1,.000,77,167,.461,23,33,.697,105,114,219,57,18,29,24,78,177,2016/2017
"Allen,Tony",274,595,.461,15,54,.278,259,541,.479,80,130,.615,166,225,391,98,115,100,29,178,643,2016/2017
"Aminu,Al-Farouq",183,466,.393,70,212,.330,113,254,.445,96,136,.706,77,374,451,99,60,94,44,102,532,2016/2017
"Andersen,Chris",9,22,.409,0,3,.000,9,19,.474,10,14,.714,9,22,31,5,5,5,7,20,28,2016/2017
"Anderson,Alan",30,80,.375,14,44,.318,16,36,.444,12,16,.750,3,21,24,11,3,7,0,35,86,2016/2017
"Anderson,Justin",186,439,.424,58,194,.299,128,245,.522,102,129,.791,69,176,245,66,41,66,23,109,532,2016/2017
"Anderson,Justin",111,277,.401,37,122,.303,74,155,.477,70,88,.795,39,110,149,32,28,40,16,64,329,2016/2017
"Anderson,Justin",75,162,.463,21,72,.292,54,90,.600,32,41,.780,30,66,96,34,13,26,7,45,203,2016/2017
"Anderson,Kyle",93,209,.445,15,40,.375,78,169,.462,45,57,.789,33,175,208,91,51,39,26,63,246,2016/2017
"Anderson,Ryan",323,773,.418,204,506,.403,119,267,.446,129,150,.860,112,218,330,68,31,55,14,142,979,2016/2017
"Antetokounmpo,Giannis",656,1259,.521,49,180,.272,607,1079,.563,471,612,.770,142,558,700,434,131,234,151,246,1832,2016/2017
"Anthony,Carmelo",602,1389,.433,151,421,.359,451,968,.466,304,365,.833,62,376,438,213,60,153,34,198,1659,2016/2017
"Anthony,Joel",10,16,.625,0,0,,10,16,.625,5,8,.625,8,23,31,3,2,4,6,11,25,2016/2017
"Ariza,Trevor",326,798,.409,191,555,.344,135,243,.556,93,126,.738,54,404,458,175,147,73,20,133,936,2016/2017
"Arthur,Darrell",95,215,.442,53,117,.453,42,98,.429,19,22,.864,25,87,112,42,19,36,21,76,262,2016/2017
"Aşık,Ömer",31,65,.477,0,0,,31,65,.477,23,39,.590,48,115,163,15,5,14,10,51,85,2016/2017
"Augustin,D.J.",195,517,.377,95,274,.347,100,243,.412,131,161,.814,15,102,117,209,31,90,1,101,616,2016/2017
"Babbitt,Luke",113,281,.402,87,210,.414,26,71,.366,11,15,.733,12,129,141,36,20,25,11,118,324,2016/2017
"Baker,Ron",82,217,.378,23,86,.267,59,131,.450,28,43,.651,12,86,98,107,34,56,8,74,215,2016/2017
"Baldwin,Wade",36,115,.313,3,22,.136,33,93,.355,31,37,.838,11,35,46,61,18,39,7,40,106,2016/2017
"Barbosa,Leandro",172,392,.439,35,98,.357,137,294,.466,40,45,.889,15,89,104,81,31,48,8,82,419,2016/2017
"Barea,J.J.",142,343,.414,53,148,.358,89,195,.456,44,51,.863,9,75,84,193,14,63,1,30,381,2016/2017
"Barnes,Harrison",599,1280,.468,78,222,.351,521,1058,.492,242,281,.861,93,301,394,116,65,102,15,128,1518,2016/2017
"Barnes,Matt",185,473,.391,87,263,.331,98,210,.467,70,89,.787,70,314,384,195,48,107,26,185,527,2016/2017
"Barnes,Matt",147,383,.384,69,211,.327,78,172,.453,50,66,.758,55,238,293,150,36,83,17,138,413,2016/2017
"Barnes,Matt",38,90,.422,18,52,.346,20,38,.526,20,23,.870,15,76,91,45,12,24,9,47,114,2016/2017
"Barton,Will",295,666,.443,87,235,.370,208,431,.483,143,190,.753,58,201,259,206,48,97,28,110,820,2016/2017
"Bass,Brandon",107,186,.575,1,3,.333,106,183,.579,77,88,.875,43,86,129,21,14,29,11,45,292,2016/2017
"Batum,Nicolas",393,975,.403,135,405,.333,258,570,.453,243,284,.856,46,435,481,456,86,194,29,109,1164,2016/2017
"Bayless,Jerryd",11,32,.344,2,5,.400,9,27,.333,9,10,.900,3,9,12,13,0,9,0,4,33,2016/2017
"Baynes,Aron",143,279,.513,0,0,,143,279,.513,79,94,.840,111,222,333,32,17,50,39,166,365,2016/2017
"Bazemore,Kent",295,721,.409,92,266,.346,203,455,.446,119,168,.708,45,186,231,177,91,125,52,165,801,2016/2017
"Beal,Bradley",637,1322,.482,223,552,.404,414,770,.538,282,342,.825,53,187,240,267,83,156,21,169,1779,2016/2017
"Beasley,Malik",33,73,.452,9,28,.321,24,45,.533,8,10,.800,5,12,17,11,7,8,0,10,83,2016/2017
"Beasley,Michael",216,406,.532,18,43,.419,198,363,.545,78,105,.743,40,153,193,53,27,66,27,92,528,2016/2017
"Belinelli,Marco",264,615,.429,102,283,.360,162,332,.488,150,168,.893,14,164,178,147,44,70,9,90,780,2016/2017
"Bembry,DeAndre'",47,98,.480,1,18,.056,46,80,.575,6,16,.375,14,45,59,28,8,16,5,21,101,2016/2017
"Bender,Dragan",57,161,.354,28,101,.277,29,60,.483,4,11,.364,23,80,103,23,10,32,22,74,146,2016/2017
"Bennett,Anthony",38,92,.413,13,48,.271,25,44,.568,26,36,.722,25,53,78,12,5,12,3,18,115,2016/2017
"Bentil,Ben",0,3,.000,0,1,.000,0,2,.000,0,0,,0,2,2,0,0,1,0,1,0,2016/2017
"Bertāns,Dāvis",103,234,.440,69,173,.399,34,61,.557,28,34,.824,22,76,98,46,20,32,28,75,303,2016/2017
"Beverley,Patrick",228,543,.420,110,288,.382,118,255,.463,73,95,.768,95,298,393,281,99,100,25,222,639,2016/2017
"Biyombo,Bismack",179,339,.528,0,0,,179,339,.528,125,234,.534,157,410,567,74,25,95,91,202,483,2016/2017
"Bjelica,Nemanja",151,356,.424,56,177,.316,95,179,.531,45,61,.738,57,187,244,79,40,59,20,154,403,2016/2017
"Black,Tarik",150,294,.510,1,2,.500,149,292,.510,82,109,.752,144,199,343,39,29,58,44,173,383,2016/2017
"Bledsoe,Eric",449,1034,.434,104,310,.335,345,724,.477,388,458,.847,52,268,320,418,91,224,31,164,1390,2016/2017
"Bogdanović,Bojan",376,845,.445,144,392,.367,232,453,.512,217,243,.893,37,240,277,111,34,131,7,146,1113,2016/2017
"Bogdanović,Bojan",269,611,.440,99,277,.357,170,334,.509,146,167,.874,23,174,197,90,24,93,3,99,783,2016/2017
"Bogdanović,Bojan",107,234,.457,45,115,.391,62,119,.521,71,76,.934,14,66,80,21,10,38,4,47,330,2016/2017
"Bogut,Andrew",38,81,.469,0,1,.000,38,80,.475,3,11,.273,56,162,218,49,13,43,25,86,79,2016/2017
"Bogut,Andrew",38,81,.469,0,1,.000,38,80,.475,3,11,.273,56,162,218,49,13,43,25,84,79,2016/2017
"Bogut,Andrew",0,0,,0,0,,0,0,,0,0,,0,0,0,0,0,0,0,2,0,2016/2017
"Bolomboy,Joel",9,16,.563,1,4,.250,8,12,.667,3,6,.500,4,13,17,2,1,2,2,1,22,2016/2017
"Booker,Devin",606,1431,.423,147,405,.363,459,1026,.447,367,441,.832,46,203,249,268,72,241,21,242,1726,2016/2017
"Booker,Trevor",305,591,.516,25,78,.321,280,513,.546,74,110,.673,143,428,571,138,75,127,28,152,709,2016/2017
"Bradley,Avery",359,775,.463,108,277,.390,251,498,.504,68,93,.731,65,269,334,122,68,88,11,141,894,2016/2017
"Brewer,Corey",147,348,.422,27,118,.229,120,230,.522,50,68,.735,32,134,166,97,61,55,20,133,371,2016/2017
"Brewer,Corey",94,227,.414,22,94,.234,72,133,.541,32,44,.727,21,93,114,61,37,36,12,104,242,2016/2017
"Brewer,Corey",53,121,.438,5,24,.208,48,97,.495,18,24,.750,11,41,52,36,24,19,8,29,129,2016/2017
"Brogdon,Malcolm",290,635,.457,78,193,.404,212,442,.480,109,126,.865,47,166,213,317,84,113,12,140,767,2016/2017
"Brooks,Aaron",121,300,.403,48,128,.375,73,172,.424,32,40,.800,18,51,69,125,25,66,9,93,322,2016/2017
"Brown,Anthony",18,50,.360,7,27,.259,11,23,.478,0,0,,8,25,33,8,5,6,1,15,43,2016/2017
"Brown,Anthony",14,41,.341,6,24,.250,8,17,.471,0,0,,6,20,26,6,5,5,1,13,34,2016/2017
"Brown,Anthony",4,9,.444,1,3,.333,3,6,.500,0,0,,2,5,7,2,0,1,0,2,9,2016/2017
"Brown,Bobby",23,60,.383,14,35,.400,9,25,.360,2,2,1.000,0,6,6,14,1,5,0,5,62,2016/2017
"Brown,Jaylen",192,423,.454,46,135,.341,146,288,.507,85,124,.685,45,175,220,64,35,68,18,142,515,2016/2017
"Brussino,Nicolás",52,141,.369,29,95,.305,23,46,.500,17,22,.773,26,69,95,47,17,26,8,43,150,2016/2017
"Bullock,Reggie",54,128,.422,28,73,.384,26,55,.473,5,7,.714,13,51,64,29,18,10,3,22,141,2016/2017
"Burke,Trey",116,255,.455,31,70,.443,85,185,.459,22,29,.759,7,40,47,100,11,48,5,54,285,2016/2017
"Burks,Alec",99,248,.399,25,76,.329,74,172,.430,60,78,.769,17,103,120,30,18,35,5,50,283,2016/2017
"Butler,Jimmy",570,1252,.455,91,248,.367,479,1004,.477,585,676,.865,129,341,470,417,143,159,32,112,1816,2016/2017
"Caboclo,Bruno",6,16,.375,2,6,.333,4,10,.400,0,0,,5,5,10,4,2,2,1,4,14,2016/2017
"Calderón,José",55,134,.410,20,64,.313,35,70,.500,11,12,.917,15,59,74,88,11,41,1,36,141,2016/2017
"Calderón,José",32,77,.416,12,34,.353,20,43,.465,4,4,1.000,8,34,42,51,7,26,1,22,80,2016/2017
"Calderón,José",23,57,.404,8,30,.267,15,27,.556,7,8,.875,7,25,32,37,4,15,0,14,61,2016/2017
"Caldwell-Pope,Kentavious",370,928,.399,153,437,.350,217,491,.442,154,185,.832,55,193,248,193,89,86,12,118,1047,2016/2017
"Canaan,Isaiah",63,173,.364,25,94,.266,38,79,.481,30,33,.909,6,44,50,37,22,21,1,35,181,2016/2017
"Capela,Clint",362,563,.643,0,0,,362,563,.643,94,177,.531,178,348,526,63,34,87,79,179,818,2016/2017
"Carroll,DeMarre",220,550,.400,109,320,.341,111,230,.483,89,117,.761,63,212,275,74,81,54,27,143,638,2016/2017
"Carter,Vince",193,490,.394,112,296,.378,81,194,.418,88,115,.765,36,191,227,133,60,50,36,163,586,2016/2017
"Carter-Williams,Michael",112,306,.366,15,64,.234,97,242,.401,58,77,.753,24,129,153,113,38,66,23,102,297,2016/2017
"Casspi,Omri",77,164,.470,15,43,.349,62,121,.512,17,29,.586,27,85,112,37,23,29,3,50,186,2016/2017
"Casspi,Omri",53,117,.453,11,29,.379,42,88,.477,12,21,.571,20,70,90,26,10,17,1,23,129,2016/2017
"Casspi,Omri",5,9,.556,2,4,.500,3,5,.600,0,0,,1,1,2,0,0,2,0,3,12,2016/2017
"Casspi,Omri",19,38,.500,2,10,.200,17,28,.607,5,8,.625,6,14,20,11,13,10,2,24,45,2016/2017
"Cauley-Stein,Willie",255,481,.530,0,2,.000,255,479,.532,101,151,.669,85,254,339,80,53,69,44,147,611,2016/2017
"Chandler,Tyson",153,228,.671,0,0,,153,228,.671,91,124,.734,153,386,539,30,33,65,24,126,397,2016/2017
"Chandler,Wilson",433,939,.461,110,326,.337,323,613,.527,141,194,.727,103,357,460,141,51,114,30,172,1117,2016/2017
"Chriss,Marquese",284,632,.449,72,224,.321,212,408,.520,113,181,.624,96,252,348,60,67,108,70,263,753,2016/2017
"Christmas,Rakeem",19,43,.442,0,0,,19,43,.442,21,29,.724,26,30,56,4,3,8,6,37,59,2016/2017
"Christon,Semaj",77,223,.345,12,63,.190,65,160,.406,17,31,.548,19,68,87,130,28,43,7,79,183,2016/2017
"Clark,Ian",211,433,.487,61,163,.374,150,270,.556,44,58,.759,22,99,121,90,39,55,8,77,527,2016/2017
"Clarkson,Jordan",477,1071,.445,117,356,.329,360,715,.503,134,168,.798,49,197,246,213,88,164,8,150,1205,2016/2017
"Cole,Norris",16,52,.308,3,13,.231,13,39,.333,8,10,.800,0,11,11,14,8,7,0,18,43,2016/2017
"Collison,Darren",340,714,.476,73,175,.417,267,539,.495,147,171,.860,23,129,152,312,67,114,9,119,900,2016/2017
"Collison,Nick",14,23,.609,0,1,.000,14,22,.636,5,8,.625,9,22,31,12,2,4,2,17,33,2016/2017
"Conley,Mike",464,1009,.460,171,419,.408,293,590,.497,316,368,.859,31,210,241,433,92,156,19,126,1415,2016/2017
"Connaughton,Pat",37,72,.514,17,33,.515,20,39,.513,7,9,.778,10,42,52,28,6,17,2,23,98,2016/2017
"Cook,Quinn",33,66,.500,11,26,.423,22,40,.550,2,5,.400,1,6,7,26,4,13,0,13,79,2016/2017
"Cook,Quinn",11,25,.440,5,14,.357,6,11,.545,0,2,.000,0,3,3,12,1,8,0,6,27,2016/2017
"Cook,Quinn",22,41,.537,6,12,.500,16,29,.552,2,3,.667,1,3,4,14,3,5,0,7,52,2016/2017
"Cousins,DeMarcus",647,1432,.452,131,363,.361,516,1069,.483,517,670,.772,152,642,794,332,100,269,93,278,1942,2016/2017
"Cousins,DeMarcus",505,1118,.452,95,267,.356,410,851,.482,423,549,.770,115,468,583,266,75,207,74,203,1528,2016/2017
"Cousins,DeMarcus",142,314,.452,36,96,.375,106,218,.486,94,121,.777,37,174,211,66,25,62,19,75,414,2016/2017
"Covington,Robert",292,732,.399,137,412,.333,155,320,.484,143,174,.822,92,344,436,102,127,131,69,203,864,2016/2017
"Crabbe,Allen",303,647,.468,134,302,.444,169,345,.490,105,124,.847,19,207,226,94,54,62,20,171,845,2016/2017
"Crawford,Jamal",359,870,.413,116,322,.360,243,548,.443,174,203,.857,17,112,129,214,61,134,14,115,1008,2016/2017
"Crawford,Jordan",105,218,.482,37,95,.389,68,123,.553,20,26,.769,4,30,34,57,11,25,2,30,267,2016/2017
"Crowder,Jae",333,720,.463,157,394,.398,176,326,.540,176,217,.811,48,367,415,155,73,80,23,161,999,2016/2017
"Cunningham,Dante",174,359,.485,71,181,.392,103,178,.579,16,27,.593,56,221,277,37,39,28,28,100,435,2016/2017
"Curry,Seth",338,703,.481,137,322,.425,201,381,.528,85,100,.850,25,154,179,189,79,92,7,126,898,2016/2017
"Curry,Stephen",675,1443,.468,324,789,.411,351,654,.537,325,362,.898,61,292,353,524,142,239,17,183,1999,2016/2017
"Daniels,Troy",185,495,.374,138,355,.389,47,140,.336,43,54,.796,22,78,100,46,20,45,4,90,551,2016/2017
"Davis,Anthony",770,1526,.505,40,134,.299,730,1392,.524,519,647,.802,172,712,884,157,94,181,167,168,2099,2016/2017
"Davis,Deyonta",24,47,.511,0,0,,24,47,.511,10,18,.556,20,40,60,2,3,8,17,40,58,2016/2017
"Davis,Ed",75,142,.528,0,0,,75,142,.528,50,81,.617,96,148,244,26,15,37,22,137,200,2016/2017
"Dedmon,Dewayne",161,259,.622,0,0,,161,259,.622,65,93,.699,129,367,496,44,37,61,61,180,387,2016/2017
"Dekker,Sam",203,429,.473,60,187,.321,143,242,.591,38,68,.559,94,190,284,76,38,41,21,83,504,2016/2017
"Delaney,Malcolm",145,388,.374,26,110,.236,119,278,.428,75,93,.806,10,113,123,193,39,95,1,112,391,2016/2017
"Dellavedova,Matthew",208,534,.390,79,215,.367,129,319,.404,82,96,.854,24,123,147,357,53,133,0,153,577,2016/2017
"Deng,Luol",164,424,.387,51,165,.309,113,259,.436,46,63,.730,63,232,295,74,48,43,20,61,425,2016/2017
"DeRozan,DeMar",721,1545,.467,33,124,.266,688,1421,.484,545,647,.842,70,316,386,290,78,180,13,134,2020,2016/2017
"Diallo,Cheick",36,76,.474,0,0,,36,76,.474,15,21,.714,23,50,73,4,4,7,7,17,87,2016/2017
"Diaw,Boris",146,327,.446,20,81,.247,126,246,.512,26,35,.743,46,112,158,170,18,87,9,83,338,2016/2017
"Dieng,Gorgui",332,661,.502,16,43,.372,316,618,.511,136,167,.814,188,459,647,158,88,107,95,254,816,2016/2017
"Dinwiddie,Spencer",134,302,.444,38,101,.376,96,201,.478,126,159,.792,27,137,164,185,44,66,23,119,432,2016/2017
"Douglas,Toney",43,117,.368,7,42,.167,36,75,.480,24,29,.828,13,48,61,56,18,21,5,50,117,2016/2017
"Dragić,Goran",534,1124,.475,117,289,.405,417,835,.499,298,377,.790,62,217,279,423,89,212,13,199,1483,2016/2017
"Drummond,Andre",483,911,.530,2,7,.286,481,904,.532,137,355,.386,345,770,1115,90,124,152,89,237,1105,2016/2017
"Dudley,Jared",157,346,.454,77,203,.379,80,143,.559,43,65,.662,31,194,225,121,42,73,16,154,434,2016/2017
"Dunleavy,Mike",93,220,.423,53,134,.396,40,86,.465,36,45,.800,18,97,115,50,15,28,7,67,275,2016/2017
"Dunleavy,Mike",36,90,.400,20,57,.351,16,33,.485,14,19,.737,5,42,47,20,6,14,2,32,106,2016/2017
"Dunleavy,Mike",57,130,.438,33,77,.429,24,53,.453,22,26,.846,13,55,68,30,9,14,5,35,169,2016/2017
"Dunn,Kris",118,313,.377,21,73,.288,97,240,.404,36,59,.610,24,142,166,188,78,89,36,178,293,2016/2017
"Durant,Kevin",551,1026,.537,117,312,.375,434,714,.608,336,384,.875,39,474,513,300,66,138,99,117,1555,2016/2017
"Eddie,Jarell",6,19,.316,4,16,.250,2,3,.667,8,9,.889,1,6,7,0,1,1,0,1,24,2016/2017
"Ellenson,Henry",23,64,.359,10,35,.286,13,29,.448,4,8,.500,8,33,41,7,1,14,1,6,60,2016/2017
"Ellington,Wayne",231,555,.416,149,394,.378,82,161,.509,37,43,.860,18,114,132,70,35,30,4,70,648,2016/2017
"Ellis,Monta",247,557,.443,43,135,.319,204,422,.483,93,128,.727,19,185,204,236,78,135,27,149,630,2016/2017
"Embiid,Joel",200,429,.466,36,98,.367,164,331,.495,191,244,.783,61,182,243,66,27,117,76,112,627,2016/2017
"Ennis,James",146,321,.455,51,137,.372,95,184,.516,86,110,.782,69,190,259,64,46,59,19,165,429,2016/2017
"Ennis,Tyler",90,208,.433,27,70,.386,63,138,.457,21,25,.840,9,36,45,86,25,45,2,58,228,2016/2017
"Ennis,Tyler",25,64,.391,6,16,.375,19,48,.396,2,3,.667,4,15,19,34,6,24,0,29,58,2016/2017
"Ennis,Tyler",65,144,.451,21,54,.389,44,90,.489,19,22,.864,5,21,26,52,19,21,2,29,170,2016/2017
"Evans,Tyreke",150,370,.405,42,118,.356,108,252,.429,69,92,.750,13,124,137,124,35,61,9,60,411,2016/2017
"Evans,Tyreke",91,227,.401,21,70,.300,70,157,.446,45,58,.776,6,80,86,91,23,39,4,41,248,2016/2017
"Evans,Tyreke",59,143,.413,21,48,.438,38,95,.400,24,34,.706,7,44,51,33,12,22,5,19,163,2016/2017
"Exum,Dante",155,363,.427,44,149,.295,111,214,.519,58,73,.795,30,102,132,111,21,80,12,146,412,2016/2017
"Faried,Kenneth",228,416,.548,0,6,.000,228,410,.556,131,189,.693,183,279,462,55,43,59,40,124,587,2016/2017
"Farmar,Jordan",4,12,.333,4,9,.444,0,3,.000,0,0,,1,2,3,9,2,3,0,1,12,2016/2017
"Favors,Derrick",203,417,.487,3,10,.300,200,407,.491,67,109,.615,92,213,305,56,45,60,40,103,476,2016/2017
"Felder,Kay",62,158,.392,7,22,.318,55,136,.404,35,49,.714,3,38,41,58,18,30,7,38,166,2016/2017
"Felício,Cristiano",128,221,.579,0,0,,128,221,.579,60,93,.645,124,187,311,40,25,33,17,110,316,2016/2017
"Felton,Raymond",221,514,.430,46,144,.319,175,370,.473,50,64,.781,33,185,218,191,66,83,22,125,538,2016/2017
"Ferrell,Yogi",160,394,.406,68,176,.386,92,218,.422,74,89,.831,20,91,111,172,42,70,9,90,462,2016/2017
"Ferrell,Yogi",18,49,.367,8,27,.296,10,22,.455,10,16,.625,4,8,12,17,2,14,2,11,54,2016/2017
"Ferrell,Yogi",142,345,.412,60,149,.403,82,196,.418,64,73,.877,16,83,99,155,40,56,7,79,408,2016/2017
"Finney-Smith,Dorian",124,333,.372,56,191,.293,68,142,.479,46,61,.754,55,167,222,67,52,45,25,125,350,2016/2017
"Forbes,Bryn",36,99,.364,17,53,.321,19,46,.413,5,6,.833,2,21,23,23,1,11,0,20,94,2016/2017
"Fournier,Evan",408,930,.439,128,360,.356,280,570,.491,223,277,.805,44,165,209,202,66,141,4,180,1167,2016/2017
"Foye,Randy",118,325,.363,67,203,.330,51,122,.418,54,63,.857,9,146,155,135,35,80,9,99,357,2016/2017
"Frazier,Tim",163,404,.403,40,128,.313,123,276,.446,98,129,.760,34,139,173,335,56,101,6,133,464,2016/2017
"Frye,Channing",238,520,.458,137,335,.409,101,185,.546,63,74,.851,37,253,290,45,33,53,37,138,676,2016/2017
"Gallinari,Danilo",335,750,.447,126,324,.389,209,426,.491,349,387,.902,39,286,325,135,40,82,15,93,1145,2016/2017
"Galloway,Langston",207,545,.380,120,308,.390,87,237,.367,51,64,.797,27,129,156,93,46,46,6,96,585,2016/2017
"Galloway,Langston",165,441,.374,101,268,.377,64,173,.370,40,52,.769,20,101,121,65,40,28,5,76,471,2016/2017
"Galloway,Langston",42,104,.404,19,40,.475,23,64,.359,11,12,.917,7,28,35,28,6,18,1,20,114,2016/2017
"Garino,Patricio",0,7,.000,0,5,.000,0,2,.000,0,0,,1,6,7,0,0,3,0,4,0,2016/2017
"Gasol,Marc",532,1160,.459,104,268,.388,428,892,.480,278,332,.837,60,404,464,338,67,166,99,171,1446,2016/2017
"Gasol,Pau",303,604,.502,56,104,.538,247,500,.494,130,184,.707,107,394,501,150,24,81,70,110,792,2016/2017
"Gay,Rudy",201,442,.455,42,113,.372,159,329,.483,118,138,.855,35,155,190,83,44,74,26,79,562,2016/2017
"Gbinije,Michael",1,10,.100,0,4,.000,1,6,.167,2,2,1.000,2,1,3,2,0,0,0,2,4,2016/2017
"Gee,Alonzo",3,14,.214,0,3,.000,3,11,.273,5,9,.556,4,11,15,6,5,4,1,14,11,2016/2017
"George,Paul",622,1348,.461,195,496,.393,427,852,.501,336,374,.898,58,434,492,251,119,220,27,206,1775,2016/2017
"Georges-Hunt,Marcus",2,7,.286,1,2,.500,1,5,.200,9,10,.900,1,8,9,3,1,2,0,5,14,2016/2017
"Gibson,Jonathan",35,95,.368,15,45,.333,20,50,.400,21,29,.724,1,21,22,26,8,21,0,21,106,2016/2017
"Gibson,Taj",365,709,.515,3,13,.231,362,696,.520,113,158,.715,158,327,485,73,41,105,65,163,846,2016/2017
"Gibson,Taj",276,530,.521,2,12,.167,274,518,.529,85,119,.714,120,262,382,60,27,77,50,123,639,2016/2017
"Gibson,Taj",89,179,.497,1,1,1.000,88,178,.494,28,39,.718,38,65,103,13,14,28,15,40,207,2016/2017
"Ginóbili,Manu",171,439,.390,89,227,.392,82,212,.387,86,107,.804,28,129,157,183,82,96,16,119,517,2016/2017
"Gobert,Rudy",413,625,.661,0,1,.000,413,624,.662,311,476,.653,314,721,1035,97,49,147,214,246,1137,2016/2017
"Goodwin,Archie",36,66,.545,5,15,.333,31,51,.608,33,42,.786,7,21,28,24,4,14,5,8,110,2016/2017
"Goodwin,Archie",2,5,.400,1,2,.500,1,3,.333,10,10,1.000,0,0,0,1,0,0,1,1,15,2016/2017
"Goodwin,Archie",34,61,.557,4,13,.308,30,48,.625,23,32,.719,7,21,28,23,4,14,4,7,95,2016/2017
"Gordon,Aaron",393,865,.454,77,267,.288,316,598,.528,156,217,.719,116,289,405,150,65,89,40,172,1019,2016/2017
"Gordon,Eric",412,1016,.406,246,661,.372,166,355,.468,147,175,.840,29,172,201,188,48,121,41,150,1217,2016/2017
"Gortat,Marcin",390,674,.579,0,2,.000,390,672,.580,103,159,.648,238,611,849,121,40,119,61,213,883,2016/2017
"Graham,Treveon",19,40,.475,9,15,.600,10,25,.400,10,15,.667,5,17,22,6,6,3,1,18,57,2016/2017
"Grant,Jerami",152,328,.463,43,116,.371,109,212,.514,90,147,.612,38,167,205,46,33,44,79,149,437,2016/2017
"Grant,Jerami",6,17,.353,0,2,.000,6,15,.400,4,8,.500,0,6,6,0,0,3,4,5,16,2016/2017
"Grant,Jerami",146,311,.469,43,114,.377,103,197,.523,86,139,.619,38,161,199,46,33,41,75,144,421,2016/2017
"Grant,Jerian",128,301,.425,49,134,.366,79,167,.473,65,73,.890,17,94,111,121,47,44,8,93,370,2016/2017
"Green,Danny",176,449,.392,118,311,.379,58,138,.420,27,32,.844,31,193,224,124,70,76,57,120,497,2016/2017
"Green,Draymond",272,650,.418,81,263,.308,191,387,.494,151,213,.709,98,501,599,533,154,184,106,217,776,2016/2017
"Green,Gerald",95,232,.409,39,111,.351,56,121,.463,33,41,.805,16,68,84,33,9,25,7,48,262,2016/2017
"Green,JaMychal",250,500,.500,55,145,.379,195,355,.549,134,167,.802,167,377,544,84,47,94,34,248,689,2016/2017
"Green,Jeff",220,558,.394,53,193,.275,167,365,.458,145,168,.863,39,175,214,81,37,75,13,103,638,2016/2017
"Griffin,Blake",479,971,.493,38,113,.336,441,858,.514,320,421,.760,112,385,497,300,57,142,22,157,1316,2016/2017
"Hamilton,Justin",174,379,.459,55,180,.306,119,199,.598,39,52,.750,71,191,262,55,29,43,43,91,442,2016/2017
"Hammons,A.J.",17,42,.405,5,10,.500,12,32,.375,9,20,.450,8,28,36,4,1,10,13,21,48,2016/2017
"Hardaway,Tim",415,912,.455,149,417,.357,266,495,.537,164,214,.766,35,189,224,182,55,106,15,103,1143,2016/2017
"Harden,James",674,1533,.440,262,756,.347,412,777,.530,746,881,.847,95,564,659,907,121,464,38,215,2356,2016/2017
"Harkless,Maurice",314,624,.503,68,194,.351,246,430,.572,77,124,.621,125,216,341,88,85,86,70,214,773,2016/2017
"Harper,Justin",5,12,.417,2,7,.286,3,5,.600,0,0,,2,3,5,2,0,4,0,2,12,2016/2017
"Harrell,Montrezl",225,345,.652,1,7,.143,224,338,.663,76,121,.628,81,138,219,64,20,44,42,126,527,2016/2017
"Harris,Devin",136,341,.399,58,177,.328,78,164,.476,107,129,.829,11,116,127,136,43,57,7,101,437,2016/2017
"Harris,Gary",320,637,.502,107,255,.420,213,382,.558,104,134,.776,48,130,178,164,71,76,8,92,851,2016/2017
"Harris,Joe",154,362,.425,85,221,.385,69,141,.489,35,49,.714,16,131,147,54,30,55,8,121,428,2016/2017
"Harris,Manny",3,15,.200,0,2,.000,3,13,.231,2,4,.500,3,6,9,2,0,2,0,1,8,2016/2017
"Harris,Tobias",511,1063,.481,109,314,.347,402,749,.537,190,226,.841,63,353,416,142,60,96,39,133,1321,2016/2017
"Harrison,Aaron",0,4,.000,0,2,.000,0,2,.000,1,2,.500,0,3,3,3,0,0,0,2,1,2016/2017
"Harrison,Andrew",117,360,.325,43,156,.276,74,204,.363,148,194,.763,23,113,136,198,53,85,21,194,425,2016/2017
"Haslem,Udonis",11,23,.478,0,3,.000,11,20,.550,9,15,.600,8,28,36,6,6,8,1,22,31,2016/2017
"Hawes,Spencer",134,277,.484,25,81,.309,109,196,.556,44,52,.846,38,153,191,81,15,49,30,77,337,2016/2017
"Hawes,Spencer",104,218,.477,16,55,.291,88,163,.540,30,34,.882,32,114,146,62,13,40,26,61,254,2016/2017
"Hawes,Spencer",30,59,.508,9,26,.346,21,33,.636,14,18,.778,6,39,45,19,2,9,4,16,83,2016/2017
"Hayward,Gordon",545,1156,.471,149,374,.398,396,782,.506,362,429,.844,49,345,394,252,73,140,20,117,1601,2016/2017
"Henderson,Gerald",234,553,.423,61,173,.353,173,380,.455,133,165,.806,34,151,185,112,40,62,15,129,662,2016/2017
"Henson,John",159,309,.515,0,1,.000,159,308,.516,74,107,.692,92,203,295,57,29,52,78,151,392,2016/2017
"Hernangómez,Juan",101,224,.451,46,113,.407,55,111,.495,57,76,.750,43,144,187,29,30,31,12,62,305,2016/2017
"Hernangómez,Willy",246,465,.529,4,15,.267,242,450,.538,91,125,.728,170,332,502,96,41,100,36,150,587,2016/2017
"Hezonja,Mario",117,330,.355,43,144,.299,74,186,.398,40,50,.800,20,126,146,62,30,58,15,74,317,2016/2017
"Hibbert,Roy",80,147,.544,0,0,,80,147,.544,61,75,.813,54,98,152,21,8,32,46,100,221,2016/2017
"Hibbert,Roy",78,144,.542,0,0,,78,144,.542,61,75,.813,53,97,150,20,8,31,44,97,217,2016/2017
"Hibbert,Roy",2,3,.667,0,0,,2,3,.667,0,0,,1,1,2,1,0,1,2,3,4,2016/2017
"Hield,Buddy",327,767,.426,148,379,.391,179,388,.461,64,76,.842,35,234,269,121,38,101,9,115,866,2016/2017
"Hield,Buddy",185,471,.393,89,241,.369,96,230,.417,29,33,.879,19,147,166,77,18,48,7,81,488,2016/2017
"Hield,Buddy",142,296,.480,59,138,.428,83,158,.525,35,43,.814,16,87,103,44,20,53,2,34,378,2016/2017
"Hilário,Nenê",245,397,.617,3,9,.333,242,388,.624,116,197,.589,95,187,282,65,56,73,39,163,609,2016/2017
"Hill,George",289,606,.477,94,233,.403,195,373,.523,157,196,.801,23,144,167,204,50,85,11,114,829,2016/2017
"Hill,Jordan",5,13,.385,0,0,,5,13,.385,2,2,1.000,8,6,14,0,1,4,0,9,12,2016/2017
"Hill,Solomon",183,478,.383,94,270,.348,89,208,.428,103,128,.805,51,256,307,141,72,82,32,182,563,2016/2017
"Hilliard,Darrun",47,126,.373,12,46,.261,35,80,.438,21,28,.750,2,31,33,33,11,28,2,39,127,2016/2017
"Holiday,Jrue",405,893,.454,100,281,.356,305,612,.498,119,168,.708,46,218,264,488,100,194,44,133,1029,2016/2017
"Holiday,Justin",233,538,.433,97,273,.355,136,265,.513,66,80,.825,27,198,225,102,65,66,31,109,629,2016/2017
"Hollis-Jefferson,Rondae",235,542,.434,15,67,.224,220,475,.463,190,253,.751,96,356,452,154,82,116,44,177,675,2016/2017
"Holmes,Richaun",230,412,.558,27,77,.351,203,335,.606,72,103,.699,94,217,311,58,42,55,55,136,559,2016/2017
"Hood,Rodney",272,666,.408,114,307,.371,158,359,.440,90,115,.783,16,186,202,96,38,65,11,132,748,2016/2017
"Horford,Al",379,801,.473,86,242,.355,293,559,.524,108,135,.800,95,370,465,337,52,115,86,138,952,2016/2017
"House,Danuel",0,0,,0,0,,0,0,,0,0,,0,1,1,0,0,0,0,0,0,2016/2017
"Howard,Dwight",388,613,.633,0,2,.000,388,611,.635,226,424,.533,296,644,940,104,64,170,92,203,1002,2016/2017
"Huertas,Marcelo",25,68,.368,4,19,.211,21,49,.429,9,17,.529,2,22,24,52,10,19,2,16,63,2016/2017
"Huestis,Josh",6,11,.545,2,4,.500,4,7,.571,0,1,.000,4,5,9,3,0,0,3,0,14,2016/2017
"Humphries,Kris",87,214,.407,19,54,.352,68,160,.425,64,82,.780,60,146,206,29,15,28,21,69,257,2016/2017
"Hunter,R.J.",0,1,.000,0,1,.000,0,0,,0,0,,0,1,1,0,0,0,0,0,0,2016/2017
"Ibaka,Serge",471,982,.480,124,317,.391,347,665,.522,107,125,.856,129,409,538,75,41,105,124,215,1173,2016/2017
"Ibaka,Serge",343,703,.488,83,214,.388,260,489,.532,77,91,.846,100,282,382,60,34,66,91,139,846,2016/2017
"Ibaka,Serge",128,279,.459,41,103,.398,87,176,.494,30,34,.882,29,127,156,15,7,39,33,76,327,2016/2017
"Iguodala,Andre",219,415,.528,64,177,.362,155,238,.651,72,102,.706,51,253,304,261,76,58,39,97,574,2016/2017
"İlyasova,Ersan",384,890,.431,142,402,.353,242,488,.496,161,207,.778,115,366,481,141,58,116,23,211,1071,2016/2017
"İlyasova,Ersan",6,16,.375,3,12,.250,3,4,.750,0,0,,2,14,16,1,3,4,1,5,15,2016/2017
"İlyasova,Ersan",285,648,.440,107,298,.359,178,350,.509,109,142,.768,71,243,314,97,33,78,14,133,786,2016/2017
"İlyasova,Ersan",93,226,.412,32,92,.348,61,134,.455,52,65,.800,42,109,151,43,22,34,8,73,270,2016/2017
"Ingles,Joe",204,451,.452,123,279,.441,81,172,.471,50,68,.735,23,238,261,225,96,107,8,163,581,2016/2017
"Ingram,Brandon",276,686,.402,55,187,.294,221,499,.443,133,214,.621,60,256,316,166,50,116,36,158,740,2016/2017
"Irving,Kyrie",671,1420,.473,177,441,.401,494,979,.505,297,328,.905,52,178,230,418,83,180,24,157,1816,2016/2017
"Jack,Jarrett",2,3,.667,0,1,.000,2,2,1.000,2,2,1.000,0,0,0,5,2,3,0,4,6,2016/2017
"Jackson,Demetrius",3,4,.750,1,1,1.000,2,3,.667,3,6,.500,2,2,4,3,0,0,0,0,10,2016/2017
"Jackson,Pierre",13,39,.333,3,11,.273,10,28,.357,6,7,.857,1,8,9,19,2,3,0,5,35,2016/2017
"Jackson,Reggie",284,677,.419,66,184,.359,218,493,.442,118,136,.868,21,93,114,270,35,114,5,129,752,2016/2017
"James,LeBron",736,1344,.548,124,342,.363,612,1002,.611,358,531,.674,97,542,639,646,92,303,44,134,1954,2016/2017
"Jefferson,Al",235,471,.499,0,1,.000,235,470,.500,65,85,.765,75,203,278,57,19,33,16,125,535,2016/2017
"Jefferson,Richard",153,343,.446,62,186,.333,91,157,.580,80,108,.741,28,175,203,78,26,52,10,153,448,2016/2017
"Jenkins,John",2,5,.400,1,2,.500,1,3,.333,2,2,1.000,0,1,1,1,0,0,0,0,7,2016/2017
"Jennings,Brandon",192,535,.359,79,252,.313,113,283,.399,114,152,.750,29,167,196,395,70,128,4,116,577,2016/2017
"Jennings,Brandon",163,429,.380,68,200,.340,95,229,.415,102,135,.756,21,131,152,287,55,106,4,84,496,2016/2017
"Jennings,Brandon",29,106,.274,11,52,.212,18,54,.333,12,17,.706,8,36,44,108,15,22,0,32,81,2016/2017
"Jerebko,Jonas",114,262,.435,45,130,.346,69,132,.523,26,37,.703,59,213,272,71,25,39,17,122,299,2016/2017
"Johnson,Amir",213,370,.576,27,66,.409,186,304,.612,67,100,.670,118,248,366,140,51,77,62,211,520,2016/2017
"Johnson,Brice",2,7,.286,0,0,,2,7,.286,0,0,,1,2,3,1,2,1,1,0,4,2016/2017
"Johnson,James",368,769,.479,87,256,.340,281,513,.548,152,215,.707,66,310,376,276,76,171,86,197,975,2016/2017
"Johnson,Joe",273,626,.436,106,258,.411,167,368,.454,63,77,.818,33,210,243,144,36,69,18,93,715,2016/2017
"Johnson,Stanley",129,365,.353,45,154,.292,84,211,.398,36,53,.679,36,153,189,105,56,71,24,121,339,2016/2017
"Johnson,Tyler",357,824,.433,93,250,.372,264,574,.460,195,254,.768,50,243,293,233,84,90,44,176,1002,2016/2017
"Johnson,Wesley",73,200,.365,29,118,.246,44,82,.537,11,17,.647,26,155,181,23,29,18,30,83,186,2016/2017
"Jokić,Nikola",494,854,.578,45,139,.324,449,715,.628,188,228,.825,212,506,718,359,61,171,55,214,1221,2016/2017
"Jones,Dahntay",3,8,.375,0,2,.000,3,6,.500,3,4,.750,1,1,2,1,0,1,0,1,9,2016/2017
"Jones,Damian",8,16,.500,0,0,,8,16,.500,3,10,.300,9,14,23,0,1,6,4,15,19,2016/2017
"Jones,Derrick",68,121,.562,3,11,.273,65,110,.591,29,41,.707,39,40,79,12,14,13,13,63,168,2016/2017
"Jones,James",44,92,.478,31,66,.470,13,26,.500,13,20,.650,3,34,37,14,6,10,10,37,132,2016/2017
"Jones,Terrence",231,492,.470,19,75,.253,212,417,.508,103,170,.606,65,241,306,59,40,48,54,67,584,2016/2017
"Jones,Terrence",231,489,.472,19,75,.253,212,414,.512,103,170,.606,65,238,303,59,39,48,53,67,584,2016/2017
"Jones,Terrence",0,3,.000,0,0,,0,3,.000,0,0,,0,3,3,0,1,0,1,0,0,2016/2017
"Jones,Tyus",75,181,.414,26,73,.356,49,108,.454,33,43,.767,10,57,67,156,48,38,5,50,209,2016/2017
"Jordan,DeAndre",412,577,.714,0,2,.000,412,575,.717,205,425,.482,298,816,1114,96,51,115,134,212,1029,2016/2017
"Joseph,Cory",299,661,.452,48,135,.356,251,526,.477,94,122,.770,51,184,235,265,66,108,13,140,740,2016/2017
"Kaminsky,Frank",320,802,.399,116,354,.328,204,448,.455,118,156,.756,57,279,336,162,46,76,34,139,874,2016/2017
"Kanter,Enes",402,737,.545,5,38,.132,397,699,.568,224,285,.786,195,287,482,67,32,123,38,154,1033,2016/2017
"Kelly,Ryan",8,28,.286,4,10,.400,4,18,.222,5,6,.833,1,17,18,8,4,4,5,5,25,2016/2017
"Kidd-Gilchrist,Michael",295,618,.477,1,9,.111,294,609,.483,152,194,.784,156,409,565,114,81,56,77,187,743,2016/2017
"Kilpatrick,Sean",305,735,.415,105,308,.341,200,427,.468,204,242,.843,22,258,280,157,45,135,6,118,919,2016/2017
"Knight,Brandon",209,525,.398,45,139,.324,164,386,.425,132,154,.857,25,93,118,130,27,88,5,87,595,2016/2017
"Korver,Kyle",239,515,.464,162,359,.451,77,156,.494,38,42,.905,7,179,186,110,34,69,21,107,678,2016/2017
"Korver,Kyle",108,246,.439,65,159,.409,43,87,.494,24,27,.889,0,89,89,75,23,40,13,47,305,2016/2017
"Korver,Kyle",131,269,.487,97,200,.485,34,69,.493,14,15,.933,7,90,97,35,11,29,8,60,373,2016/2017
"Koufos,Kosta",216,392,.551,0,1,.000,216,391,.552,38,62,.613,118,285,403,47,36,61,48,172,470,2016/2017
"Kuzminskas,Mindaugas",158,369,.428,54,168,.321,104,201,.517,55,68,.809,47,79,126,69,29,51,11,79,425,2016/2017
"Labissière,Skal",117,218,.537,3,8,.375,114,210,.543,52,74,.703,51,111,162,27,16,37,13,64,289,2016/2017
"Lamb,Jeremy",226,491,.460,41,146,.281,185,345,.536,110,129,.853,30,234,264,75,27,40,23,98,603,2016/2017
"Laprovíttola,Nicolás",20,47,.426,10,27,.370,10,20,.500,9,9,1.000,1,9,10,28,4,19,1,19,59,2016/2017
"Lauvergne,Joffrey",148,336,.440,33,98,.337,115,238,.483,46,73,.630,72,179,251,70,25,56,6,83,375,2016/2017
"Lauvergne,Joffrey",111,244,.455,27,78,.346,84,166,.506,37,58,.638,51,132,183,51,18,40,6,71,286,2016/2017
"Lauvergne,Joffrey",37,92,.402,6,20,.300,31,72,.431,9,15,.600,21,47,68,19,7,16,0,12,89,2016/2017
"LaVine,Zach",326,710,.459,120,310,.387,206,400,.515,117,140,.836,19,141,160,139,41,85,10,104,889,2016/2017
"Lawson,Ty",237,522,.454,34,118,.288,203,404,.502,173,217,.797,44,135,179,334,74,129,6,119,681,2016/2017
"Layman,Jake",26,89,.292,13,51,.255,13,38,.342,13,17,.765,6,18,24,11,9,11,3,22,78,2016/2017
"Lee,Courtney",321,704,.456,108,269,.401,213,435,.490,85,98,.867,53,206,259,179,81,69,24,141,835,2016/2017
"Lee,David",248,420,.590,0,0,,248,420,.590,80,113,.708,149,292,441,124,31,82,40,125,576,2016/2017
"Len,Alex",230,463,.497,3,12,.250,227,451,.503,150,208,.721,156,354,510,44,38,102,98,242,613,2016/2017
"Leonard,Kawhi",636,1312,.485,147,387,.380,489,925,.529,469,533,.880,80,350,430,260,133,154,55,122,1888,2016/2017
"Leonard,Meyers",146,378,.386,74,213,.347,72,165,.436,35,40,.875,27,210,237,71,13,35,28,172,401,2016/2017
"Leuer,Jon",310,646,.480,49,167,.293,261,479,.545,98,113,.867,102,300,402,111,31,66,26,145,767,2016/2017
"LeVert,Caris",171,380,.450,59,184,.321,112,196,.571,67,93,.720,23,165,188,110,49,59,8,91,468,2016/2017
"Liggins,DeAndre",55,142,.387,17,46,.370,38,96,.396,25,40,.625,20,88,108,54,47,42,14,81,152,2016/2017
"Liggins,DeAndre",52,136,.382,17,45,.378,35,91,.385,23,37,.622,17,84,101,54,45,42,14,78,144,2016/2017
"Liggins,DeAndre",3,6,.500,0,1,.000,3,5,.600,2,3,.667,3,4,7,0,2,0,0,3,8,2016/2017
"Lillard,Damian",661,1488,.444,214,579,.370,447,909,.492,488,545,.895,46,322,368,440,68,197,20,152,2024,2016/2017
"Lin,Jeremy",175,400,.438,58,156,.372,117,244,.480,115,141,.816,11,124,135,184,42,86,14,79,523,2016/2017
"Livingston,Shaun",173,316,.547,1,3,.333,172,313,.550,42,60,.700,28,123,151,139,38,62,20,120,389,2016/2017
"Long,Shawn",61,109,.560,7,19,.368,54,90,.600,19,35,.543,41,44,85,13,9,13,9,49,148,2016/2017
"Looney,Kevon",56,107,.523,2,9,.222,54,98,.551,21,34,.618,44,80,124,29,15,17,17,64,135,2016/2017
"Lopez,Brook",555,1172,.474,134,387,.346,421,785,.536,295,364,.810,121,282,403,176,38,184,124,192,1539,2016/2017
"Lopez,Robin",382,775,.493,0,2,.000,382,773,.494,75,104,.721,244,276,520,80,18,91,117,151,839,2016/2017
"Love,Kevin",370,867,.427,145,389,.373,225,478,.471,257,295,.871,148,518,666,116,53,122,21,125,1142,2016/2017
"Lowry,Kyle",426,918,.464,193,468,.412,233,450,.518,299,365,.819,48,238,286,417,88,173,19,170,1344,2016/2017
"Lucas III,John",1,4,.250,0,1,.000,1,3,.333,0,0,,0,0,0,1,2,0,0,0,2,2016/2017
"Luwawu-Cabarrot,Timothé",145,361,.402,50,161,.311,95,200,.475,105,123,.854,25,124,149,75,32,73,10,154,445,2016/2017
"Lyles,Trey",159,439,.362,65,204,.319,94,235,.400,57,79,.722,48,187,235,69,26,64,20,97,440,2016/2017
"Mac,Sheldon",30,75,.400,7,30,.233,23,45,.511,23,27,.852,4,30,34,15,8,5,2,17,90,2016/2017
"Mack,Shelvin",170,381,.446,37,120,.308,133,261,.510,53,77,.688,20,105,125,154,42,90,3,100,430,2016/2017
"Mahinmi,Ian",65,111,.586,0,0,,65,111,.586,43,75,.573,47,103,150,19,33,34,24,90,173,2016/2017
"Maker,Thon",83,181,.459,28,74,.378,55,107,.514,32,49,.653,40,74,114,23,10,17,26,84,226,2016/2017
"Marjanović,Boban",72,132,.545,0,0,,72,132,.545,47,58,.810,46,84,130,9,6,10,12,25,191,2016/2017
"Martin,Jarell",58,151,.384,9,25,.360,49,126,.389,40,50,.800,42,120,162,8,17,28,9,91,165,2016/2017
"Matthews,Wesley",333,847,.393,174,479,.363,159,368,.432,146,179,.816,18,241,259,210,77,102,15,161,986,2016/2017
"Mbah a Moute,Luc",191,378,.505,43,110,.391,148,268,.552,59,87,.678,44,126,170,39,81,46,35,122,484,2016/2017
"McAdoo,James Michael",62,117,.530,2,8,.250,60,109,.550,21,42,.500,34,57,91,18,18,19,29,47,147,2016/2017
"McCaw,Patrick",106,245,.433,41,123,.333,65,122,.533,29,37,.784,21,79,100,77,32,36,15,62,282,2016/2017
"McCollum,CJ",692,1441,.480,185,439,.421,507,1002,.506,268,294,.912,60,229,289,285,72,172,42,202,1837,2016/2017
"McConnell,T.J.",236,512,.461,11,55,.200,225,457,.492,73,90,.811,39,212,251,534,134,159,10,139,556,2016/2017
"McCullough,Chris",16,32,.500,1,7,.143,15,25,.600,3,5,.600,9,10,19,2,2,3,2,7,36,2016/2017
"McCullough,Chris",16,31,.516,1,6,.167,15,25,.600,2,3,.667,9,8,17,2,1,2,2,7,35,2016/2017
"McCullough,Chris",0,1,.000,0,1,.000,0,0,,1,2,.500,0,2,2,0,1,1,0,0,1,2016/2017
"McDaniels,K.J.",77,169,.456,20,66,.303,57,103,.553,32,38,.842,15,67,82,13,19,29,18,49,206,2016/2017
"McDaniels,K.J.",31,68,.456,9,27,.333,22,41,.537,9,10,.900,6,24,30,4,7,10,8,24,80,2016/2017
"McDaniels,K.J.",46,101,.455,11,39,.282,35,62,.565,23,28,.821,9,43,52,9,12,19,10,25,126,2016/2017
"McDermott,Doug",222,497,.447,77,208,.370,145,289,.502,71,84,.845,20,159,179,58,13,38,5,79,592,2016/2017
"McDermott,Doug",166,373,.445,56,150,.373,110,223,.493,59,67,.881,14,116,130,45,11,32,4,57,447,2016/2017
"McDermott,Doug",56,124,.452,21,58,.362,35,66,.530,12,17,.706,6,43,49,13,2,6,1,22,145,2016/2017
"McGee,JaVale",208,319,.652,0,3,.000,208,316,.658,56,111,.505,100,144,244,17,19,40,67,109,472,2016/2017
"McGruder,Rodney",190,460,.413,73,220,.332,117,240,.488,44,71,.620,94,162,256,124,46,56,18,140,497,2016/2017
"McLemore,Ben",180,419,.430,65,170,.382,115,249,.462,70,93,.753,19,110,129,51,29,62,6,108,495,2016/2017
"McRae,Jordan",58,150,.387,18,51,.353,40,99,.404,27,34,.794,6,35,41,19,8,14,6,31,161,2016/2017
"McRoberts,Josh",44,118,.373,13,31,.419,31,87,.356,6,9,.667,23,51,74,50,10,23,4,31,107,2016/2017
"Meeks,Jodie",103,256,.402,56,137,.409,47,119,.395,65,74,.878,5,72,77,45,34,36,4,41,327,2016/2017
"Mejri,Salah",88,137,.642,1,3,.333,87,134,.649,36,61,.590,97,211,308,14,32,40,61,152,213,2016/2017
"Mickey,Jordan",15,34,.441,0,1,.000,15,33,.455,8,14,.571,13,21,34,7,3,9,6,12,38,2016/2017
"Middleton,Khris",150,333,.450,45,104,.433,105,229,.459,81,92,.880,11,112,123,99,41,65,7,79,426,2016/2017
"Miles,C.J.",281,647,.434,169,409,.413,112,238,.471,84,93,.903,30,199,229,48,46,40,25,151,815,2016/2017
"Miller,Mike",9,23,.391,8,20,.400,1,3,.333,2,2,1.000,2,36,38,22,2,13,0,9,28,2016/2017
"Mills,Patty",273,621,.440,147,355,.414,126,266,.474,66,80,.825,24,117,141,280,65,101,3,109,759,2016/2017
"Millsap,Elijah",1,7,.143,0,2,.000,1,5,.200,1,2,.500,3,3,6,1,0,2,0,2,3,2016/2017
"Millsap,Paul",430,972,.442,75,241,.311,355,731,.486,311,405,.768,111,422,533,252,90,158,62,186,1246,2016/2017
"Mirotić,Nikola",258,625,.413,129,377,.342,129,248,.520,99,128,.773,61,323,384,75,53,80,55,128,744,2016/2017
"Monroe,Greg",387,726,.533,0,4,.000,387,722,.536,177,239,.741,167,365,532,187,92,140,38,168,951,2016/2017
"Moore,E'Twaun",283,619,.457,77,208,.370,206,411,.501,57,74,.770,33,119,152,164,50,62,32,131,700,2016/2017
"Morris,Marcus",421,1007,.418,118,357,.331,303,650,.466,145,185,.784,77,289,366,160,52,87,25,168,1105,2016/2017
"Morris,Markieff",406,889,.457,71,196,.362,335,693,.483,180,215,.837,107,386,493,126,82,129,42,254,1063,2016/2017
"Morrow,Anthony",98,252,.389,41,133,.308,57,119,.479,34,37,.919,12,19,31,25,24,6,2,44,271,2016/2017
"Morrow,Anthony",86,223,.386,35,119,.294,51,104,.490,23,26,.885,11,18,29,19,22,6,2,40,230,2016/2017
"Morrow,Anthony",12,29,.414,6,14,.429,6,15,.400,11,11,1.000,1,1,2,6,2,0,0,4,41,2016/2017
"Motiejūnas,Donatas",57,138,.413,11,47,.234,46,91,.505,25,49,.510,26,75,101,32,18,31,11,55,150,2016/2017
"Mozgov,Timofey",169,328,.515,0,1,.000,169,327,.517,63,78,.808,104,160,264,43,16,72,31,133,401,2016/2017
"Mudiay,Emmanuel",208,551,.377,56,178,.315,152,373,.408,131,167,.784,29,149,178,217,41,123,13,95,603,2016/2017
"Muhammad,Shabazz",288,598,.482,49,145,.338,239,453,.528,147,190,.774,84,136,220,35,22,56,6,86,772,2016/2017
"Murray,Dejounte",50,116,.431,9,23,.391,41,93,.441,21,30,.700,6,36,42,48,8,38,6,29,130,2016/2017
"Murray,Jamal",295,730,.404,115,344,.334,180,386,.466,106,120,.883,41,173,214,170,51,113,24,124,811,2016/2017
"Muscala,Mike",170,337,.504,46,110,.418,124,227,.546,49,64,.766,76,164,240,95,30,55,41,97,435,2016/2017
"Nance,Larry",190,361,.526,10,36,.278,180,325,.554,59,80,.738,120,249,369,96,82,56,39,149,449,2016/2017
"Napier,Shabazz",73,183,.399,34,92,.370,39,91,.429,38,49,.776,8,53,61,67,32,41,2,38,218,2016/2017
"Ndour,Maurice",39,86,.453,1,7,.143,38,79,.481,19,26,.731,22,42,64,8,15,12,8,30,98,2016/2017
"Neal,Gary",0,7,.000,0,2,.000,0,5,.000,4,4,1.000,0,1,1,1,0,0,0,1,4,2016/2017
"Nelson,Jameer",268,604,.444,106,273,.388,162,331,.489,45,63,.714,28,164,192,385,54,128,8,197,687,2016/2017
"Neto,Raul",41,91,.451,10,31,.323,31,60,.517,8,9,.889,4,26,30,34,21,15,5,48,100,2016/2017
"Niang,Georges",9,36,.250,1,12,.083,8,24,.333,2,2,1.000,2,15,17,5,3,5,0,6,21,2016/2017
"Nicholson,Andrew",43,111,.387,5,27,.185,38,84,.452,9,14,.643,15,46,61,10,16,17,6,55,100,2016/2017
"Nicholson,Andrew",30,77,.390,3,16,.188,27,61,.443,7,12,.583,11,23,34,7,11,11,6,37,70,2016/2017
"Nicholson,Andrew",13,34,.382,2,11,.182,11,23,.478,2,2,1.000,4,23,27,3,5,6,0,18,30,2016/2017
"Noah,Joakim",99,202,.490,0,1,.000,99,201,.493,34,78,.436,162,241,403,103,30,58,37,127,232,2016/2017
"Noel,Nerlens",184,309,.595,0,1,.000,184,308,.597,77,111,.694,93,201,294,50,65,51,50,126,445,2016/2017
"Noel,Nerlens",107,175,.611,0,1,.000,107,174,.615,43,63,.683,46,98,144,30,43,29,26,71,257,2016/2017
"Noel,Nerlens",77,134,.575,0,0,,77,134,.575,34,48,.708,47,103,150,20,22,22,24,55,188,2016/2017
"Nogueira,Lucas",103,156,.660,3,12,.250,100,144,.694,44,67,.657,82,162,244,42,52,46,89,137,253,2016/2017
"Novak,Steve",2,7,.286,1,6,.167,1,1,1.000,0,0,,0,3,3,0,0,0,0,1,5,2016/2017
"Nowitzki,Dirk",296,678,.437,79,209,.378,217,469,.463,98,112,.875,23,330,353,82,30,51,38,113,769,2016/2017
"Nurkić,Jusuf",271,534,.507,0,1,.000,271,533,.508,120,210,.571,154,313,467,123,50,143,74,161,662,2016/2017
"Nurkić,Jusuf",151,298,.507,0,0,,151,298,.507,56,113,.496,89,171,260,60,25,81,36,88,358,2016/2017
"Nurkić,Jusuf",120,236,.508,0,1,.000,120,235,.511,64,97,.660,65,142,207,63,25,62,38,73,304,2016/2017
"Nwaba,David",47,81,.580,1,5,.200,46,76,.605,25,39,.641,17,46,63,14,13,11,7,36,120,2016/2017
"O'Bryant,Johnny",15,30,.500,3,6,.500,12,24,.500,5,6,.833,9,10,19,6,0,6,1,10,38,2016/2017
"O'Bryant,Johnny",7,15,.467,2,3,.667,5,12,.417,4,4,1.000,5,6,11,2,0,3,1,4,20,2016/2017
"O'Bryant,Johnny",8,15,.533,1,3,.333,7,12,.583,1,2,.500,4,4,8,4,0,3,0,6,18,2016/2017
"O'Quinn,Kyle",215,413,.521,2,17,.118,213,396,.538,64,83,.771,157,282,439,117,36,76,104,174,496,2016/2017
"Ochefu,Daniel",12,27,.444,0,0,,12,27,.444,0,2,.000,5,17,22,3,2,3,0,17,24,2016/2017
"Okafor,Jahlil",242,471,.514,0,0,,242,471,.514,106,158,.671,81,159,240,58,20,91,49,122,590,2016/2017
"Oladipo,Victor",412,932,.442,127,352,.361,285,580,.491,116,154,.753,39,252,291,176,78,119,21,155,1067,2016/2017
"Olynyk,Kelly",260,508,.512,68,192,.354,192,316,.608,90,123,.732,73,288,361,148,43,96,29,207,678,2016/2017
"Onuaku,Arinze",2,4,.500,0,0,,2,4,.500,0,0,,2,4,6,2,0,2,1,3,4,2016/2017
"Onuaku,Chinanu",5,7,.714,0,0,,5,7,.714,4,4,1.000,2,8,10,3,3,4,1,6,14,2016/2017
"Oubre,Kelly",186,442,.421,54,188,.287,132,254,.520,75,99,.758,61,200,261,47,58,50,17,195,501,2016/2017
"Pachulia,Zaza",164,307,.534,0,2,.000,164,305,.538,98,126,.778,140,270,410,132,59,87,33,166,426,2016/2017
"Papagiannis,Georgios",56,102,.549,0,2,.000,56,100,.560,12,14,.857,24,62,86,20,3,24,17,44,124,2016/2017
"Parker,Jabari",399,814,.490,65,178,.365,334,636,.525,162,218,.743,79,235,314,142,50,93,22,111,1025,2016/2017
"Parker,Tony",265,569,.466,23,69,.333,242,500,.484,85,117,.726,9,104,113,285,34,89,2,92,638,2016/2017
"Parsons,Chandler",75,222,.338,25,93,.269,50,129,.388,35,43,.814,6,78,84,55,20,24,5,52,210,2016/2017
"Patterson,Lamar",3,15,.200,1,6,.167,2,9,.222,2,3,.667,1,6,7,6,1,4,0,6,9,2016/2017
"Patterson,Patrick",154,384,.401,94,253,.372,60,131,.458,43,60,.717,62,231,293,76,40,38,23,120,445,2016/2017
"Paul,Chris",374,785,.476,124,302,.411,250,483,.518,232,260,.892,40,264,304,563,119,147,8,146,1104,2016/2017
"Payne,Adreian",23,54,.426,3,15,.200,20,39,.513,14,19,.737,9,24,33,7,8,8,7,32,63,2016/2017
"Payne,Cameron",64,193,.332,27,86,.314,37,107,.346,5,8,.625,3,45,48,55,14,29,4,52,160,2016/2017
"Payne,Cameron",43,130,.331,16,52,.308,27,78,.346,4,4,1.000,2,29,31,40,10,16,4,38,106,2016/2017
"Payne,Cameron",21,63,.333,11,34,.324,10,29,.345,1,4,.250,1,16,17,15,4,13,0,14,54,2016/2017
"Payton,Elfrid",430,912,.471,40,146,.274,390,766,.509,146,211,.692,89,298,387,529,88,178,40,177,1046,2016/2017
"Payton,Gary",8,22,.364,1,9,.111,7,13,.538,3,5,.600,0,12,12,13,3,10,4,9,20,2016/2017
"Pierce,Paul",28,70,.400,15,43,.349,13,27,.481,10,13,.769,1,47,48,10,4,16,5,40,81,2016/2017
"Plumlee,Marshall",16,30,.533,0,0,,16,30,.533,8,19,.421,23,28,51,10,4,12,4,23,40,2016/2017
"Plumlee,Mason",334,623,.536,0,6,.000,334,617,.541,174,300,.580,170,435,605,284,69,134,92,226,842,2016/2017
"Plumlee,Mason",235,442,.532,0,5,.000,235,437,.538,127,224,.567,120,312,432,214,50,88,63,149,597,2016/2017
"Plumlee,Mason",99,181,.547,0,1,.000,99,180,.550,47,76,.618,50,123,173,70,19,46,29,77,245,2016/2017
"Plumlee,Miles",44,92,.478,0,0,,44,92,.478,25,39,.641,38,57,95,21,18,30,13,73,113,2016/2017
"Plumlee,Miles",30,68,.441,0,0,,30,68,.441,22,35,.629,23,30,53,18,11,22,9,48,82,2016/2017
"Plumlee,Miles",14,24,.583,0,0,,14,24,.583,3,4,.750,15,27,42,3,7,8,4,25,31,2016/2017
"Pöltl,Jakob",67,115,.583,0,0,,67,115,.583,31,57,.544,78,87,165,12,17,29,20,113,165,2016/2017
"Porter,Otto",414,803,.516,148,341,.434,266,462,.576,99,119,.832,118,396,514,121,116,44,42,193,1075,2016/2017
"Portis,Bobby",183,375,.488,32,96,.333,151,279,.541,39,59,.661,75,221,296,35,16,37,11,94,437,2016/2017
"Porziņģis,Kristaps",443,985,.450,112,314,.357,331,671,.493,198,252,.786,111,364,475,97,47,118,129,244,1196,2016/2017
"Powell,Dwight",194,377,.515,21,74,.284,173,303,.571,107,141,.759,93,213,306,49,61,34,39,135,516,2016/2017
"Powell,Norman",227,506,.449,56,173,.324,171,333,.514,126,159,.792,26,143,169,82,52,70,14,127,636,2016/2017
"Poythress,Alex",25,54,.463,6,19,.316,19,35,.543,8,10,.800,11,18,29,5,3,3,2,14,64,2016/2017
"Price,Ronnie",4,24,.167,3,17,.176,1,7,.143,3,4,.750,3,8,11,18,11,3,1,14,14,2016/2017
"Quarterman,Tim",13,29,.448,5,13,.385,8,16,.500,0,3,.000,4,10,14,11,2,11,3,6,31,2016/2017
"Randle,Chasson",40,98,.408,16,47,.340,24,51,.471,41,43,.953,6,26,32,34,9,19,2,39,137,2016/2017
"Randle,Chasson",12,26,.462,6,15,.400,6,11,.545,12,12,1.000,0,5,5,6,3,3,1,11,42,2016/2017
"Randle,Chasson",28,72,.389,10,32,.313,18,40,.450,29,31,.935,6,21,27,28,6,16,1,28,95,2016/2017
"Randle,Julius",377,773,.488,17,63,.270,360,710,.507,204,282,.723,150,486,636,264,49,173,37,248,975,2016/2017
"Randolph,Zach",433,964,.449,21,94,.223,412,870,.474,141,193,.731,182,416,598,122,38,99,10,136,1028,2016/2017
"Redick,J.J.",396,890,.445,201,468,.429,195,422,.462,180,202,.891,11,160,171,110,54,98,13,125,1173,2016/2017
"Reed,Willie",162,285,.568,1,4,.250,161,281,.573,49,88,.557,129,203,332,26,18,31,47,137,374,2016/2017
"Richardson,Josh",202,513,.394,75,227,.330,127,286,.444,60,77,.779,35,133,168,140,60,65,39,132,539,2016/2017
"Richardson,Malachi",28,68,.412,8,28,.286,20,40,.500,15,19,.789,3,20,23,11,5,8,1,23,79,2016/2017
"Rivers,Austin",323,731,.442,111,299,.371,212,432,.491,132,191,.691,20,141,161,204,48,115,10,187,889,2016/2017
"Roberson,Andre",215,463,.464,45,184,.245,170,279,.609,47,111,.423,98,305,403,79,94,51,79,204,522,2016/2017
"Roberts,Brian",46,122,.377,17,44,.386,29,78,.372,33,39,.846,5,34,39,52,9,26,1,18,142,2016/2017
"Robinson,Glenn",158,338,.467,49,125,.392,109,213,.512,54,76,.711,57,189,246,47,41,37,20,63,419,2016/2017
"Robinson,Thomas",105,196,.536,0,1,.000,105,195,.538,31,66,.470,84,139,223,31,26,46,9,76,241,2016/2017
"Rodríguez,Sergio",210,536,.392,92,252,.365,118,284,.415,18,27,.667,21,136,157,344,49,128,4,95,530,2016/2017
"Rondo,Rajon",229,561,.408,50,133,.376,179,428,.418,30,50,.600,73,282,355,461,99,169,11,144,538,2016/2017
"Rose,Derrick",460,977,.471,13,60,.217,447,917,.487,221,253,.874,66,180,246,283,44,147,17,84,1154,2016/2017
"Ross,Terrence",326,746,.437,142,391,.363,184,355,.518,64,77,.831,18,188,206,88,87,68,33,143,858,2016/2017
"Ross,Terrence",211,479,.441,96,256,.375,115,223,.516,41,50,.820,14,124,138,45,53,33,20,82,559,2016/2017
"Ross,Terrence",115,267,.431,46,135,.341,69,132,.523,23,27,.852,4,64,68,43,34,35,13,61,299,2016/2017
"Rozier,Terry",151,411,.367,57,179,.318,94,232,.405,51,66,.773,40,187,227,131,46,47,11,69,410,2016/2017
"Rubio,Ricky",261,650,.402,60,196,.306,201,454,.443,254,285,.891,68,237,305,682,128,195,10,202,836,2016/2017
"Rudež,Damjan",31,88,.352,20,64,.313,11,24,.458,0,0,,5,20,25,20,12,9,1,31,82,2016/2017
"Rush,Brandon",70,187,.374,44,114,.386,26,73,.356,13,18,.722,16,83,99,45,22,28,23,42,197,2016/2017
"Russell,D'Angelo",351,867,.405,135,384,.352,216,483,.447,147,188,.782,31,190,221,303,87,176,16,130,984,2016/2017
"Sabonis,Domantas",192,481,.399,51,159,.321,141,322,.438,44,67,.657,46,242,288,82,39,83,32,200,479,2016/2017
"Sanders,Larry",1,4,.250,0,0,,1,4,.250,2,2,1.000,3,1,4,0,1,2,1,5,4,2016/2017
"Šarić,Dario",381,927,.411,106,341,.311,275,586,.469,172,220,.782,112,401,513,182,57,183,30,162,1040,2016/2017
"Satoranský,Tomáš",61,147,.415,9,37,.243,52,110,.473,23,33,.697,25,58,83,92,26,38,6,60,154,2016/2017
"Schröder,Dennis",548,1214,.451,100,294,.340,448,920,.487,218,255,.855,42,206,248,499,74,258,16,149,1414,2016/2017
"Scola,Luis",71,151,.470,17,50,.340,54,101,.535,25,37,.676,51,88,139,37,14,34,4,63,184,2016/2017
"Scott,Mike",17,59,.288,4,27,.148,13,32,.406,7,8,.875,10,27,37,17,4,8,3,12,45,2016/2017
"Sefolosha,Thabo",174,395,.441,41,120,.342,133,275,.484,55,75,.733,54,216,270,107,96,58,31,97,444,2016/2017
"Selden,Wayne",25,58,.431,7,28,.250,18,30,.600,14,22,.636,1,15,16,13,6,12,1,18,71,2016/2017
"Selden,Wayne",5,8,.625,4,7,.571,1,1,1.000,2,4,.500,0,5,5,1,2,3,0,6,16,2016/2017
"Selden,Wayne",20,50,.400,3,21,.143,17,29,.586,12,18,.667,1,10,11,12,4,9,1,12,55,2016/2017
"Séraphin,Kevin",109,198,.551,0,2,.000,109,196,.556,14,22,.636,41,101,142,23,7,29,20,66,232,2016/2017
"Sessions,Ramon",100,263,.380,21,62,.339,79,201,.393,91,118,.771,11,62,73,129,27,46,3,43,312,2016/2017
"Shumpert,Iman",201,489,.411,94,261,.360,107,228,.469,71,90,.789,39,179,218,109,62,78,27,150,567,2016/2017
"Siakam,Pascal",103,205,.502,1,7,.143,102,198,.515,22,32,.688,64,121,185,17,26,33,45,109,229,2016/2017
"Simmons,Jonathon",177,421,.420,30,102,.294,147,319,.461,99,132,.750,20,140,160,126,47,76,25,146,483,2016/2017
"Singler,Kyle",34,83,.410,7,37,.189,27,46,.587,13,17,.765,8,40,48,9,7,11,5,29,88,2016/2017
"Smart,Marcus",269,749,.359,94,332,.283,175,417,.420,203,250,.812,78,227,305,364,125,159,34,192,835,2016/2017
"Smith,Ish",329,749,.439,28,105,.267,301,644,.467,72,102,.706,21,214,235,418,61,112,33,127,758,2016/2017
"Smith,J.R.",123,356,.346,95,271,.351,28,85,.329,10,15,.667,17,96,113,62,40,26,11,77,351,2016/2017
"Smith,Jason",174,329,.529,37,78,.474,137,251,.546,35,51,.686,64,194,258,37,21,58,54,168,420,2016/2017
"Snell,Tony",246,541,.455,144,355,.406,102,186,.548,47,58,.810,22,226,248,96,55,55,14,125,683,2016/2017
"Speights,Marreese",244,548,.445,103,277,.372,141,271,.520,120,137,.876,88,285,373,65,23,69,41,229,711,2016/2017
"Splitter,Tiago",14,31,.452,2,6,.333,12,25,.480,9,11,.818,8,14,22,4,1,6,1,8,39,2016/2017
"Stauskas,Nik",251,634,.396,132,359,.368,119,275,.433,122,150,.813,21,205,226,188,45,128,32,144,756,2016/2017
"Stephenson,Lance",54,120,.450,6,20,.300,48,100,.480,8,13,.615,4,48,52,59,5,26,3,32,122,2016/2017
"Stephenson,Lance",26,55,.473,1,10,.100,25,45,.556,5,8,.625,3,15,18,29,2,11,1,18,58,2016/2017
"Stephenson,Lance",10,21,.476,0,2,.000,10,19,.526,1,2,.500,0,10,10,5,0,4,0,2,21,2016/2017
"Stephenson,Lance",18,44,.409,5,8,.625,13,36,.361,2,3,.667,1,23,24,25,3,11,2,12,43,2016/2017
"Stokes,Jarnell",1,1,1.000,0,0,,1,1,1.000,1,2,.500,1,1,2,2,1,0,0,3,3,2016/2017
"Stone,Diamond",3,13,.231,0,0,,3,13,.231,4,4,1.000,1,5,6,0,0,2,1,5,10,2016/2017
"Stuckey,Rodney",91,244,.373,19,60,.317,72,184,.391,80,107,.748,6,78,84,84,16,53,0,44,281,2016/2017
"Sullinger,Jared",15,47,.319,3,18,.167,12,29,.414,4,8,.500,10,17,27,3,4,4,1,17,37,2016/2017
"Tavares,Edy",4,5,.800,0,0,,4,5,.800,0,3,.000,4,7,11,1,0,2,6,3,8,2016/2017
"Tavares,Edy",1,1,1.000,0,0,,1,1,1.000,0,2,.000,0,1,1,0,0,0,0,0,2,2016/2017
"Tavares,Edy",3,4,.750,0,0,,3,4,.750,0,1,.000,4,6,10,1,0,2,6,3,6,2016/2017
"Taylor,Isaiah",1,7,.143,0,2,.000,1,5,.200,1,2,.500,1,2,3,3,1,0,1,6,3,2016/2017
"Teague,Jeff",402,909,.442,90,252,.357,312,657,.475,360,415,.867,33,297,330,639,100,216,32,165,1254,2016/2017
"Teletović,Mirza",156,418,.373,104,305,.341,52,113,.460,35,45,.778,11,151,162,48,12,37,13,109,451,2016/2017
"Temple,Garrett",183,432,.424,82,220,.373,101,212,.476,58,74,.784,32,152,184,168,84,78,28,141,506,2016/2017
"Terry,Jason",105,243,.432,73,171,.427,32,72,.444,24,29,.828,15,91,106,98,46,36,20,95,307,2016/2017
"Thomas,Isaiah",682,1473,.463,245,646,.379,437,827,.528,590,649,.909,43,162,205,448,70,210,13,167,2199,2016/2017
"Thomas,Lance",97,244,.398,38,85,.447,59,159,.371,43,51,.843,32,110,142,35,21,25,5,85,275,2016/2017
"Thompson,Hollis",77,200,.385,32,95,.337,45,105,.429,19,29,.655,19,93,112,35,20,11,6,69,205,2016/2017
"Thompson,Hollis",66,159,.415,26,71,.366,40,88,.455,13,20,.650,15,69,84,26,14,9,6,55,171,2016/2017
"Thompson,Hollis",11,41,.268,6,24,.250,5,17,.294,6,9,.667,4,24,28,9,6,2,0,14,34,2016/2017
"Thompson,Klay",644,1376,.468,268,647,.414,376,729,.516,186,218,.853,49,236,285,160,66,128,40,139,1742,2016/2017
"Thompson,Tristan",262,437,.600,0,3,.000,262,434,.604,106,213,.498,286,429,715,77,39,64,84,176,630,2016/2017
"Thornton,Marcus",84,210,.400,28,80,.350,56,130,.431,23,27,.852,22,54,76,41,19,25,3,48,219,2016/2017
"Tobey,Mike",1,4,.250,0,0,,1,4,.250,0,0,,2,1,3,1,0,1,0,2,2,2016/2017
"Tolliver,Anthony",155,351,.442,90,230,.391,65,121,.537,61,82,.744,51,186,237,77,34,56,20,109,461,2016/2017
"Toupane,Axel",5,9,.556,1,4,.250,4,5,.800,0,0,,0,1,1,0,1,0,1,6,11,2016/2017
"Toupane,Axel",0,1,.000,0,1,.000,0,0,,0,0,,0,0,0,0,0,0,0,1,0,2016/2017
"Toupane,Axel",5,8,.625,1,3,.333,4,5,.800,0,0,,0,1,1,0,1,0,1,5,11,2016/2017
"Towns,Karl-Anthony",802,1480,.542,101,275,.367,701,1205,.582,356,428,.832,296,711,1007,220,56,212,103,241,2061,2016/2017
"Tucker,P.J.",199,482,.413,70,196,.357,129,286,.451,72,93,.774,117,354,471,99,116,66,19,196,540,2016/2017
"Tucker,P.J.",147,354,.415,46,136,.338,101,218,.463,61,77,.792,94,248,342,73,85,52,14,143,401,2016/2017
"Tucker,P.J.",52,128,.406,24,60,.400,28,68,.412,11,16,.688,23,106,129,26,31,14,5,53,139,2016/2017
"Turner,Evan",235,552,.426,31,118,.263,204,434,.470,85,103,.825,36,211,247,205,53,100,24,121,586,2016/2017
"Turner,Myles",444,869,.511,40,115,.348,404,754,.536,245,303,.809,139,450,589,106,74,105,172,262,1173,2016/2017
"Udrih,Beno",92,197,.467,11,32,.344,81,165,.491,32,34,.941,6,51,57,131,13,36,0,29,227,2016/2017
"Ulis,Tyler",184,437,.421,21,79,.266,163,358,.455,55,71,.775,20,75,95,226,48,77,5,73,444,2016/2017
"Uthoff,Jarrod",16,38,.421,3,9,.333,13,29,.448,5,7,.714,8,14,22,9,2,3,4,8,40,2016/2017
"Valančiūnas,Jonas",391,702,.557,1,2,.500,390,700,.557,176,217,.811,226,533,759,57,37,106,63,216,959,2016/2017
"Valentine,Denzel",102,288,.354,73,208,.351,29,80,.363,14,18,.778,11,140,151,63,30,49,7,86,291,2016/2017
"VanVleet,Fred",39,111,.351,11,29,.379,28,82,.341,18,22,.818,4,38,42,35,16,15,3,36,107,2016/2017
"Varejão,Anderson",5,14,.357,0,0,,5,14,.357,8,11,.727,12,15,27,10,3,8,3,16,18,2016/2017
"Vásquez,Greivis",2,8,.250,1,3,.333,1,5,.200,2,3,.667,0,2,2,5,1,1,1,6,7,2016/2017
"Vaughn,Rashad",57,156,.365,26,81,.321,31,75,.413,2,5,.400,4,45,49,23,19,14,10,32,142,2016/2017
"Vonleh,Noah",130,270,.481,7,20,.350,123,250,.492,60,94,.638,131,256,387,31,30,64,27,154,327,2016/2017
"Vučević,Nikola",483,1031,.468,23,75,.307,460,956,.481,107,160,.669,176,603,779,208,76,117,74,180,1096,2016/2017
"Vujačić,Sasha",42,136,.309,23,74,.311,19,62,.306,17,24,.708,12,47,59,52,13,16,2,38,124,2016/2017
"Wade,Dwyane",414,955,.434,45,145,.310,369,810,.456,223,281,.794,63,207,270,228,86,138,41,112,1096,2016/2017
"Waiters,Dion",281,663,.424,85,215,.395,196,448,.438,82,127,.646,18,135,153,200,42,103,20,95,729,2016/2017
"Walker,Kemba",643,1449,.444,240,602,.399,403,847,.476,304,359,.847,45,263,308,434,85,168,22,119,1830,2016/2017
"Wall,John",647,1435,.451,89,272,.327,558,1163,.480,422,527,.801,59,267,326,831,157,322,49,151,1805,2016/2017
"Waller-Prince,Taurean",114,285,.400,33,102,.324,81,183,.443,74,94,.787,25,132,157,55,43,61,27,96,335,2016/2017
"Warren,T.J.",403,814,.495,26,98,.265,377,716,.527,119,154,.773,125,214,339,75,76,57,39,175,951,2016/2017
"Watson,C.J.",96,248,.387,32,105,.305,64,143,.448,57,66,.864,16,73,89,114,43,47,2,84,281,2016/2017
"Weber,Briante",25,60,.417,1,10,.100,24,50,.480,11,16,.688,8,18,26,21,12,8,1,16,62,2016/2017
"Weber,Briante",5,14,.357,0,3,.000,5,11,.455,2,3,.667,0,4,4,5,3,3,1,4,12,2016/2017
"Weber,Briante",20,46,.435,1,7,.143,19,39,.487,9,13,.692,8,14,22,16,9,5,0,12,50,2016/2017
"West,David",135,252,.536,3,8,.375,132,244,.541,43,56,.768,47,156,203,151,42,78,48,105,316,2016/2017
"Westbrook,Russell",824,1941,.425,200,583,.343,624,1358,.459,710,840,.845,137,727,864,840,132,438,31,190,2558,2016/2017
"White,Okaro",33,87,.379,12,34,.353,21,53,.396,20,22,.909,25,57,82,21,10,18,10,52,98,2016/2017
"Whitehead,Isaiah",204,508,.402,44,149,.295,160,359,.446,91,113,.805,32,152,184,192,42,142,36,175,543,2016/2017
"Whiteside,Hassan",542,973,.557,0,0,,542,973,.557,225,358,.628,293,795,1088,57,57,154,161,226,1309,2016/2017
"Wiggins,Andrew",709,1570,.452,103,289,.356,606,1281,.473,412,542,.760,102,226,328,189,82,187,30,183,1933,2016/2017
"Wilcox,C.J.",8,31,.258,3,15,.200,5,16,.313,2,2,1.000,4,8,12,12,2,6,1,8,21,2016/2017
"Williams,Alan",138,267,.517,0,1,.000,138,266,.519,70,112,.625,94,198,292,23,27,37,32,125,346,2016/2017
"Williams,Deron",263,600,.438,85,234,.363,178,366,.486,90,109,.826,14,133,147,360,31,138,8,138,701,2016/2017
"Williams,Deron",195,453,.430,63,181,.348,132,272,.485,69,84,.821,13,89,102,274,25,98,2,96,522,2016/2017
"Williams,Deron",68,147,.463,22,53,.415,46,94,.489,21,25,.840,1,44,45,86,6,40,6,42,179,2016/2017
"Williams,Derrick",108,244,.443,30,97,.309,78,147,.531,58,89,.652,19,111,130,28,14,28,7,60,304,2016/2017
"Williams,Derrick",54,137,.394,9,45,.200,45,92,.489,31,50,.620,16,57,73,14,9,14,5,33,148,2016/2017
"Williams,Derrick",54,107,.505,21,52,.404,33,55,.600,27,39,.692,3,54,57,14,5,14,2,27,156,2016/2017
"Williams,Lou",428,998,.429,163,446,.365,265,552,.480,402,457,.880,26,176,202,239,80,160,20,92,1421,2016/2017
"Williams,Lou",326,734,.444,122,317,.385,204,417,.489,304,344,.884,14,118,132,183,65,120,11,67,1078,2016/2017
"Williams,Lou",102,264,.386,41,129,.318,61,135,.452,98,113,.867,12,58,70,56,15,40,9,25,343,2016/2017
"Williams,Marvin",297,704,.422,124,354,.350,173,350,.494,131,150,.873,89,411,500,106,58,60,53,134,849,2016/2017
"Williams,Reggie",8,23,.348,5,11,.455,3,12,.250,6,7,.857,2,4,6,4,3,0,0,2,27,2016/2017
"Williams,Troy",73,167,.437,18,62,.290,55,105,.524,21,32,.656,15,54,69,25,27,32,10,60,185,2016/2017
"Williams,Troy",51,123,.415,10,41,.244,41,82,.500,15,25,.600,6,39,45,19,24,26,9,42,127,2016/2017
"Williams,Troy",22,44,.500,8,21,.381,14,23,.609,6,7,.857,9,15,24,6,3,6,1,18,58,2016/2017
"Wiltjer,Kyle",4,14,.286,4,13,.308,0,1,.000,1,2,.500,4,6,10,2,3,5,1,4,13,2016/2017
"Winslow,Justise",80,225,.356,7,35,.200,73,190,.384,29,47,.617,23,71,94,66,26,33,6,52,196,2016/2017
"Withey,Jeff",55,103,.534,0,1,.000,55,102,.539,36,48,.750,52,69,121,7,16,14,32,52,146,2016/2017
"Wood,Christian",12,23,.522,0,5,.000,12,18,.667,11,15,.733,14,15,29,2,3,7,6,11,35,2016/2017
"World Peace,Metta",19,68,.279,9,38,.237,10,30,.333,10,16,.625,5,15,20,11,10,7,2,18,57,2016/2017
"Wright,Brandan",83,135,.615,0,1,.000,83,134,.619,23,35,.657,31,47,78,15,11,10,20,42,189,2016/2017
"Wright,Delon",49,116,.422,10,30,.333,39,86,.453,42,55,.764,16,32,48,57,27,25,11,31,150,2016/2017
"Young,James",25,58,.431,12,35,.343,13,23,.565,6,9,.667,6,20,26,4,10,4,2,15,68,2016/2017
"Young,Joe",26,72,.361,5,23,.217,21,49,.429,11,15,.733,1,16,17,15,4,5,0,5,68,2016/2017
"Young,Nick",272,633,.430,170,421,.404,102,212,.481,77,90,.856,25,113,138,58,37,36,14,137,791,2016/2017
"Young,Thaddeus",362,687,.527,45,118,.381,317,569,.557,45,86,.523,131,317,448,122,113,95,29,135,814,2016/2017
"Zeller,Cody",253,443,.571,0,1,.000,253,442,.572,133,196,.679,135,270,405,99,62,65,58,189,639,2016/2017
"Zeller,Tyler",78,158,.494,0,1,.000,78,157,.497,22,39,.564,43,81,124,42,7,20,21,61,178,2016/2017
"Zimmerman,Stephen",10,31,.323,0,0,,10,31,.323,3,5,.600,11,24,35,4,2,3,5,17,23,2016/2017
"Zipser,Paul",88,221,.398,33,99,.333,55,122,.451,31,40,.775,15,110,125,36,15,40,16,78,240,2016/2017
"Zubac,Ivica",126,238,.529,0,3,.000,126,235,.536,32,49,.653,41,118,159,30,14,30,33,66,284,2016/2017
"Abrines,Álex",115,291,.395,84,221,.380,31,70,.443,39,46,.848,26,88,114,28,38,25,8,124,353,2017/2018
"Acy,Quincy",130,365,.356,102,292,.349,28,73,.384,49,60,.817,40,217,257,57,33,60,29,149,411,2017/2018
"Adams,Steven",448,712,.629,0,2,.000,448,710,.631,160,286,.559,384,301,685,88,92,128,78,215,1056,2017/2018
"Adebayo,Bam",174,340,.512,0,7,.000,174,333,.523,129,179,.721,118,263,381,101,32,66,41,138,477,2017/2018
"Afflalo,Arron",65,162,.401,27,70,.386,38,92,.413,22,26,.846,4,62,66,30,4,21,9,56,179,2017/2018
"Aldrich,Cole",5,15,.333,0,0,,5,15,.333,2,6,.333,3,12,15,3,2,1,1,11,12,2017/2018
"Aldridge,LaMarcus",687,1347,.510,27,92,.293,660,1255,.526,334,399,.837,246,389,635,152,43,111,90,161,1735,2017/2018
"Allen,Jarrett",234,397,.589,5,15,.333,229,382,.599,114,147,.776,144,244,388,49,28,82,88,147,587,2017/2018
"Allen,Kadeem",6,22,.273,0,11,.000,6,11,.545,7,9,.778,4,7,11,12,3,9,2,15,19,2017/2018
"Allen,Tony",44,91,.484,4,12,.333,40,79,.506,11,21,.524,20,27,47,9,11,19,3,49,103,2017/2018
"Aminu,Al-Farouq",230,582,.395,125,339,.369,105,243,.432,59,80,.738,97,428,525,84,79,79,40,136,644,2017/2018
"Anderson,Justin",87,202,.431,34,103,.330,53,99,.535,28,38,.737,25,68,93,25,15,16,7,54,236,2017/2018
"Anderson,Kyle",231,438,.527,19,57,.333,212,381,.556,104,146,.712,84,312,396,202,115,94,60,114,585,2017/2018
"Anderson,Ryan",207,480,.431,131,339,.386,76,141,.539,72,93,.774,94,237,331,60,24,42,21,126,617,2017/2018
"Anigbogu,Ike",4,9,.444,0,0,,4,9,.444,5,6,.833,5,4,9,0,1,2,3,1,13,2017/2018
"Antetokounmpo,Giannis",742,1402,.529,43,140,.307,699,1262,.554,487,641,.760,156,597,753,361,109,223,106,231,2014,2017/2018
"Anthony,Carmelo",472,1168,.404,169,474,.357,303,694,.437,148,193,.767,67,386,453,103,47,99,49,197,1261,2017/2018
"Anunoby,OG",163,346,.471,73,197,.371,90,149,.604,39,62,.629,44,140,184,55,52,45,14,130,438,2017/2018
"Arcidiacono,Ryan",17,41,.415,9,31,.290,8,10,.800,5,6,.833,1,24,25,35,13,13,0,18,48,2017/2018
"Ariza,Trevor",268,651,.412,170,462,.368,98,189,.519,76,89,.854,33,261,294,105,98,52,13,132,782,2017/2018
"Arthur,Darrell",22,47,.468,8,23,.348,14,24,.583,2,3,.667,3,12,15,9,8,15,3,22,54,2017/2018
"Artis,Jamel",31,79,.392,8,29,.276,23,50,.460,7,12,.583,4,34,38,18,2,8,3,11,77,2017/2018
"Aşık,Ömer",9,22,.409,0,0,,9,22,.409,4,13,.308,9,38,47,3,2,9,4,20,22,2017/2018
"Aşık,Ömer",7,16,.438,0,0,,7,16,.438,4,12,.333,7,30,37,2,1,5,2,14,18,2017/2018
"Aşık,Ömer",2,6,.333,0,0,,2,6,.333,0,1,.000,2,8,10,1,1,4,2,6,4,2017/2018
"Augustin,D.J.",244,540,.452,114,272,.419,130,268,.485,164,189,.868,30,130,160,287,54,123,0,94,766,2017/2018
"Babbitt,Luke",91,215,.423,60,156,.385,31,59,.525,17,22,.773,7,89,96,31,8,19,7,54,259,2017/2018
"Babbitt,Luke",80,168,.476,49,111,.441,31,57,.544,17,22,.773,5,76,81,26,7,15,5,47,226,2017/2018
"Babbitt,Luke",11,47,.234,11,45,.244,0,2,.000,0,0,,2,13,15,5,1,4,2,7,33,2017/2018
"Bacon,Dwayne",72,192,.375,11,43,.256,61,149,.409,20,25,.800,4,120,124,38,16,23,2,46,175,2017/2018
"Baker,Ron",20,59,.339,11,33,.333,9,26,.346,20,26,.769,5,25,30,47,26,18,6,33,71,2017/2018
"Baldwin,Wade",14,21,.667,4,5,.800,10,16,.625,6,10,.600,1,7,8,5,2,4,1,12,38,2017/2018
"Ball,Lonzo",203,564,.360,90,295,.305,113,269,.420,32,71,.451,69,291,360,376,88,136,43,117,528,2017/2018
"Barea,J.J.",303,690,.439,115,313,.367,188,377,.499,80,102,.784,15,186,201,434,35,143,3,83,801,2017/2018
"Barnes,Harrison",537,1208,.445,119,333,.357,418,875,.478,259,313,.827,77,391,468,152,49,118,14,94,1452,2017/2018
"Barton,Will",465,1028,.452,156,422,.370,309,606,.510,182,226,.805,70,339,409,331,82,149,52,168,1268,2017/2018
"Batum,Nicolas",270,650,.415,92,274,.336,178,376,.473,108,130,.831,57,249,306,349,65,131,23,72,740,2017/2018
"Bayless,Jerryd",109,262,.416,54,146,.370,55,116,.474,35,44,.795,15,65,80,54,23,46,6,91,307,2017/2018
"Baynes,Aron",210,446,.471,3,21,.143,207,425,.487,59,78,.756,130,304,434,93,22,80,51,200,482,2017/2018
"Bazemore,Kent",284,676,.420,108,274,.394,176,402,.438,160,201,.796,25,223,248,228,100,157,45,147,836,2017/2018
"Beal,Bradley",683,1484,.460,199,530,.375,484,954,.507,292,369,.791,61,302,363,373,96,214,36,160,1857,2017/2018
"Beasley,Malik",73,178,.410,28,82,.341,45,96,.469,22,33,.667,14,57,71,31,15,24,7,36,196,2017/2018
"Beasley,Michael",409,807,.507,34,86,.395,375,721,.520,124,159,.780,97,317,414,123,36,143,43,145,976,2017/2018
"Belinelli,Marco",337,764,.441,149,395,.377,188,369,.509,148,163,.908,20,131,151,148,66,94,12,91,971,2017/2018
"Belinelli,Marco",199,485,.410,92,247,.372,107,238,.450,101,109,.927,14,86,100,103,46,54,3,41,591,2017/2018
"Belinelli,Marco",138,279,.495,57,148,.385,81,131,.618,47,54,.870,6,45,51,45,20,40,9,50,380,2017/2018
"Bell,Jordan",116,185,.627,0,4,.000,116,181,.641,30,44,.682,60,147,207,102,35,51,56,92,262,2017/2018
"Bembry,DeAndre'",53,128,.414,11,30,.367,42,98,.429,19,33,.576,8,64,72,49,21,47,12,38,136,2017/2018
"Bender,Dragan",187,484,.386,118,322,.366,69,162,.426,39,51,.765,40,321,361,130,22,112,53,166,531,2017/2018
"Bertāns,Dāvis",161,366,.440,94,252,.373,67,114,.588,40,49,.816,18,135,153,74,26,36,28,93,456,2017/2018
"Beverley,Patrick",48,119,.403,24,60,.400,24,59,.407,14,17,.824,16,29,45,32,19,25,5,34,134,2017/2018
"Birch,Khem",68,126,.540,0,0,,68,126,.540,42,61,.689,70,110,180,34,15,21,21,56,178,2017/2018
"Bird,Jabari",15,26,.577,3,7,.429,12,19,.632,6,13,.462,6,13,19,8,3,8,1,7,39,2017/2018
"Biyombo,Bismack",183,352,.520,0,1,.000,183,351,.521,102,157,.650,144,324,468,66,21,84,95,158,468,2017/2018
"Bjelica,Nemanja",171,371,.461,76,183,.415,95,188,.505,36,45,.800,53,221,274,86,50,52,16,141,454,2017/2018
"Black,Tarik",75,127,.591,1,11,.091,74,116,.638,29,63,.460,63,100,163,13,21,35,30,107,180,2017/2018
"Blakeney,Antonio",53,143,.371,15,52,.288,38,91,.418,30,39,.769,4,29,33,20,7,11,1,19,151,2017/2018
"Bledsoe,Eric",468,989,.473,125,360,.347,343,629,.545,252,317,.795,51,233,284,370,149,216,42,185,1313,2017/2018
"Bledsoe,Eric",16,40,.400,4,13,.308,12,27,.444,11,14,.786,3,4,7,9,4,10,2,6,47,2017/2018
"Bledsoe,Eric",452,949,.476,121,347,.349,331,602,.550,241,303,.795,48,229,277,361,145,206,40,179,1266,2017/2018
"Blue,Vander",1,5,.200,0,2,.000,1,3,.333,1,2,.500,0,1,1,3,1,3,0,2,3,2017/2018
"Bogdanović,Bogdan",344,772,.446,129,329,.392,215,443,.485,100,119,.840,31,192,223,258,72,125,16,172,917,2017/2018
"Bogdanović,Bojan",404,852,.474,155,386,.402,249,466,.534,178,205,.868,30,240,270,119,55,106,8,129,1141,2017/2018
"Bogut,Andrew",17,25,.680,0,0,,17,25,.680,2,2,1.000,26,52,78,15,4,19,13,40,36,2017/2018
"Bolomboy,Joel",3,6,.500,0,1,.000,3,5,.600,3,6,.500,6,4,10,0,2,2,0,3,9,2017/2018
"Booker,Devin",455,1054,.432,147,384,.383,308,670,.460,289,329,.878,26,218,244,253,47,194,14,168,1346,2017/2018
"Booker,Trevor",177,343,.516,8,33,.242,169,310,.545,66,93,.710,117,201,318,82,28,59,21,119,428,2017/2018
"Booker,Trevor",77,150,.513,3,12,.250,74,138,.536,24,43,.558,38,81,119,38,8,30,5,43,181,2017/2018
"Booker,Trevor",61,109,.560,2,7,.286,59,102,.578,32,39,.821,47,75,122,27,16,20,11,50,156,2017/2018
"Booker,Trevor",39,84,.464,3,14,.214,36,70,.514,10,11,.909,32,45,77,17,4,9,5,26,91,2017/2018
"Boucher,Chris",0,1,.000,0,1,.000,0,0,,0,0,,0,1,1,0,0,0,0,0,0,2017/2018
"Bradley,Avery",259,625,.414,75,203,.369,184,422,.436,63,82,.768,22,94,116,94,51,101,8,92,656,2017/2018
"Bradley,Avery",233,570,.409,74,194,.381,159,376,.423,61,80,.763,19,75,94,83,46,93,7,80,601,2017/2018
"Bradley,Avery",26,55,.473,1,9,.111,25,46,.543,2,2,1.000,3,19,22,11,5,8,1,12,55,2017/2018
"Bradley,Tony",3,11,.273,0,1,.000,3,10,.300,2,2,1.000,4,7,11,1,0,0,0,1,8,2017/2018
"Brewer,Corey",142,316,.449,31,110,.282,111,206,.539,65,90,.722,43,111,154,65,79,49,14,139,380,2017/2018
"Brewer,Corey",78,172,.453,8,43,.186,70,129,.543,34,51,.667,23,70,93,41,41,38,8,83,198,2017/2018
"Brewer,Corey",64,144,.444,23,67,.343,41,77,.532,31,39,.795,20,41,61,24,38,11,6,56,182,2017/2018
"Brogdon,Malcolm",244,503,.485,62,161,.385,182,342,.532,75,85,.882,23,133,156,152,41,66,13,128,625,2017/2018
"Brooks,Aaron",28,69,.406,11,31,.355,17,38,.447,8,11,.727,7,10,17,20,6,11,0,28,75,2017/2018
"Brooks,Dillon",340,772,.440,94,264,.356,246,508,.484,124,166,.747,49,208,257,135,73,124,17,233,898,2017/2018
"Brooks,MarShon",51,102,.500,19,32,.594,32,70,.457,20,23,.870,8,13,21,25,11,16,3,6,141,2017/2018
"Brown,Anthony",1,1,1.000,1,1,1.000,0,0,,0,0,,0,0,0,1,0,0,0,0,3,2017/2018
"Brown,Bobby",19,58,.328,11,40,.275,8,18,.444,1,2,.500,0,7,7,11,4,9,0,6,50,2017/2018
"Brown,Jaylen",373,803,.465,121,306,.395,252,497,.507,150,233,.644,66,280,346,114,70,124,26,181,1017,2017/2018
"Brown,Lorenzo",14,34,.412,2,12,.167,12,22,.545,2,2,1.000,1,14,15,13,5,3,0,7,32,2017/2018
"Brown,Markel",2,7,.286,1,5,.200,1,2,.500,0,0,,1,4,5,2,0,2,0,6,5,2017/2018
"Brown,Sterling",82,205,.400,32,91,.352,50,114,.439,21,24,.875,27,116,143,25,31,25,13,80,217,2017/2018
"Brussino,Nicolás",0,2,.000,0,2,.000,0,0,,0,0,,0,3,3,0,0,0,0,0,0,2017/2018
"Bryant,Thomas",8,21,.381,1,10,.100,7,11,.636,5,9,.556,3,14,17,6,1,2,2,6,22,2017/2018
"Bullock,Reggie",267,546,.489,125,281,.445,142,265,.536,39,49,.796,27,127,154,95,47,47,13,70,698,2017/2018
"Burke,Trey",193,384,.503,38,105,.362,155,279,.556,37,57,.649,13,58,71,170,24,43,4,43,461,2017/2018
"Burks,Alec",170,414,.411,47,142,.331,123,272,.452,107,124,.863,19,173,192,67,37,60,8,75,494,2017/2018
"Butler,Jimmy",437,921,.474,70,200,.350,367,721,.509,363,425,.854,79,235,314,288,116,108,24,78,1307,2017/2018
"Buycks,Dwight",82,198,.414,15,45,.333,67,153,.438,36,41,.878,12,29,41,59,19,39,2,39,215,2017/2018
"Caboclo,Bruno",9,31,.290,3,17,.176,6,14,.429,5,6,.833,7,15,22,4,3,4,4,8,26,2017/2018
"Caboclo,Bruno",0,2,.000,0,2,.000,0,0,,0,0,,0,1,1,1,1,0,0,1,0,2017/2018
"Caboclo,Bruno",9,29,.310,3,15,.200,6,14,.429,5,6,.833,7,14,21,3,2,4,4,7,26,2017/2018
"Calderón,José",93,185,.503,45,97,.464,48,88,.545,24,30,.800,14,70,84,117,27,41,2,81,255,2017/2018
"Caldwell-Pope,Kentavious",340,798,.426,159,415,.383,181,383,.473,153,194,.789,60,327,387,162,106,97,16,145,992,2017/2018
"Canaan,Isaiah",52,137,.380,22,66,.333,30,71,.423,46,51,.902,6,39,45,76,16,29,1,36,172,2017/2018
"Canaan,Isaiah",0,1,.000,0,0,,0,1,.000,0,0,,0,1,1,0,0,0,0,0,0,2017/2018
"Canaan,Isaiah",52,136,.382,22,66,.333,30,70,.429,46,51,.902,6,38,44,76,16,29,1,36,172,2017/2018
"Capela,Clint",441,676,.652,0,1,.000,441,675,.653,144,257,.560,241,561,802,68,58,103,137,185,1026,2017/2018
"Carroll,DeMarre",325,785,.414,145,391,.371,180,394,.457,188,246,.764,105,374,479,147,59,103,30,165,983,2017/2018
"Carter,Vince",114,283,.403,57,165,.345,57,118,.483,28,37,.757,18,130,148,69,42,36,26,96,313,2017/2018
"Carter-Williams,Michael",76,229,.332,14,59,.237,62,170,.365,73,89,.820,37,101,138,116,44,52,23,99,239,2017/2018
"Caruso,Alex",50,116,.431,13,43,.302,37,73,.507,21,30,.700,15,50,65,75,23,42,10,52,134,2017/2018
"Casspi,Omri",120,207,.580,10,22,.455,110,185,.595,50,69,.725,30,170,200,51,18,37,19,71,300,2017/2018
"Cauley-Stein,Willie",388,773,.502,3,12,.250,385,761,.506,153,247,.619,131,379,510,172,77,109,67,185,932,2017/2018
"Cavanaugh,Tyler",67,152,.441,32,89,.360,35,63,.556,17,21,.810,45,82,127,27,9,14,4,61,183,2017/2018
"Chalmers,Mario",168,443,.379,53,191,.277,115,252,.456,118,138,.855,13,144,157,197,79,117,14,179,507,2017/2018
"Chandler,Tyson",121,187,.647,0,0,,121,187,.647,58,93,.624,134,284,418,53,16,59,27,106,300,2017/2018
"Chandler,Wilson",281,631,.445,88,246,.358,193,385,.501,88,114,.772,102,296,398,159,43,92,39,156,738,2017/2018
"Chriss,Marquese",202,477,.423,56,190,.295,146,287,.509,96,158,.608,76,319,395,83,51,107,70,205,556,2017/2018
"Clark,Ian",222,495,.448,62,195,.318,160,300,.533,45,59,.763,10,117,127,110,33,57,10,120,551,2017/2018
"Clarkson,Jordan",430,954,.451,112,318,.352,318,636,.500,152,190,.800,57,160,217,221,58,127,6,107,1124,2017/2018
"Clarkson,Jordan",299,667,.448,68,210,.324,231,457,.505,105,132,.795,44,115,159,173,39,95,3,63,771,2017/2018
"Clarkson,Jordan",131,287,.456,44,108,.407,87,179,.486,47,58,.810,13,45,58,48,19,32,3,44,353,2017/2018
"Clavell,Gian",6,18,.333,6,15,.400,0,3,.000,2,2,1.000,1,6,7,3,2,2,0,8,20,2017/2018
"Cleveland,Antonius",8,21,.381,3,4,.750,5,17,.294,4,6,.667,3,11,14,2,7,7,5,23,23,2017/2018
"Cleveland,Antonius",4,14,.286,0,1,.000,4,13,.308,2,4,.500,2,8,10,2,6,2,4,11,10,2017/2018
"Cleveland,Antonius",4,7,.571,3,3,1.000,1,4,.250,2,2,1.000,1,3,4,0,1,5,1,12,13,2017/2018
"Collins,John",314,545,.576,16,47,.340,298,498,.598,133,186,.715,176,365,541,98,47,105,80,215,777,2017/2018
"Collins,Zach",115,289,.398,35,113,.310,80,176,.455,27,42,.643,45,176,221,52,17,58,31,133,292,2017/2018
"Collinsworth,Kyle",38,99,.384,4,17,.235,34,82,.415,21,40,.525,32,75,107,56,17,24,9,44,101,2017/2018
"Collison,Darren",316,638,.495,96,205,.468,220,433,.508,127,144,.882,37,141,178,368,92,86,15,122,855,2017/2018
"Collison,Nick",13,19,.684,0,0,,13,19,.684,5,13,.385,7,13,20,4,0,7,0,7,31,2017/2018
"Conley,Mike",64,168,.381,24,77,.312,40,91,.440,53,66,.803,0,27,27,49,12,18,3,24,205,2017/2018
"Connaughton,Pat",165,390,.423,74,210,.352,91,180,.506,37,44,.841,36,125,161,91,23,43,22,120,441,2017/2018
"Cook,Quinn",122,252,.484,46,104,.442,76,148,.514,22,25,.880,10,72,82,89,12,32,1,59,312,2017/2018
"Cooke,Charles",2,14,.143,1,8,.125,1,6,.167,1,2,.500,0,2,2,1,1,1,0,0,6,2017/2018
"Cooley,Jack",13,27,.481,0,0,,13,27,.481,14,19,.737,14,16,30,6,1,3,0,13,40,2017/2018
"Costello,Matt",2,4,.500,0,0,,2,4,.500,0,0,,1,8,9,2,2,1,2,7,4,2017/2018
"Cousins,DeMarcus",406,864,.470,104,294,.354,302,570,.530,294,394,.746,105,512,617,257,79,242,76,183,1210,2017/2018
"Covington,Robert",345,836,.413,203,550,.369,142,286,.497,116,136,.853,55,378,433,156,137,126,72,238,1009,2017/2018
"Crabbe,Allen",337,827,.407,201,532,.378,136,295,.461,115,135,.852,28,296,324,117,47,78,35,168,990,2017/2018
"Craig,Torrey",62,137,.453,17,58,.293,45,79,.570,22,35,.629,40,87,127,25,12,20,15,63,163,2017/2018
"Crawford,Jamal",308,742,.415,104,314,.331,204,428,.477,102,113,.903,21,78,99,185,40,95,9,85,822,2017/2018
"Crawford,Jordan",12,27,.444,8,14,.571,4,13,.308,1,1,1.000,2,2,4,13,1,5,1,7,33,2017/2018
"Crowder,Jae",271,671,.404,110,341,.323,161,330,.488,121,148,.818,59,216,275,99,64,74,21,187,773,2017/2018
"Crowder,Jae",157,376,.418,62,189,.328,95,187,.508,78,92,.848,41,132,173,58,41,42,12,124,454,2017/2018
"Crowder,Jae",114,295,.386,48,152,.316,66,143,.462,43,56,.768,18,84,102,41,23,32,9,63,319,2017/2018
"Cunningham,Dante",164,364,.451,58,168,.345,106,196,.541,31,52,.596,78,220,298,48,39,33,30,111,417,2017/2018
"Cunningham,Dante",99,225,.440,35,108,.324,64,117,.547,20,36,.556,50,143,193,26,27,16,16,75,253,2017/2018
"Cunningham,Dante",65,139,.468,23,60,.383,42,79,.532,11,16,.688,28,77,105,22,12,17,14,36,164,2017/2018
"Curry,Stephen",428,864,.495,212,501,.423,216,363,.595,278,302,.921,36,225,261,310,80,153,8,114,1346,2017/2018
"Daniels,Troy",232,575,.403,183,458,.400,49,117,.419,56,64,.875,12,115,127,48,26,56,5,137,703,2017/2018
"Davis,Anthony",780,1462,.534,55,162,.340,725,1300,.558,495,598,.828,187,645,832,174,115,162,193,159,2110,2017/2018
"Davis,Deyonta",161,265,.608,0,0,,161,265,.608,38,57,.667,75,175,250,40,15,32,39,125,360,2017/2018
"Davis,Ed",170,292,.582,0,1,.000,170,291,.584,74,111,.667,183,392,575,40,32,66,52,188,414,2017/2018
"Dedmon,Dewayne",250,477,.524,50,141,.355,200,336,.595,67,86,.779,100,389,489,90,40,86,51,162,617,2017/2018
"Dekker,Sam",128,259,.494,10,60,.167,118,199,.593,37,56,.661,44,130,174,38,24,33,9,71,303,2017/2018
"Delaney,Malcolm",109,285,.382,46,124,.371,63,161,.391,74,92,.804,9,91,100,163,35,66,6,82,338,2017/2018
"Dellavedova,Matthew",55,152,.362,29,78,.372,26,74,.351,25,27,.926,14,50,64,145,14,49,0,67,164,2017/2018
"Deng,Luol",1,2,.500,0,0,,1,2,.500,0,0,,0,0,0,1,1,1,0,0,2,2017/2018
"DeRozan,DeMar",645,1413,.456,89,287,.310,556,1126,.494,461,559,.825,59,256,315,417,85,175,22,151,1840,2017/2018
"Diallo,Cheick",102,176,.580,0,0,,102,176,.580,50,66,.758,47,164,211,19,11,28,21,82,254,2017/2018
"Dieng,Gorgui",186,388,.479,19,61,.311,167,327,.511,79,102,.775,106,254,360,71,45,59,39,147,470,2017/2018
"Dinwiddie,Spencer",324,838,.387,141,433,.326,183,405,.452,218,268,.813,40,219,259,524,68,128,23,186,1007,2017/2018
"Dorsey,Tyler",144,382,.377,72,199,.362,72,183,.393,45,63,.714,17,113,130,79,17,37,5,63,405,2017/2018
"Dotson,Damyean",72,161,.447,22,68,.324,50,93,.538,16,23,.696,9,75,84,31,12,17,2,34,182,2017/2018
"Doyle,Milton",13,47,.277,4,23,.174,9,24,.375,4,8,.500,3,15,18,10,6,2,2,13,34,2017/2018
"Dozier,PJ",1,2,.500,0,0,,1,2,.500,0,0,,0,1,1,0,0,1,0,1,2,2017/2018
"Dragić,Goran",484,1075,.450,111,300,.370,373,775,.481,217,271,.801,54,253,307,359,63,166,12,180,1296,2017/2018
"Drew,Larry",7,24,.292,3,9,.333,4,15,.267,0,0,,3,0,3,10,0,3,0,6,17,2017/2018
"Drew,Larry",1,7,.143,0,3,.000,1,4,.250,0,0,,1,0,1,2,0,1,0,2,2,2017/2018
"Drew,Larry",6,17,.353,3,6,.500,3,11,.273,0,0,,2,0,2,8,0,2,0,4,15,2017/2018
"Drummond,Andre",466,881,.529,0,11,.000,466,870,.536,239,395,.605,399,848,1247,237,114,200,127,250,1171,2017/2018
"Dudley,Jared",48,122,.393,29,80,.363,19,42,.452,27,35,.771,8,86,94,78,24,28,11,85,152,2017/2018
"Dunn,Kris",286,666,.429,43,134,.321,243,532,.457,84,114,.737,24,197,221,310,104,150,27,174,699,2017/2018
"Durant,Kevin",630,1222,.516,173,413,.419,457,809,.565,359,404,.889,31,433,464,366,50,207,119,133,1792,2017/2018
"Eddie,Jarell",0,2,.000,0,2,.000,0,0,,0,0,,0,1,1,0,1,0,0,0,0,2017/2018
"Eddie,Jarell",0,1,.000,0,1,.000,0,0,,0,0,,0,1,1,0,1,0,0,0,0,2017/2018
"Eddie,Jarell",0,1,.000,0,1,.000,0,0,,0,0,,0,0,0,0,0,0,0,0,0,2017/2018
"Ellenson,Henry",53,146,.363,20,60,.333,33,86,.384,25,29,.862,10,71,81,20,5,18,0,22,151,2017/2018
"Ellington,Wayne",285,700,.407,227,579,.392,58,121,.479,67,78,.859,23,195,218,79,53,52,8,94,864,2017/2018
"Embiid,Joel",510,1056,.483,66,214,.308,444,842,.527,359,467,.769,143,547,690,199,40,234,111,209,1445,2017/2018
"Ennis,James",182,384,.474,51,153,.333,131,231,.567,97,116,.836,73,151,224,71,47,56,18,134,512,2017/2018
"Ennis,James",108,222,.486,30,84,.357,78,138,.565,64,73,.877,53,104,157,49,32,38,12,81,310,2017/2018
"Ennis,James",74,162,.457,21,69,.304,53,93,.570,33,43,.767,20,47,67,22,15,18,6,53,202,2017/2018
"Ennis,Tyler",94,224,.420,14,56,.250,80,168,.476,22,29,.759,19,76,95,105,30,38,10,75,224,2017/2018
"Evans,Jawun",89,253,.352,15,54,.278,74,199,.372,38,49,.776,9,75,84,100,36,44,6,97,231,2017/2018
"Evans,Jeremy",1,1,1.000,0,0,,1,1,1.000,0,0,,1,0,1,0,0,1,0,1,2,2017/2018
"Evans,Tyreke",366,809,.452,114,286,.399,252,523,.482,164,209,.785,44,221,265,269,57,117,17,96,1010,2017/2018
"Exum,Dante",42,87,.483,5,18,.278,37,69,.536,25,31,.806,4,22,26,43,8,20,3,20,114,2017/2018
"Faried,Kenneth",76,148,.514,0,1,.000,76,147,.517,36,51,.706,68,85,153,18,12,23,13,51,188,2017/2018
"Favors,Derrick",395,702,.563,14,63,.222,381,639,.596,140,215,.651,198,354,552,102,54,88,82,164,944,2017/2018
"Felder,Kay",21,70,.300,4,19,.211,17,51,.333,11,12,.917,3,15,18,20,3,16,1,11,57,2017/2018
"Felder,Kay",20,66,.303,4,18,.222,16,48,.333,11,12,.917,1,13,14,20,3,15,1,11,55,2017/2018
"Felder,Kay",1,4,.250,0,1,.000,1,3,.333,0,0,,2,2,4,0,0,1,0,0,2,2017/2018
"Felício,Cristiano",127,215,.591,0,2,.000,127,213,.596,54,81,.667,83,150,233,55,16,54,11,104,308,2017/2018
"Felton,Raymond",224,552,.406,81,230,.352,143,322,.444,36,44,.818,25,131,156,203,49,76,16,91,565,2017/2018
"Ferguson,Terrance",70,169,.414,40,120,.333,30,49,.612,9,10,.900,19,28,47,19,24,11,10,83,189,2017/2018
"Ferrell,Yogi",311,730,.426,134,359,.373,177,371,.477,82,103,.796,26,223,249,201,64,78,9,153,838,2017/2018
"Finney-Smith,Dorian",46,121,.380,20,67,.299,26,54,.481,11,15,.733,22,53,75,26,10,21,4,43,123,2017/2018
"Forbes,Bryn",209,497,.421,89,228,.390,120,269,.446,48,72,.667,12,98,110,80,28,37,2,108,555,2017/2018
"Fournier,Evan",368,802,.459,127,335,.379,241,467,.516,150,173,.867,23,157,180,165,47,95,16,138,1013,2017/2018
"Fox,De'Aaron",328,797,.412,47,153,.307,281,644,.436,141,195,.723,33,171,204,320,70,173,20,163,844,2017/2018
"Frazier,Tim",68,172,.395,17,56,.304,51,116,.440,23,30,.767,18,97,115,194,47,57,7,97,176,2017/2018
"Frye,Channing",104,212,.491,39,115,.339,65,97,.670,17,19,.895,12,123,135,38,18,21,13,69,264,2017/2018
"Frye,Channing",84,169,.497,30,90,.333,54,79,.684,14,15,.933,10,100,110,28,17,17,12,54,212,2017/2018
"Frye,Channing",20,43,.465,9,25,.360,11,18,.611,3,4,.750,2,23,25,10,1,4,1,15,52,2017/2018
"Fultz,Markelle",45,111,.405,0,1,.000,45,110,.409,10,21,.476,11,32,43,53,12,17,4,22,100,2017/2018
"Gallinari,Danilo",102,256,.398,36,111,.324,66,145,.455,81,87,.931,9,92,101,41,12,26,10,30,321,2017/2018
"Galloway,Langston",126,340,.371,75,218,.344,51,122,.418,33,41,.805,13,79,92,58,35,18,5,39,360,2017/2018
"Gasol,Marc",434,1033,.420,109,320,.341,325,713,.456,281,337,.834,78,514,592,305,54,194,101,185,1258,2017/2018
"Gasol,Pau",287,627,.458,43,120,.358,244,507,.481,158,209,.756,129,490,619,238,24,108,79,121,775,2017/2018
"Gay,Rudy",253,537,.471,37,118,.314,216,419,.516,112,145,.772,76,215,291,73,46,78,38,98,655,2017/2018
"George,Paul",576,1340,.430,244,609,.401,332,731,.454,338,411,.822,72,375,447,263,161,212,39,233,1734,2017/2018
"Georges-Hunt,Marcus",21,48,.438,4,15,.267,17,33,.515,13,21,.619,7,9,16,7,6,3,0,32,59,2017/2018
"Gibson,Jonathan",14,23,.609,6,12,.500,8,11,.727,0,0,,0,3,3,4,0,3,0,5,34,2017/2018
"Gibson,Taj",425,737,.577,7,35,.200,418,702,.595,142,185,.768,194,390,584,99,62,89,59,218,999,2017/2018
"Ginóbili,Manu",201,463,.434,64,192,.333,137,271,.506,110,131,.840,19,123,142,163,43,105,16,126,576,2017/2018
"Gobert,Rudy",276,444,.622,0,0,,276,444,.622,204,299,.682,165,436,601,80,44,107,129,153,756,2017/2018
"Gordon,Aaron",375,865,.434,115,342,.336,260,523,.497,157,225,.698,87,370,457,136,59,107,45,111,1022,2017/2018
"Gordon,Eric",415,970,.428,218,608,.359,197,362,.544,195,241,.809,25,145,170,154,44,130,27,116,1243,2017/2018
"Gortat,Marcin",290,560,.518,0,0,,290,560,.518,110,163,.675,181,442,623,151,40,99,61,175,690,2017/2018
"Graham,Treveon",96,221,.434,40,97,.412,56,124,.452,41,59,.695,42,79,121,59,33,27,2,109,273,2017/2018
"Grant,Jerami",244,456,.535,32,110,.291,212,346,.613,162,240,.675,86,233,319,57,31,54,77,155,682,2017/2018
"Grant,Jerian",209,503,.416,61,187,.326,148,316,.468,140,188,.745,31,141,172,342,63,89,8,132,619,2017/2018
"Gray,Josh",11,41,.268,3,13,.231,8,28,.286,7,11,.636,2,8,10,12,8,7,2,8,32,2017/2018
"Green,Danny",217,561,.387,116,320,.363,101,241,.419,50,65,.769,41,208,249,110,63,74,80,122,600,2017/2018
"Green,Draymond",281,619,.454,77,256,.301,204,363,.562,134,173,.775,75,460,535,508,95,202,91,185,773,2017/2018
"Green,Gerald",168,413,.407,110,298,.369,58,115,.504,51,60,.850,15,118,133,25,24,31,15,87,497,2017/2018
"Green,JaMychal",223,488,.457,43,127,.339,180,361,.499,80,111,.721,147,317,464,79,32,76,25,153,569,2017/2018
"Green,Jeff",295,618,.477,53,170,.312,242,448,.540,203,234,.868,60,186,246,99,41,75,34,149,846,2017/2018
"Griffin,Blake",436,996,.438,111,322,.345,325,674,.482,259,330,.785,73,355,428,334,41,165,18,139,1242,2017/2018
"Griffin,Blake",255,578,.441,64,187,.342,191,391,.488,172,219,.785,46,216,262,179,30,99,9,78,746,2017/2018
"Griffin,Blake",181,418,.433,47,135,.348,134,283,.473,87,111,.784,27,139,166,155,11,66,9,61,496,2017/2018
"Hamilton,Daniel",5,11,.455,2,5,.400,3,6,.500,0,0,,0,5,5,8,1,2,0,2,12,2017/2018
"Hardaway,Tim",360,856,.421,130,410,.317,230,446,.516,146,179,.816,32,192,224,155,62,92,10,123,996,2017/2018
"Harden,James",651,1449,.449,265,722,.367,386,727,.531,624,727,.858,41,348,389,630,126,315,50,169,2191,2017/2018
"Harkless,Maurice",147,297,.495,49,118,.415,98,179,.547,42,59,.712,46,116,162,53,48,40,43,103,385,2017/2018
"Harrell,Montrezl",348,548,.635,1,7,.143,347,541,.641,139,222,.626,103,203,306,74,36,68,52,143,836,2017/2018
"Harris,Devin",187,454,.412,79,227,.348,108,227,.476,142,170,.835,12,115,127,152,47,76,12,158,595,2017/2018
"Harris,Devin",118,284,.415,44,125,.352,74,159,.465,93,112,.830,9,76,85,85,33,49,8,103,373,2017/2018
"Harris,Devin",69,170,.406,35,102,.343,34,68,.500,49,58,.845,3,39,42,67,14,27,4,55,222,2017/2018
"Harris,Gary",440,908,.485,156,394,.396,284,514,.553,134,162,.827,37,139,176,194,122,119,15,119,1170,2017/2018
"Harris,Joe",305,621,.491,150,358,.419,155,263,.589,86,104,.827,51,209,260,128,35,91,20,153,846,2017/2018
"Harris,Tobias",562,1221,.460,183,445,.411,379,776,.488,179,216,.829,58,379,437,192,71,105,35,164,1486,2017/2018
"Harris,Tobias",320,709,.451,113,276,.409,207,433,.478,115,136,.846,36,208,244,94,34,51,15,91,868,2017/2018
"Harris,Tobias",242,512,.473,70,169,.414,172,343,.501,64,80,.800,22,171,193,98,37,54,20,73,618,2017/2018
"Harrison,Aaron",19,69,.275,9,43,.209,10,26,.385,13,17,.765,4,20,24,11,9,3,2,27,60,2017/2018
"Harrison,Andrew",181,429,.422,47,142,.331,134,287,.467,124,159,.780,23,108,131,177,38,81,26,138,533,2017/2018
"Harrison,Shaquille",59,124,.476,6,26,.231,53,98,.541,28,38,.737,9,52,61,55,26,22,7,42,152,2017/2018
"Hart,Josh",176,375,.469,78,197,.396,98,178,.551,66,94,.702,42,221,263,80,47,47,16,107,496,2017/2018
"Haslem,Udonis",3,15,.200,1,8,.125,2,7,.286,1,2,.500,3,7,10,5,0,2,2,3,8,2017/2018
"Hayes,Nigel",11,33,.333,4,16,.250,7,17,.412,1,3,.333,4,18,22,6,2,2,3,8,27,2017/2018
"Hayes,Nigel",1,3,.333,0,2,.000,1,1,1.000,1,1,1.000,0,0,0,2,0,0,0,0,3,2017/2018
"Hayes,Nigel",2,2,1.000,2,2,1.000,0,0,,0,0,,0,0,0,0,0,1,0,0,6,2017/2018
"Hayes,Nigel",8,28,.286,2,12,.167,6,16,.375,0,2,.000,4,18,22,4,2,1,3,8,18,2017/2018
"Hayward,Gordon",1,2,.500,0,1,.000,1,1,1.000,0,0,,0,1,1,0,0,0,0,1,2,2017/2018
"Hearn,Reggie",1,2,.500,1,2,.500,0,0,,0,0,,0,0,0,0,0,0,0,0,3,2017/2018
"Henry,Myke",41,109,.376,19,58,.328,22,51,.431,6,10,.600,10,28,38,22,31,19,6,28,107,2017/2018
"Henson,John",287,502,.572,1,7,.143,286,495,.578,90,158,.570,150,363,513,114,45,84,109,202,665,2017/2018
"Hernangómez,Juan",29,75,.387,14,50,.280,15,25,.600,10,12,.833,18,36,54,12,6,9,3,25,82,2017/2018
"Hernangómez,Willy",91,164,.555,5,12,.417,86,152,.566,59,90,.656,61,122,183,33,18,35,16,64,246,2017/2018
"Hernangómez,Willy",49,81,.605,1,5,.200,48,76,.632,12,28,.429,22,45,67,21,8,26,7,32,111,2017/2018
"Hernangómez,Willy",42,83,.506,4,7,.571,38,76,.500,47,62,.758,39,77,116,12,10,9,9,32,135,2017/2018
"Hezonja,Mario",273,617,.442,90,267,.337,183,350,.523,86,105,.819,41,240,281,106,81,86,31,134,722,2017/2018
"Hicks,Isaiah",33,72,.458,2,9,.222,31,63,.492,12,18,.667,10,31,41,16,2,16,4,45,80,2017/2018
"Hield,Buddy",416,933,.446,176,408,.431,240,525,.457,71,81,.877,55,252,307,155,85,124,22,148,1079,2017/2018
"Hilário,Nenê",136,239,.569,0,2,.000,136,237,.574,68,107,.636,54,122,176,45,28,38,14,123,340,2017/2018
"Hill,George",236,513,.460,85,205,.415,151,308,.490,110,140,.786,42,139,181,186,61,88,27,128,667,2017/2018
"Hill,George",153,326,.469,58,128,.453,95,198,.480,77,99,.778,22,95,117,119,39,60,12,75,441,2017/2018
"Hill,George",83,187,.444,27,77,.351,56,110,.509,33,41,.805,20,44,64,67,22,28,15,53,226,2017/2018
"Hill,Solomon",11,41,.268,4,21,.190,7,20,.350,3,6,.500,9,27,36,22,7,9,1,22,29,2017/2018
"Hilliard,Darrun",5,19,.263,0,6,.000,5,13,.385,6,7,.857,0,7,7,11,2,4,0,7,16,2017/2018
"Holiday,Jrue",615,1244,.494,120,356,.337,495,888,.557,187,238,.786,62,303,365,486,123,213,64,201,1537,2017/2018
"Holiday,Justin",290,782,.371,161,449,.359,129,333,.387,135,164,.823,31,260,291,153,80,93,31,134,876,2017/2018
"Holland,John",17,59,.288,11,36,.306,6,23,.261,9,13,.692,6,18,24,5,7,8,2,10,54,2017/2018
"Hollis-Jefferson,Rondae",342,724,.472,13,54,.241,329,670,.491,249,316,.788,101,358,459,167,65,121,48,145,946,2017/2018
"Holmes,Richaun",135,241,.560,4,31,.129,131,210,.624,37,56,.661,57,154,211,61,20,25,29,97,311,2017/2018
"Hood,Rodney",322,751,.429,127,333,.381,195,418,.467,111,129,.860,22,143,165,95,45,70,12,105,882,2017/2018
"Hood,Rodney",234,552,.424,102,262,.389,132,290,.455,85,97,.876,14,97,111,65,30,63,7,64,655,2017/2018
"Hood,Rodney",88,199,.442,25,71,.352,63,128,.492,26,32,.813,8,46,54,30,15,7,5,41,227,2017/2018
"Hopson,Scotty",0,1,.000,0,0,,0,1,.000,1,2,.500,0,0,0,1,0,1,0,0,1,2017/2018
"Horford,Al",368,753,.489,97,226,.429,271,527,.514,94,120,.783,103,427,530,339,43,132,78,138,927,2017/2018
"House,Danuel",56,129,.434,15,58,.259,41,71,.577,25,31,.806,13,63,76,25,7,11,6,23,152,2017/2018
"Howard,Dwight",506,911,.555,1,7,.143,505,904,.559,334,582,.574,255,757,1012,105,48,208,131,249,1347,2017/2018
"Huestis,Josh",60,182,.330,33,115,.287,27,67,.403,6,20,.300,42,119,161,20,15,26,43,82,159,2017/2018
"Hunter,R.J.",7,20,.350,3,14,.214,4,6,.667,2,2,1.000,0,5,5,3,3,2,0,7,19,2017/2018
"Hunter,Vince",3,5,.600,0,0,,3,5,.600,0,0,,2,1,3,0,0,1,1,0,6,2017/2018
"Ibaka,Serge",379,784,.483,107,297,.360,272,487,.559,94,118,.797,78,400,478,62,29,90,99,209,959,2017/2018
"Iguodala,Andre",148,320,.463,33,117,.282,115,203,.567,55,87,.632,50,196,246,210,54,67,38,99,384,2017/2018
"İlyasova,Ersan",277,613,.452,91,253,.360,186,360,.517,105,135,.778,118,287,405,90,61,72,26,157,750,2017/2018
"İlyasova,Ersan",184,401,.459,61,170,.359,123,231,.532,72,90,.800,74,177,251,51,44,43,17,92,501,2017/2018
"İlyasova,Ersan",93,212,.439,30,83,.361,63,129,.488,33,45,.733,44,110,154,39,17,29,9,65,249,2017/2018
"Ingles,Joe",335,718,.467,204,464,.440,131,254,.516,66,83,.795,24,320,344,392,90,159,20,178,940,2017/2018
"Ingram,Andre",8,17,.471,5,9,.556,3,8,.375,3,3,1.000,1,5,6,7,3,3,3,3,24,2017/2018
"Ingram,Brandon",358,761,.470,41,105,.390,317,656,.483,192,282,.681,57,257,314,230,45,149,43,163,949,2017/2018
"Irving,Kyrie",534,1087,.491,166,407,.408,368,680,.541,232,261,.889,33,194,227,306,65,140,17,122,1466,2017/2018
"Isaac,Jonathan",55,145,.379,16,46,.348,39,99,.394,19,25,.760,16,83,99,18,33,27,30,48,145,2017/2018
"Iwundu,Wesley",93,218,.427,9,46,.196,84,172,.488,34,47,.723,36,101,137,57,33,30,12,81,229,2017/2018
"Jack,Jarrett",189,443,.427,25,86,.291,164,357,.459,63,75,.840,22,169,191,348,35,115,4,98,466,2017/2018
"Jackson,Aaron",3,9,.333,1,4,.250,2,5,.400,1,2,.500,2,1,3,1,0,1,0,4,8,2017/2018
"Jackson,Demetrius",7,18,.389,1,7,.143,6,11,.545,1,2,.500,5,7,12,9,5,10,1,7,16,2017/2018
"Jackson,Demetrius",4,14,.286,0,6,.000,4,8,.500,0,0,,4,7,11,5,4,9,1,6,8,2017/2018
"Jackson,Demetrius",3,4,.750,1,1,1.000,2,3,.667,1,2,.500,1,0,1,4,1,1,0,1,8,2017/2018
"Jackson,Josh",389,932,.417,57,217,.263,332,715,.464,177,279,.634,95,256,351,119,80,146,35,218,1012,2017/2018
"Jackson,Justin",185,419,.442,57,185,.308,128,234,.547,26,36,.722,27,160,187,74,28,40,13,81,453,2017/2018
"Jackson,Reggie",246,577,.426,52,169,.308,194,408,.475,112,134,.836,29,96,125,238,27,99,4,87,656,2017/2018
"James,LeBron",857,1580,.542,149,406,.367,708,1174,.603,388,531,.731,97,612,709,747,116,347,71,136,2251,2017/2018
"James,Mike",123,321,.383,26,98,.265,97,223,.435,64,84,.762,13,77,90,126,28,49,7,48,336,2017/2018
"James,Mike",121,312,.388,26,97,.268,95,215,.442,64,84,.762,12,77,89,120,27,48,7,45,332,2017/2018
"James,Mike",2,9,.222,0,1,.000,2,8,.250,0,0,,1,0,1,6,1,1,0,3,4,2017/2018
"Jefferson,Al",111,208,.534,0,3,.000,111,205,.541,30,36,.833,30,113,143,30,16,21,23,66,252,2017/2018
"Jefferson,Richard",12,27,.444,2,7,.286,10,20,.500,4,7,.571,2,15,17,15,2,5,1,11,30,2017/2018
"Jennings,Brandon",27,72,.375,9,33,.273,18,39,.462,10,10,1.000,5,26,31,44,6,18,4,11,73,2017/2018
"Jerebko,Jonas",159,341,.466,65,157,.414,94,184,.511,46,57,.807,53,193,246,42,24,27,12,127,429,2017/2018
"Johnson,Amir",140,260,.538,10,32,.313,130,228,.570,52,85,.612,123,207,330,118,45,55,44,192,342,2017/2018
"Johnson,Brice",20,42,.476,0,1,.000,20,41,.488,3,5,.600,9,22,31,2,9,5,6,13,43,2017/2018
"Johnson,Brice",7,11,.636,0,1,.000,7,10,.700,2,2,1.000,2,11,13,1,6,4,2,7,16,2017/2018
"Johnson,Brice",13,31,.419,0,0,,13,31,.419,1,3,.333,7,11,18,1,3,1,4,6,27,2017/2018
"Johnson,Dakari",22,39,.564,0,0,,22,39,.564,11,20,.550,16,18,34,8,6,3,8,27,55,2017/2018
"Johnson,James",309,614,.503,57,185,.308,252,429,.587,113,162,.698,61,297,358,280,70,141,51,192,788,2017/2018
"Johnson,Joe",146,360,.406,40,145,.276,106,215,.493,40,45,.889,14,158,172,83,18,49,7,67,372,2017/2018
"Johnson,Joe",95,226,.420,23,84,.274,72,142,.507,20,24,.833,12,95,107,45,12,31,6,32,233,2017/2018
"Johnson,Joe",51,134,.381,17,61,.279,34,73,.466,20,21,.952,2,63,65,38,6,18,1,35,139,2017/2018
"Johnson,Omari",9,21,.429,4,12,.333,5,9,.556,0,0,,4,7,11,7,2,3,0,6,22,2017/2018
"Johnson,Stanley",210,560,.375,67,234,.286,143,326,.439,112,145,.772,33,219,252,112,95,77,14,169,599,2017/2018
"Johnson,Tyler",309,711,.435,119,324,.367,190,387,.491,106,129,.822,34,214,248,165,60,81,34,148,843,2017/2018
"Johnson,Wesley",150,368,.408,60,177,.339,90,191,.471,43,58,.741,29,187,216,61,76,55,62,146,403,2017/2018
"Jokić,Nikola",504,1010,.499,111,280,.396,393,730,.538,266,313,.850,195,608,803,458,90,210,61,212,1385,2017/2018
"Jones,Damian",11,22,.500,0,0,,11,22,.500,3,5,.600,5,9,14,2,1,4,3,14,25,2017/2018
"Jones,Derrick",21,53,.396,3,18,.167,18,35,.514,16,24,.667,21,17,38,9,4,7,13,24,61,2017/2018
"Jones,Derrick",2,4,.500,0,2,.000,2,2,1.000,5,6,.833,2,2,4,3,1,1,4,2,9,2017/2018
"Jones,Derrick",19,49,.388,3,16,.188,16,33,.485,11,18,.611,19,15,34,6,3,6,9,22,52,2017/2018
"Jones,Jalen",26,68,.382,10,26,.385,16,42,.381,12,19,.632,13,25,38,4,5,7,1,22,74,2017/2018
"Jones,Jalen",1,4,.250,1,1,1.000,0,3,.000,2,2,1.000,0,3,3,0,0,0,0,2,5,2017/2018
"Jones,Jalen",25,64,.391,9,25,.360,16,39,.410,10,17,.588,13,22,35,4,5,7,1,20,69,2017/2018
"Jones,Tyus",150,328,.457,45,129,.349,105,199,.528,71,81,.877,16,116,132,232,95,59,6,110,416,2017/2018
"Jordan,DeAndre",373,578,.645,0,0,,373,578,.645,181,312,.580,329,842,1171,117,39,137,71,203,927,2017/2018
"Joseph,Cory",256,604,.424,67,190,.353,189,414,.457,70,94,.745,39,224,263,260,80,87,18,141,649,2017/2018
"Kaminsky,Frank",307,716,.429,104,274,.380,203,442,.459,155,194,.799,46,242,288,129,36,66,19,95,873,2017/2018
"Kanter,Enes",422,713,.592,0,2,.000,422,711,.594,156,184,.848,273,507,780,105,36,122,37,187,1000,2017/2018
"Kennard,Luke",206,465,.443,81,195,.415,125,270,.463,65,76,.855,21,155,176,124,44,69,13,86,558,2017/2018
"Kidd-Gilchrist,Michael",282,560,.504,0,2,.000,282,558,.505,117,171,.684,84,218,302,71,51,53,32,143,681,2017/2018
"Kilpatrick,Sean",110,294,.374,46,144,.319,64,150,.427,64,72,.889,5,82,87,46,13,38,5,33,330,2017/2018
"Kilpatrick,Sean",25,87,.287,11,43,.256,14,44,.318,18,19,.947,1,34,35,15,2,16,1,8,79,2017/2018
"Kilpatrick,Sean",31,82,.378,13,46,.283,18,36,.500,18,19,.947,1,24,25,15,5,9,1,15,93,2017/2018
"Kilpatrick,Sean",7,18,.389,3,7,.429,4,11,.364,2,2,1.000,0,2,2,3,0,1,0,2,19,2017/2018
"Kilpatrick,Sean",47,107,.439,19,48,.396,28,59,.475,26,32,.813,3,22,25,13,6,12,3,8,139,2017/2018
"Kleber,Maxi",151,309,.489,40,128,.313,111,181,.613,44,59,.746,71,163,234,51,26,30,47,114,386,2017/2018
"Korkmaz,Furkan",8,28,.286,5,17,.294,3,11,.273,2,4,.500,2,9,11,4,2,2,1,12,23,2017/2018
"Kornet,Luke",49,125,.392,28,79,.354,21,46,.457,8,11,.727,11,53,64,26,6,12,16,28,134,2017/2018
"Korver,Kyle",222,484,.459,164,376,.436,58,108,.537,64,72,.889,9,156,165,88,31,55,27,130,672,2017/2018
"Koufos,Kosta",222,389,.571,0,0,,222,389,.571,33,74,.446,149,323,472,87,47,49,32,146,477,2017/2018
"Kuzma,Kyle",468,1039,.450,159,434,.366,309,605,.511,147,208,.707,88,395,483,141,49,140,34,160,1242,2017/2018
"Kuzminskas,Mindaugas",0,2,.000,0,0,,0,2,.000,0,0,,0,0,0,0,0,0,0,0,0,2017/2018
"Labissière,Skal",205,458,.448,18,51,.353,187,407,.459,95,118,.805,99,189,288,72,25,73,49,132,523,2017/2018
"Lamb,Jeremy",380,832,.457,94,254,.370,286,578,.495,179,208,.861,49,275,324,186,61,93,32,138,1033,2017/2018
"Larkin,Shane",84,219,.384,31,86,.360,53,133,.398,32,37,.865,15,77,92,98,29,33,2,58,231,2017/2018
"Lauvergne,Joffrey",98,190,.516,0,5,.000,98,185,.530,30,47,.638,63,108,171,41,9,33,3,45,226,2017/2018
"LaVine,Zach",136,355,.383,42,123,.341,94,232,.405,87,107,.813,9,85,94,72,24,43,4,55,401,2017/2018
"Layman,Jake",14,47,.298,4,20,.200,10,27,.370,2,3,.667,4,12,16,11,6,5,4,13,34,2017/2018
"Leaf,T.J.",64,136,.471,18,42,.429,46,94,.489,10,16,.625,29,53,82,9,5,10,4,45,156,2017/2018
"Lee,Courtney",343,755,.454,113,278,.406,230,477,.482,114,124,.919,30,194,224,180,80,84,17,109,913,2017/2018
"Lee,Damion",62,152,.408,15,60,.250,47,92,.511,22,29,.759,11,60,71,29,19,14,1,25,161,2017/2018
"Lemon,Walt",7,16,.438,1,1,1.000,6,15,.400,2,3,.667,0,2,2,5,0,4,1,5,17,2017/2018
"Len,Alex",214,378,.566,1,3,.333,213,375,.568,158,231,.684,175,343,518,82,27,78,61,158,587,2017/2018
"Leonard,Kawhi",52,111,.468,11,35,.314,41,76,.539,31,38,.816,6,36,42,21,18,16,9,9,146,2017/2018
"Leonard,Meyers",46,78,.590,11,26,.423,35,52,.673,9,11,.818,12,58,70,17,7,10,0,36,112,2017/2018
"Leuer,Jon",15,36,.417,0,3,.000,15,33,.455,13,15,.867,7,25,32,5,1,7,3,16,43,2017/2018
"LeVert,Caris",320,735,.435,85,245,.347,235,490,.480,133,187,.711,53,207,260,299,82,153,22,159,858,2017/2018
"Liggins,DeAndre",40,106,.377,19,53,.358,21,53,.396,2,5,.400,7,68,75,48,37,20,14,81,101,2017/2018
"Liggins,DeAndre",22,65,.338,11,36,.306,11,29,.379,2,5,.400,5,44,49,27,27,13,10,61,57,2017/2018
"Liggins,DeAndre",18,41,.439,8,17,.471,10,24,.417,0,0,,2,24,26,21,10,7,4,20,44,2017/2018
"Lillard,Damian",621,1415,.439,227,629,.361,394,786,.501,493,538,.916,62,263,325,481,77,206,27,117,1962,2017/2018
"Lin,Jeremy",5,12,.417,1,2,.500,4,10,.400,7,7,1.000,0,0,0,4,0,3,0,3,18,2017/2018
"Livingston,Shaun",172,343,.501,0,5,.000,172,338,.509,50,61,.820,32,99,131,140,35,58,21,117,394,2017/2018
"Looney,Kevon",112,193,.580,1,5,.200,111,188,.590,42,77,.545,83,132,215,42,34,31,56,106,267,2017/2018
"Lopez,Brook",369,793,.465,112,325,.345,257,468,.549,111,158,.703,74,220,294,126,30,98,98,195,961,2017/2018
"Lopez,Robin",342,645,.530,4,14,.286,338,631,.536,68,90,.756,134,156,290,124,14,107,53,109,756,2017/2018
"Love,Kevin",334,729,.458,137,330,.415,197,399,.494,234,266,.880,101,445,546,103,43,90,24,120,1039,2017/2018
"Lowry,Kyle",403,944,.427,238,596,.399,165,348,.474,223,261,.854,66,368,434,537,85,183,19,192,1267,2017/2018
"Luwawu-Cabarrot,Timothé",100,267,.375,53,158,.335,47,109,.431,46,58,.793,14,58,72,54,12,38,5,97,299,2017/2018
"Lydon,Tyler",0,0,,0,0,,0,0,,0,0,,0,0,0,0,0,0,0,0,0,2017/2018
"Lyles,Trey",270,550,.491,83,218,.381,187,332,.563,101,143,.706,55,292,347,91,30,61,34,111,724,2017/2018
"Mack,Shelvin",178,414,.430,48,139,.345,130,275,.473,69,97,.711,23,143,166,272,54,89,8,91,473,2017/2018
"Magette,Josh",15,46,.326,8,22,.364,7,24,.292,8,8,1.000,2,17,19,57,8,9,1,16,46,2017/2018
"Mahinmi,Ian",138,248,.556,0,2,.000,138,246,.561,90,128,.703,135,177,312,53,38,100,42,230,366,2017/2018
"Maker,Thon",130,316,.411,31,104,.298,99,212,.467,65,93,.699,75,150,225,46,38,44,53,162,356,2017/2018
"Marjanović,Boban",79,148,.534,0,0,,79,148,.534,77,97,.794,48,96,144,22,10,36,11,51,235,2017/2018
"Marjanović,Boban",41,79,.519,0,0,,41,79,.519,36,45,.800,15,42,57,14,4,22,6,28,118,2017/2018
"Marjanović,Boban",38,69,.551,0,0,,38,69,.551,41,52,.788,33,54,87,8,6,14,5,23,117,2017/2018
"Markkanen,Lauri",374,862,.434,145,401,.362,229,461,.497,140,166,.843,79,429,508,79,39,83,40,103,1033,2017/2018
"Martin,Jarell",221,496,.446,34,98,.347,187,398,.470,89,116,.767,97,221,318,73,39,86,49,211,565,2017/2018
"Mason,Frank",144,380,.379,31,86,.360,113,294,.384,94,115,.817,30,100,130,147,34,65,10,72,413,2017/2018
"Mathiang,Mangok",4,7,.571,0,0,,4,7,.571,0,1,.000,3,7,10,0,1,0,0,5,8,2017/2018
"Matthews,Wesley",283,697,.406,153,402,.381,130,295,.441,83,101,.822,28,170,198,172,76,83,16,140,802,2017/2018
"Mbah a Moute,Luc",166,345,.481,63,173,.364,103,172,.599,65,95,.684,22,164,186,55,72,68,25,100,460,2017/2018
"McAdoo,James Michael",2,7,.286,2,7,.286,0,0,,2,2,1.000,0,2,2,0,0,1,1,1,8,2017/2018
"McCaw,Patrick",92,225,.409,19,80,.238,73,145,.503,26,34,.765,16,66,82,81,43,41,10,67,229,2017/2018
"McCollum,CJ",667,1505,.443,189,476,.397,478,1029,.465,209,250,.836,53,268,321,272,77,151,35,168,1732,2017/2018
"McConnell,T.J.",210,421,.499,27,62,.435,183,359,.510,31,39,.795,37,189,226,303,92,112,13,122,478,2017/2018
"McCree,Erik",0,2,.000,0,1,.000,0,1,.000,0,0,,0,1,1,0,1,1,0,0,0,2017/2018
"McCullough,Chris",18,42,.429,1,8,.125,17,34,.500,9,14,.643,7,18,25,4,0,2,5,8,46,2017/2018
"McDermott,Doug",237,508,.467,92,216,.426,145,292,.497,64,81,.790,40,160,200,79,19,56,16,122,630,2017/2018
"McDermott,Doug",151,328,.460,53,137,.387,98,191,.513,40,53,.755,33,101,134,50,10,34,12,73,395,2017/2018
"McDermott,Doug",86,180,.478,39,79,.494,47,101,.465,24,28,.857,7,59,66,29,9,22,4,49,235,2017/2018
"McGee,JaVale",136,219,.621,0,6,.000,136,213,.638,38,52,.731,59,110,169,33,21,27,57,91,310,2017/2018
"McGruder,Rodney",36,73,.493,15,35,.429,21,38,.553,4,8,.500,11,21,32,17,8,4,3,21,91,2017/2018
"McKinney-Jones,Trey",0,0,,0,0,,0,0,,0,0,,0,0,0,0,0,0,0,0,0,2017/2018
"McKinnie,Alfonzo",8,15,.533,3,9,.333,5,6,.833,2,3,.667,1,6,7,1,1,3,1,8,21,2017/2018
"McLemore,Ben",157,373,.421,55,159,.346,102,214,.477,53,64,.828,34,105,139,51,38,61,15,139,422,2017/2018
"McRoberts,Josh",0,1,.000,0,1,.000,0,0,,0,0,,0,0,0,0,0,0,0,2,0,2017/2018
"Meeks,Jodie",157,393,.399,72,210,.343,85,183,.464,101,117,.863,15,111,126,70,29,37,4,55,487,2017/2018
"Mejri,Salah",88,137,.642,0,3,.000,88,134,.657,38,66,.576,85,161,246,35,22,39,67,121,214,2017/2018
"Mickey,Jordan",39,82,.476,2,16,.125,37,66,.561,13,19,.684,18,63,81,9,6,18,10,36,93,2017/2018
"Middleton,Khris",593,1272,.466,146,407,.359,447,865,.517,320,362,.884,45,384,429,328,119,191,21,270,1652,2017/2018
"Miles,C.J.",227,599,.379,164,454,.361,63,145,.434,81,97,.835,18,134,152,55,37,39,21,134,699,2017/2018
"Miller,Darius",216,487,.444,147,358,.411,69,129,.535,58,67,.866,18,146,164,111,28,58,17,160,637,2017/2018
"Miller,Malcolm",13,28,.464,8,21,.381,5,7,.714,4,4,1.000,4,11,15,3,1,5,2,10,38,2017/2018
"Mills,Patty",280,682,.411,154,414,.372,126,268,.470,105,118,.890,26,128,154,229,55,106,11,128,819,2017/2018
"Millsap,Paul",202,435,.464,39,113,.345,163,322,.506,112,161,.696,65,180,245,105,39,73,44,99,555,2017/2018
"Mirotić,Nikola",306,684,.447,135,358,.377,171,326,.525,112,137,.818,59,346,405,80,44,62,39,108,859,2017/2018
"Mirotić,Nikola",143,302,.474,69,161,.429,74,141,.525,65,79,.823,18,141,159,39,15,31,13,45,420,2017/2018
"Mirotić,Nikola",163,382,.427,66,197,.335,97,185,.524,47,58,.810,41,205,246,41,29,31,26,63,439,2017/2018
"Mitchell,Donovan",595,1362,.437,187,550,.340,408,812,.502,239,297,.805,52,244,296,291,118,215,27,213,1616,2017/2018
"Mitrou-Long,Naz",1,1,1.000,1,1,1.000,0,0,,0,0,,0,0,0,0,0,0,0,0,3,2017/2018
"Monk,Malik",153,425,.360,83,243,.342,70,182,.385,32,38,.842,8,58,66,91,20,49,9,60,421,2017/2018
"Monroe,Greg",218,386,.565,0,0,,218,386,.565,88,119,.739,109,241,350,114,44,94,23,95,524,2017/2018
"Monroe,Greg",16,33,.485,0,0,,16,33,.485,2,4,.500,6,19,25,5,0,6,0,7,34,2017/2018
"Monroe,Greg",97,155,.626,0,0,,97,155,.626,31,46,.674,50,110,160,50,16,40,6,40,225,2017/2018
"Monroe,Greg",105,198,.530,0,0,,105,198,.530,55,69,.797,53,112,165,59,28,48,17,48,265,2017/2018
"Montero,Luis",0,1,.000,0,0,,0,1,.000,0,0,,0,2,2,0,0,2,0,0,0,2017/2018
"Moore,Ben",0,0,,0,0,,0,0,,0,0,,0,1,1,1,0,0,0,4,0,2017/2018
"Moore,E'Twaun",423,832,.508,128,301,.425,295,531,.556,48,68,.706,57,181,238,187,79,102,12,182,1022,2017/2018
"Moreland,Eric",66,122,.541,0,0,,66,122,.541,11,29,.379,81,197,278,78,31,42,51,116,143,2017/2018
"Morris,Jaylen",13,32,.406,2,10,.200,11,22,.500,0,0,,2,14,16,7,2,6,1,2,28,2017/2018
"Morris,Marcus",262,611,.429,86,234,.368,176,377,.467,124,154,.805,43,246,289,72,35,65,12,100,734,2017/2018
"Morris,Markieff",330,687,.480,76,207,.367,254,480,.529,105,128,.820,75,334,409,142,56,127,38,216,841,2017/2018
"Morris,Monte",4,6,.667,0,1,.000,4,5,.800,2,2,1.000,0,2,2,7,3,1,0,1,10,2017/2018
"Motley,Johnathan",40,75,.533,1,6,.167,39,69,.565,15,28,.536,14,35,49,7,3,9,2,18,96,2017/2018
"Mozgov,Timofey",52,93,.559,4,18,.222,48,75,.640,23,30,.767,32,66,98,11,5,33,13,39,131,2017/2018
"Mudiay,Emmanuel",204,526,.388,47,148,.318,157,378,.415,98,129,.760,26,126,152,206,41,113,11,80,553,2017/2018
"Mudiay,Emmanuel",129,322,.401,38,102,.373,91,220,.414,63,78,.808,16,78,94,121,21,72,4,47,359,2017/2018
"Mudiay,Emmanuel",75,204,.368,9,46,.196,66,158,.418,35,51,.686,10,48,58,85,20,41,7,33,194,2017/2018
"Muhammad,Shabazz",84,188,.447,7,27,.259,77,161,.478,39,50,.780,23,53,76,14,9,6,3,30,214,2017/2018
"Muhammad,Shabazz",47,121,.388,4,19,.211,43,102,.422,22,31,.710,15,30,45,7,5,5,2,23,120,2017/2018
"Muhammad,Shabazz",37,67,.552,3,8,.375,34,59,.576,17,19,.895,8,23,31,7,4,1,1,7,94,2017/2018
"Munford,Xavier",1,6,.167,0,2,.000,1,4,.250,1,2,.500,1,0,1,4,1,2,0,4,3,2017/2018
"Murray,Dejounte",270,609,.443,9,34,.265,261,575,.454,105,148,.709,110,349,459,231,97,134,31,151,654,2017/2018
"Murray,Jamal",479,1062,.451,165,436,.378,314,626,.502,229,253,.905,82,215,297,274,79,172,28,173,1352,2017/2018
"Muscala,Mike",143,312,.458,62,167,.371,81,145,.559,57,62,.919,56,174,230,51,31,42,27,80,405,2017/2018
"Nader,Abdel",50,149,.336,23,65,.354,27,84,.321,23,39,.590,13,58,71,26,15,34,10,45,146,2017/2018
"Nance,Larry",240,413,.581,2,12,.167,238,401,.594,91,137,.664,161,291,452,82,88,51,38,172,573,2017/2018
"Nance,Larry",152,253,.601,1,4,.250,151,249,.606,55,87,.632,108,176,284,57,59,41,20,113,360,2017/2018
"Nance,Larry",88,160,.550,1,8,.125,87,152,.572,36,50,.720,53,115,168,25,29,10,18,59,213,2017/2018
"Napier,Shabazz",223,531,.420,82,218,.376,141,313,.450,116,138,.841,26,144,170,150,81,90,14,84,644,2017/2018
"Nelson,Jameer",95,244,.389,41,124,.331,54,120,.450,16,20,.800,13,91,104,179,27,67,4,81,247,2017/2018
"Nelson,Jameer",84,205,.410,40,110,.364,44,95,.463,13,17,.765,11,85,96,156,23,56,3,67,221,2017/2018
"Nelson,Jameer",11,39,.282,1,14,.071,10,25,.400,3,3,1.000,2,6,8,23,4,11,1,14,26,2017/2018
"Neto,Raul",69,151,.457,19,47,.404,50,104,.481,26,35,.743,7,42,49,75,13,36,4,38,183,2017/2018
"Niang,Georges",4,11,.364,0,4,.000,4,7,.571,1,2,.500,3,6,9,3,2,3,0,1,9,2017/2018
"Noah,Joakim",5,10,.500,0,0,,5,10,.500,2,4,.500,6,8,14,4,2,4,2,5,12,2017/2018
"Noel,Nerlens",55,105,.524,0,1,.000,55,104,.529,21,28,.750,48,120,168,20,31,26,22,59,131,2017/2018
"Nogueira,Lucas",49,80,.613,5,19,.263,44,61,.721,19,28,.679,18,69,87,22,23,16,43,49,122,2017/2018
"Nowitzki,Dirk",346,758,.456,138,337,.409,208,421,.494,97,108,.898,22,416,438,120,43,51,45,146,927,2017/2018
"Ntilikina,Frank",182,500,.364,50,157,.318,132,343,.385,49,68,.721,37,140,177,250,65,131,18,181,463,2017/2018
"Nurkić,Jusuf",480,951,.505,0,7,.000,480,944,.508,172,273,.630,189,519,708,143,64,183,111,247,1132,2017/2018
"Nwaba,David",202,423,.478,18,52,.346,184,371,.496,133,203,.655,89,237,326,104,59,77,29,158,555,2017/2018
"O'Bryant,Johnny",68,171,.398,14,43,.326,54,128,.422,21,25,.840,29,64,93,14,9,15,6,45,171,2017/2018
"O'Neale,Royce",120,284,.423,42,118,.356,78,166,.470,61,76,.803,25,211,236,95,36,55,16,105,343,2017/2018
"O'Quinn,Kyle",224,384,.583,4,17,.235,220,367,.599,98,127,.772,121,349,470,158,36,100,98,192,550,2017/2018
"Ojeleye,Semi",65,188,.346,40,125,.320,25,63,.397,25,41,.610,37,124,161,20,21,25,4,91,195,2017/2018
"Okafor,Emeka",48,95,.505,0,0,,48,95,.505,18,22,.818,47,73,120,8,8,13,25,30,114,2017/2018
"Okafor,Jahlil",77,138,.558,1,4,.250,76,134,.567,21,29,.724,21,64,85,12,3,21,18,51,176,2017/2018
"Okafor,Jahlil",4,9,.444,0,0,,4,9,.444,2,4,.500,4,5,9,1,0,3,2,7,10,2017/2018
"Okafor,Jahlil",73,129,.566,1,4,.250,72,125,.576,19,25,.760,17,59,76,11,3,18,16,44,166,2017/2018
"Oladipo,Victor",640,1342,.477,161,434,.371,479,908,.528,294,368,.799,47,343,390,323,177,219,57,175,1735,2017/2018
"Olynyk,Kelly",316,636,.497,106,280,.379,210,356,.590,134,174,.770,89,342,431,207,62,147,35,222,872,2017/2018
"Onuaku,Chinanu",2,5,.400,0,0,,2,5,.400,0,0,,1,3,4,1,0,3,0,4,4,2017/2018
"Osman,Cedi",90,186,.484,32,87,.368,58,99,.586,26,46,.565,19,101,120,41,22,32,3,78,238,2017/2018
"Oubre,Kelly",318,790,.403,126,369,.341,192,421,.456,191,233,.820,59,304,363,98,80,90,35,234,953,2017/2018
"Pachulia,Zaza",149,264,.564,0,1,.000,149,263,.567,75,93,.806,89,232,321,109,38,72,17,122,373,2017/2018
"Paige,Marcus",4,14,.286,2,8,.250,2,6,.333,2,2,1.000,0,4,4,3,0,0,0,0,12,2017/2018
"Papagiannis,Georgios",18,42,.429,0,0,,18,42,.429,0,0,,13,24,37,9,4,8,6,12,36,2017/2018
"Papagiannis,Georgios",17,41,.415,0,0,,17,41,.415,0,0,,12,24,36,9,2,8,6,12,34,2017/2018
"Papagiannis,Georgios",1,1,1.000,0,0,,1,1,1.000,0,0,,1,0,1,0,2,0,0,0,2,2017/2018
"Parker,Jabari",160,332,.482,31,81,.383,129,251,.514,40,54,.741,42,109,151,59,25,45,10,50,391,2017/2018
"Parker,Tony",178,388,.459,10,37,.270,168,351,.479,55,78,.705,7,88,95,195,28,68,1,52,421,2017/2018
"Parsons,Chandler",108,234,.462,51,121,.421,57,113,.504,17,27,.630,14,76,90,69,18,35,11,53,284,2017/2018
"Patterson,Patrick",106,266,.398,66,171,.386,40,95,.421,40,46,.870,32,161,193,57,48,33,23,87,318,2017/2018
"Patton,Justin",1,2,.500,0,0,,1,2,.500,0,0,,0,0,0,0,1,0,0,1,2,2017/2018
"Paul,Brandon",55,127,.433,15,54,.278,40,73,.548,22,43,.512,6,62,68,37,25,29,7,58,147,2017/2018
"Paul,Chris",367,798,.460,144,379,.380,223,419,.532,203,221,.919,37,276,313,457,96,128,14,141,1081,2017/2018
"Payne,Adreian",7,10,.700,2,3,.667,5,7,.714,5,6,.833,2,7,9,0,2,2,0,6,21,2017/2018
"Payne,Cameron",87,215,.405,35,91,.385,52,124,.419,12,16,.750,18,51,69,113,26,36,9,44,221,2017/2018
"Payton,Elfrid",329,667,.493,30,92,.326,299,575,.520,109,168,.649,64,210,274,393,83,168,22,147,797,2017/2018
"Payton,Elfrid",238,458,.520,25,67,.373,213,391,.545,72,114,.632,47,127,174,275,64,114,16,97,573,2017/2018
"Payton,Elfrid",91,209,.435,5,25,.200,86,184,.467,37,54,.685,17,83,100,118,19,54,6,50,224,2017/2018
"Payton,Gary",30,74,.405,6,25,.240,24,49,.490,3,9,.333,13,31,44,21,7,7,3,30,69,2017/2018
"Payton,Gary",13,33,.394,2,12,.167,11,21,.524,2,3,.667,4,13,17,9,3,3,1,17,30,2017/2018
"Payton,Gary",17,41,.415,4,13,.308,13,28,.464,1,6,.167,9,18,27,12,4,4,2,13,39,2017/2018
"Perkins,Kendrick",1,2,.500,0,0,,1,2,.500,1,2,.500,0,1,1,2,1,1,0,1,3,2017/2018
"Perrantes,London",2,13,.154,0,3,.000,2,10,.200,3,5,.600,1,3,4,5,2,1,1,6,7,2017/2018
"Peters,Alec",28,74,.378,18,58,.310,10,16,.625,8,10,.800,8,29,37,12,2,4,2,13,82,2017/2018
"Plumlee,Marshall",1,3,.333,0,0,,1,3,.333,12,16,.750,4,13,17,2,0,3,1,10,14,2017/2018
"Plumlee,Mason",221,368,.601,0,1,.000,221,367,.602,82,179,.458,132,268,400,142,49,103,81,184,524,2017/2018
"Plumlee,Miles",105,180,.583,0,0,,105,180,.583,27,60,.450,77,151,228,45,17,63,30,79,237,2017/2018
"Pöltl,Jakob",253,384,.659,1,2,.500,252,382,.660,60,101,.594,165,228,393,57,39,85,100,212,567,2017/2018
"Pondexter,Quincy",14,49,.286,3,22,.136,11,27,.407,14,17,.824,8,19,27,9,8,11,2,24,45,2017/2018
"Porter,Otto",445,885,.503,138,313,.441,307,572,.537,106,128,.828,103,389,492,157,116,75,41,151,1134,2017/2018
"Portis,Bobby",382,811,.471,80,223,.359,302,588,.514,120,156,.769,159,339,498,123,50,103,23,130,964,2017/2018
"Porziņģis,Kristaps",390,889,.439,90,228,.395,300,661,.454,218,275,.793,62,254,316,57,36,93,115,141,1088,2017/2018
"Powell,Dwight",255,430,.593,28,84,.333,227,346,.656,133,185,.719,135,309,444,91,67,59,32,186,671,2017/2018
"Powell,Norman",150,374,.401,53,186,.285,97,188,.516,32,39,.821,14,105,119,89,37,66,16,111,385,2017/2018
"Poythress,Alex",11,26,.423,4,11,.364,7,15,.467,0,0,,7,10,17,2,3,2,1,16,26,2017/2018
"Pullen,Jacob",1,2,.500,0,1,.000,1,1,1.000,0,0,,0,0,0,0,0,1,0,0,2,2017/2018
"Purvis,Rodney",35,107,.327,13,52,.250,22,55,.400,13,15,.867,1,26,27,17,3,10,3,26,96,2017/2018
"Qi,Zhou",6,32,.188,2,19,.105,4,13,.308,8,12,.667,6,16,22,2,2,10,14,14,22,2017/2018
"Quarterman,Tim",1,3,.333,0,2,.000,1,1,1.000,2,2,1.000,0,3,3,1,0,2,0,1,4,2017/2018
"Rabb,Ivan",86,152,.566,0,0,,86,152,.566,29,36,.806,53,105,158,32,12,35,13,55,201,2017/2018
"Randle,Julius",504,904,.558,10,45,.222,494,859,.575,305,425,.718,181,473,654,210,43,213,45,274,1323,2017/2018
"Randolph,Zach",361,763,.473,51,147,.347,310,616,.503,84,107,.785,97,300,397,127,42,116,10,119,857,2017/2018
"Rathan-Mayes,Xavier",12,42,.286,1,14,.071,11,28,.393,4,9,.444,0,5,5,18,6,11,3,18,29,2017/2018
"Redick,J.J.",404,879,.460,193,460,.420,211,419,.504,197,218,.904,9,169,178,210,35,103,6,123,1198,2017/2018
"Reed,Davon",22,76,.289,11,38,.289,11,38,.289,8,12,.667,2,37,39,13,10,10,2,17,63,2017/2018
"Reed,Willie",81,121,.669,1,2,.500,80,119,.672,32,55,.582,35,86,121,10,9,19,22,56,195,2017/2018
"Reed,Willie",80,120,.667,1,2,.500,79,118,.669,32,55,.582,35,85,120,9,9,19,22,53,193,2017/2018
"Reed,Willie",1,1,1.000,0,0,,1,1,1.000,0,0,,0,1,1,1,0,0,0,3,2,2017/2018
"Richardson,Josh",399,885,.451,127,336,.378,272,549,.495,120,142,.845,69,216,285,231,121,140,75,199,1045,2017/2018
"Richardson,Malachi",30,90,.333,12,40,.300,18,50,.360,17,22,.773,5,29,34,13,10,10,1,27,89,2017/2018
"Richardson,Malachi",29,88,.330,12,39,.308,17,49,.347,17,22,.773,5,28,33,13,10,10,1,27,87,2017/2018
"Richardson,Malachi",1,2,.500,0,1,.000,1,1,1.000,0,0,,0,1,1,0,0,0,0,0,2,2017/2018
"Rivers,Austin",341,805,.424,136,360,.378,205,445,.461,102,159,.642,27,118,145,242,74,109,16,152,920,2017/2018
"Roberson,Andre",87,162,.537,8,36,.222,79,126,.627,12,38,.316,75,110,185,46,45,30,35,89,194,2017/2018
"Robinson,Devin",1,3,.333,0,0,,1,3,.333,0,0,,2,3,5,0,1,0,0,2,2,2017/2018
"Robinson,Glenn",36,85,.424,14,34,.412,22,51,.431,9,11,.818,11,26,37,17,13,5,1,14,95,2017/2018
"Rondo,Rajon",231,494,.468,50,150,.333,181,344,.526,25,46,.543,31,232,263,533,70,151,10,119,537,2017/2018
"Rose,Derrick",81,186,.435,7,30,.233,74,156,.474,40,46,.870,13,22,35,37,7,35,4,16,209,2017/2018
"Rose,Derrick",58,132,.439,6,24,.250,52,108,.481,35,41,.854,10,19,29,26,3,28,4,14,157,2017/2018
"Rose,Derrick",23,54,.426,1,6,.167,22,48,.458,5,5,1.000,3,3,6,11,4,7,0,2,52,2017/2018
"Ross,Terrence",76,191,.398,30,93,.323,46,98,.469,27,36,.750,10,63,73,38,27,29,11,45,209,2017/2018
"Rozier,Terry",316,800,.395,153,402,.381,163,398,.410,115,149,.772,63,313,376,232,80,80,19,123,900,2017/2018
"Rubio,Ricky",346,827,.418,96,273,.352,250,554,.451,220,254,.866,44,307,351,410,121,207,11,206,1008,2017/2018
"Russell,D'Angelo",278,672,.414,90,278,.324,188,394,.477,97,131,.740,30,159,189,249,36,147,17,93,743,2017/2018
"Sabonis,Domantas",340,661,.514,13,37,.351,327,624,.524,168,224,.750,165,407,572,151,40,137,32,220,861,2017/2018
"Sampson,JaKarr",44,81,.543,5,10,.500,39,71,.549,10,16,.625,21,57,78,9,8,8,22,48,103,2017/2018
"Šarić,Dario",403,890,.453,157,399,.393,246,491,.501,178,207,.860,154,366,520,202,51,148,20,160,1141,2017/2018
"Satoranský,Tomáš",201,384,.523,47,101,.465,154,283,.544,75,96,.781,72,161,233,286,52,83,15,131,524,2017/2018
"Schröder,Dennis",500,1146,.436,76,262,.290,424,884,.480,225,265,.849,44,164,208,417,72,183,6,147,1301,2017/2018
"Scott,Mike",276,524,.527,66,163,.405,210,361,.582,50,76,.658,50,197,247,80,23,79,10,148,668,2017/2018
"Sefolosha,Thabo",118,240,.492,32,84,.381,86,156,.551,44,54,.815,29,132,161,33,52,30,12,59,312,2017/2018
"Selden,Wayne",116,269,.431,49,122,.402,67,147,.456,44,59,.746,16,40,56,66,18,54,5,59,325,2017/2018
"Sessions,Ramon",42,117,.359,8,26,.308,34,91,.374,44,57,.772,6,32,38,77,14,30,2,29,136,2017/2018
"Sessions,Ramon",17,53,.321,2,11,.182,15,42,.357,12,15,.800,1,17,18,27,7,15,1,14,48,2017/2018
"Sessions,Ramon",25,64,.391,6,15,.400,19,49,.388,32,42,.762,5,15,20,50,7,15,1,15,88,2017/2018
"Shumpert,Iman",22,58,.379,7,26,.269,15,32,.469,11,15,.733,7,34,41,17,9,16,4,22,62,2017/2018
"Siakam,Pascal",253,498,.508,29,132,.220,224,366,.612,54,87,.621,79,285,364,159,62,67,42,166,589,2017/2018
"Silas,Xavier",0,3,.000,0,2,.000,0,1,.000,0,0,,1,1,2,0,1,0,0,1,0,2017/2018
"Simmons,Ben",544,998,.545,0,11,.000,544,987,.551,191,341,.560,145,514,659,661,140,278,70,211,1279,2017/2018
"Simmons,Jonathon",354,761,.465,69,204,.338,285,557,.512,185,241,.768,61,178,239,171,58,146,16,175,962,2017/2018
"Simmons,Kobi",80,189,.423,11,39,.282,69,150,.460,25,25,1.000,14,36,50,68,18,44,5,61,196,2017/2018
"Singler,Kyle",7,21,.333,2,5,.400,5,16,.313,7,13,.538,1,9,10,2,1,3,0,4,23,2017/2018
"Smart,Marcus",189,515,.367,75,249,.301,114,266,.429,97,133,.729,43,146,189,259,71,129,23,133,550,2017/2018
"Smith,Dennis",404,1024,.395,106,339,.313,298,685,.435,134,193,.694,50,210,260,358,71,194,18,152,1048,2017/2018
"Smith,Ish",389,801,.486,35,101,.347,354,700,.506,81,116,.698,27,197,224,360,64,108,20,140,894,2017/2018
"Smith,J.R.",240,595,.403,143,381,.375,97,214,.453,39,56,.696,29,206,235,141,68,81,11,161,662,2017/2018
"Smith,Jason",45,115,.391,4,32,.125,41,83,.494,19,21,.905,18,35,53,14,3,16,13,44,113,2017/2018
"Smith,Josh",1,4,.250,0,0,,1,4,.250,0,0,,3,1,4,0,0,0,0,3,2,2017/2018
"Snell,Tony",185,425,.435,108,268,.403,77,157,.490,38,48,.792,9,132,141,98,47,36,28,115,516,2017/2018
"Speights,Marreese",138,349,.395,86,233,.369,52,116,.448,40,55,.727,21,112,133,40,8,40,22,106,402,2017/2018
"Stauskas,Nik",60,154,.390,40,100,.400,20,54,.370,21,29,.724,4,60,64,39,9,26,4,24,181,2017/2018
"Stauskas,Nik",1,4,.250,0,1,.000,1,3,.333,2,2,1.000,0,1,1,1,4,4,0,3,4,2017/2018
"Stauskas,Nik",59,150,.393,40,99,.404,19,51,.373,19,27,.704,4,59,63,38,5,22,4,21,177,2017/2018
"Stephenson,Lance",303,709,.427,67,232,.289,236,477,.495,84,127,.661,62,362,424,235,46,131,17,177,757,2017/2018
"Stockton,David",2,3,.667,2,3,.667,0,0,,4,4,1.000,0,0,0,0,0,1,0,3,10,2017/2018
"Stone,Julyan",6,13,.462,6,13,.462,0,0,,1,2,.500,1,28,29,26,4,7,2,21,19,2017/2018
"Sumner,Edmond",1,1,1.000,0,0,,1,1,1.000,0,0,,0,1,1,0,0,0,0,1,2,2017/2018
"Swanigan,Caleb",24,60,.400,1,8,.125,23,52,.442,12,18,.667,15,39,54,14,5,18,3,37,61,2017/2018
"Tatum,Jayson",397,835,.475,105,242,.434,292,593,.492,213,258,.826,50,352,402,128,83,114,58,170,1112,2017/2018
"Taylor,Isaiah",163,390,.418,20,80,.250,143,310,.461,99,141,.702,22,72,94,206,34,84,10,116,445,2017/2018
"Teague,Jeff",354,794,.446,84,228,.368,270,566,.477,202,239,.845,24,185,209,492,102,177,23,171,994,2017/2018
"Teague,Marquis",4,16,.250,1,4,.250,3,12,.250,2,5,.400,1,5,6,13,4,3,0,5,11,2017/2018
"Teletović,Mirza",25,57,.439,21,45,.467,4,12,.333,0,0,,3,20,23,10,4,7,1,14,71,2017/2018
"Temple,Garrett",199,476,.418,89,227,.392,110,249,.442,60,78,.769,22,130,152,124,57,79,27,135,547,2017/2018
"Teodosić,Miloš",151,360,.419,88,232,.379,63,128,.492,39,46,.848,16,110,126,209,23,97,5,103,429,2017/2018
"Terry,Jason",59,154,.383,40,115,.348,19,39,.487,8,9,.889,5,43,48,59,42,25,13,52,166,2017/2018
"Theis,Daniel",126,233,.541,18,58,.310,108,175,.617,61,81,.753,90,184,274,56,30,56,48,157,331,2017/2018
"Thomas,Isaiah",157,421,.373,55,188,.293,102,233,.438,117,131,.893,17,50,67,153,15,95,3,58,486,2017/2018
"Thomas,Isaiah",70,194,.361,22,87,.253,48,107,.449,59,68,.868,7,24,31,68,9,41,2,25,221,2017/2018
"Thomas,Isaiah",87,227,.383,33,101,.327,54,126,.429,58,63,.921,10,26,36,85,6,54,1,33,265,2017/2018
"Thomas,Lance",102,267,.382,50,124,.403,52,143,.364,44,53,.830,44,131,175,44,30,40,14,134,298,2017/2018
"Thompson,Klay",575,1179,.488,229,521,.440,346,658,.526,82,98,.837,31,246,277,185,55,128,34,117,1461,2017/2018
"Thompson,Tristan",132,235,.562,0,0,,132,235,.562,43,79,.544,126,226,352,33,16,36,17,102,307,2017/2018
"Thornwell,Sindarius",100,233,.429,23,61,.377,77,172,.448,59,88,.670,33,107,140,68,48,53,25,125,282,2017/2018
"Tolliver,Anthony",219,472,.464,159,365,.436,60,107,.561,106,133,.797,50,191,241,90,32,58,21,144,703,2017/2018
"Towns,Karl-Anthony",639,1172,.545,120,285,.421,519,887,.585,345,402,.858,238,774,1012,199,64,159,115,285,1743,2017/2018
"Tucker,P.J.",172,441,.390,115,310,.371,57,131,.435,43,60,.717,93,364,457,77,78,74,26,205,502,2017/2018
"Turner,Evan",258,577,.447,42,132,.318,216,445,.485,91,107,.850,30,214,244,173,47,99,29,163,649,2017/2018
"Turner,Myles",306,639,.479,56,157,.357,250,482,.519,160,206,.777,93,324,417,87,38,96,118,186,828,2017/2018
"Udoh,Ekpe",60,120,.500,0,1,.000,60,119,.504,42,56,.750,68,82,150,53,43,20,74,105,162,2017/2018
"Ulis,Tyler",214,551,.388,42,146,.288,172,405,.425,84,101,.832,24,104,128,311,70,127,7,120,554,2017/2018
"Valančiūnas,Jonas",390,687,.568,30,74,.405,360,613,.587,170,211,.806,183,477,660,81,29,115,69,192,980,2017/2018
"Valentine,Denzel",301,721,.417,143,370,.386,158,351,.450,38,51,.745,48,345,393,244,65,99,11,185,783,2017/2018
"VanVleet,Fred",232,545,.426,108,261,.414,124,284,.437,84,101,.832,25,159,184,243,68,74,19,130,656,2017/2018
"Vaughn,Rashad",23,56,.411,14,37,.378,9,19,.474,4,6,.667,3,18,21,13,5,6,3,15,64,2017/2018
"Vaughn,Rashad",21,50,.420,13,35,.371,8,15,.533,4,6,.667,2,15,17,12,4,4,3,12,59,2017/2018
"Vaughn,Rashad",0,0,,0,0,,0,0,,0,0,,0,0,0,1,0,0,0,1,0,2017/2018
"Vaughn,Rashad",2,6,.333,1,2,.500,1,4,.250,0,0,,1,3,4,0,1,2,0,2,5,2017/2018
"Vonleh,Noah",104,234,.444,20,66,.303,84,168,.500,36,58,.621,70,241,311,34,19,31,17,68,264,2017/2018
"Vonleh,Noah",47,96,.490,2,6,.333,45,90,.500,23,31,.742,35,132,167,13,6,15,11,42,119,2017/2018
"Vonleh,Noah",57,138,.413,18,60,.300,39,78,.500,13,27,.481,35,109,144,21,13,16,6,26,145,2017/2018
"Vučević,Nikola",399,840,.475,64,204,.314,335,636,.527,77,94,.819,101,422,523,191,56,109,62,144,939,2017/2018
"Wade,Dwyane",299,682,.438,32,111,.288,267,571,.468,135,189,.714,50,202,252,228,61,140,47,124,765,2017/2018
"Wade,Dwyane",198,435,.455,23,70,.329,175,365,.479,94,134,.701,39,142,181,163,42,92,32,84,513,2017/2018
"Wade,Dwyane",101,247,.409,9,41,.220,92,206,.447,41,55,.745,11,60,71,65,19,48,15,40,252,2017/2018
"Waiters,Dion",163,410,.398,52,170,.306,111,240,.463,51,69,.739,8,69,77,113,23,70,9,61,429,2017/2018
"Walker,Kemba",588,1363,.431,231,601,.384,357,762,.469,363,420,.864,32,216,248,444,91,179,24,98,1770,2017/2018
"Wall,John",280,667,.420,62,167,.371,218,500,.436,175,241,.726,22,128,150,393,57,158,45,80,797,2017/2018
"Wallace,Tyrone",110,247,.445,10,40,.250,100,207,.483,61,78,.782,21,84,105,71,27,46,13,83,291,2017/2018
"Waller-Prince,Taurean",415,975,.426,176,457,.385,239,518,.461,152,180,.844,50,339,389,214,85,191,42,168,1158,2017/2018
"Walton,Derrick",8,25,.320,7,17,.412,1,8,.125,6,6,1.000,2,14,16,16,7,2,3,7,29,2017/2018
"Warney,Jameel",7,12,.583,0,0,,7,12,.583,3,5,.600,4,5,9,0,0,1,0,2,17,2017/2018
"Warren,T.J.",529,1063,.498,20,90,.222,509,973,.523,193,255,.757,125,208,333,85,65,85,41,149,1271,2017/2018
"Wear,Travis",25,72,.347,17,47,.362,8,25,.320,8,8,1.000,0,38,38,7,4,6,5,30,75,2017/2018
"Webb,James",6,24,.250,4,19,.211,2,5,.400,0,0,,8,16,24,4,1,4,0,10,16,2017/2018
"Weber,Briante",19,43,.442,4,11,.364,15,32,.469,8,10,.800,8,27,35,22,18,15,5,28,50,2017/2018
"Weber,Briante",9,22,.409,4,9,.444,5,13,.385,4,4,1.000,3,15,18,13,10,7,3,18,26,2017/2018
"Weber,Briante",10,21,.476,0,2,.000,10,19,.526,4,6,.667,5,12,17,9,8,8,2,10,24,2017/2018
"West,David",216,378,.571,3,8,.375,213,370,.576,60,79,.759,64,174,238,138,47,80,75,120,495,2017/2018
"Westbrook,Russell",757,1687,.449,97,326,.298,660,1361,.485,417,566,.737,152,652,804,820,147,381,20,200,2028,2017/2018
"White,Andrew",25,73,.342,18,49,.367,7,24,.292,1,4,.250,4,30,34,6,3,8,1,12,69,2017/2018
"White,Derrick",16,33,.485,8,13,.615,8,20,.400,14,20,.700,5,21,26,9,4,6,3,8,54,2017/2018
"White,Okaro",7,16,.438,4,11,.364,3,5,.600,2,3,.667,3,8,11,2,1,1,1,6,20,2017/2018
"Whitehead,Isaiah",40,86,.465,7,18,.389,33,68,.485,13,19,.684,4,22,26,20,8,24,2,23,100,2017/2018
"Whiteside,Hassan",312,578,.540,2,2,1.000,310,576,.538,128,182,.703,174,444,618,54,37,92,94,131,754,2017/2018
"Wiggins,Andrew",569,1300,.438,112,338,.331,457,962,.475,202,314,.643,82,276,358,160,91,138,51,163,1452,2017/2018
"Wiley,Jacob",1,4,.250,1,2,.500,0,2,.000,1,2,.500,2,9,11,2,1,0,0,4,4,2017/2018
"Wilkins,Damien",13,39,.333,4,18,.222,9,21,.429,3,4,.750,5,11,16,9,2,5,1,7,33,2017/2018
"Williams,Alan",7,18,.389,0,0,,7,18,.389,6,9,.667,3,19,22,8,5,7,1,13,20,2017/2018
"Williams,C.J.",87,197,.442,22,78,.282,65,119,.546,13,16,.813,12,44,56,43,31,20,13,63,209,2017/2018
"Williams,Derrick",1,4,.250,0,2,.000,1,2,.500,0,0,,0,1,1,0,0,0,0,0,2,2017/2018
"Williams,Lou",582,1337,.435,186,518,.359,396,819,.484,432,491,.880,40,158,198,417,85,234,19,106,1782,2017/2018
"Williams,Marvin",258,563,.458,126,305,.413,132,258,.512,102,123,.829,74,296,370,96,56,66,38,116,744,2017/2018
"Williams,Matt",2,6,.333,1,5,.200,1,1,1.000,0,0,,0,1,1,0,0,1,0,1,5,2017/2018
"Williams,Troy",51,109,.468,11,38,.289,40,71,.563,20,30,.667,22,41,63,16,20,19,4,34,133,2017/2018
"Williams,Troy",2,9,.222,0,5,.000,2,4,.500,1,3,.333,1,3,4,1,1,1,0,2,5,2017/2018
"Williams,Troy",49,100,.490,11,33,.333,38,67,.567,19,27,.704,21,38,59,15,19,18,4,32,128,2017/2018
"Wilson,D.J.",9,16,.563,2,5,.400,7,11,.636,1,2,.500,2,8,10,3,3,4,1,7,21,2017/2018
"Wilson,Jamil",38,81,.469,27,63,.429,11,18,.611,2,4,.500,3,29,32,10,5,8,8,34,105,2017/2018
"Winslow,Justise",207,488,.424,49,129,.380,158,359,.440,66,104,.635,64,306,370,148,54,77,33,140,529,2017/2018
"Withey,Jeff",6,16,.375,2,10,.200,4,6,.667,1,2,.500,1,9,10,0,0,2,3,3,15,2017/2018
"Wolters,Nate",1,6,.167,0,0,,1,6,.167,0,0,,1,1,2,1,0,0,0,1,2,2017/2018
"Wright,Brandan",59,102,.578,0,0,,59,102,.578,21,33,.636,33,62,95,13,13,8,26,32,139,2017/2018
"Wright,Brandan",57,99,.576,0,0,,57,99,.576,21,33,.636,32,61,93,13,13,8,25,29,135,2017/2018
"Wright,Brandan",2,3,.667,0,0,,2,3,.667,0,0,,1,1,2,0,0,0,1,3,4,2017/2018
"Wright,Delon",201,432,.465,56,153,.366,145,279,.520,97,117,.829,45,153,198,200,72,78,33,81,555,2017/2018
"Yabusele,Guerschon",26,61,.426,12,37,.324,14,24,.583,15,22,.682,17,35,52,16,4,12,5,23,79,2017/2018
"Young,James",5,14,.357,3,10,.300,2,4,.500,4,6,.667,0,2,2,2,0,1,0,4,17,2017/2018
"Young,Joe",80,186,.430,25,66,.379,55,120,.458,22,29,.759,12,51,63,39,14,26,1,39,207,2017/2018
"Young,Nick",201,488,.412,123,326,.377,78,162,.481,56,65,.862,20,105,125,36,38,39,7,100,581,2017/2018
"Young,Thaddeus",421,864,.487,58,181,.320,363,683,.531,55,92,.598,184,328,512,152,135,105,36,175,955,2017/2018
"Zeller,Cody",85,156,.545,2,3,.667,83,153,.542,61,85,.718,67,110,177,31,14,33,21,81,233,2017/2018
"Zeller,Tyler",187,334,.560,10,28,.357,177,306,.578,57,79,.722,110,195,305,47,15,47,35,126,441,2017/2018
"Zeller,Tyler",125,229,.546,10,26,.385,115,203,.567,40,60,.667,63,131,194,28,8,35,21,78,300,2017/2018
"Zeller,Tyler",62,105,.590,0,2,.000,62,103,.602,17,19,.895,47,64,111,19,7,12,14,48,141,2017/2018
"Zipser,Paul",81,234,.346,37,110,.336,44,124,.355,19,25,.760,13,118,131,46,20,43,15,86,218,2017/2018
"Žižić,Ante",49,67,.731,0,0,,49,67,.731,21,29,.724,24,36,60,5,2,11,13,30,119,2017/2018
"Zubac,Ivica",61,122,.500,0,1,.000,61,121,.504,39,51,.765,45,78,123,25,8,26,15,47,161,2017/2018
"Abrines,Álex",56,157,.357,41,127,.323,15,30,.500,12,13,.923,5,43,48,20,17,14,6,53,165,2018/2019
"Acy,Quincy",4,18,.222,2,15,.133,2,3,.667,7,10,.700,3,22,25,8,1,4,4,24,17,2018/2019
"Adams,Jaylen",38,110,.345,25,74,.338,13,36,.361,7,9,.778,11,49,60,65,14,28,5,45,108,2018/2019
"Adams,Steven",481,809,.595,0,2,.000,481,807,.596,146,292,.500,391,369,760,124,117,135,76,204,1108,2018/2019
"Adebayo,Bam",280,486,.576,3,15,.200,277,471,.588,166,226,.735,165,432,597,184,71,121,65,203,729,2018/2019
"Adel,Deng",11,36,.306,6,23,.261,5,13,.385,4,4,1.000,3,16,19,5,1,6,4,13,32,2018/2019
"Akoon-Purcell,DeVaughn",3,10,.300,0,4,.000,3,6,.500,1,2,.500,1,3,4,6,2,2,0,4,7,2018/2019
"Aldridge,LaMarcus",684,1319,.519,10,42,.238,674,1277,.528,349,412,.847,251,493,744,194,43,144,107,179,1727,2018/2019
"Alkins,Rawle",13,39,.333,3,12,.250,10,27,.370,8,12,.667,11,15,26,13,1,8,0,7,37,2018/2019
"Allen,Grayson",67,178,.376,32,99,.323,35,79,.443,45,60,.750,3,20,23,25,6,33,6,47,211,2018/2019
"Allen,Jarrett",335,568,.590,6,45,.133,329,523,.629,197,278,.709,191,481,672,110,43,103,120,184,873,2018/2019
"Allen,Kadeem",65,141,.461,17,36,.472,48,105,.457,42,54,.778,8,43,51,76,16,26,4,46,189,2018/2019
"Aminu,Al-Farouq",257,593,.433,96,280,.343,161,313,.514,150,173,.867,112,498,610,104,68,72,33,143,760,2018/2019
"Anderson,Justin",64,157,.408,24,77,.312,40,80,.500,26,35,.743,24,60,84,23,22,23,13,48,178,2018/2019
"Anderson,Kyle",150,276,.543,9,34,.265,141,242,.583,37,64,.578,48,203,251,128,54,58,37,112,346,2018/2019
"Anderson,Ryan",21,69,.304,9,40,.225,12,29,.414,12,16,.750,18,36,54,19,4,14,1,25,63,2018/2019
"Anderson,Ryan",19,60,.317,7,34,.206,12,26,.462,11,14,.786,14,31,45,17,3,12,1,23,56,2018/2019
"Anderson,Ryan",2,9,.222,2,6,.333,0,3,.000,1,2,.500,4,5,9,2,1,2,0,2,7,2018/2019
"Anigbogu,Ike",0,3,.000,0,0,,0,3,.000,0,0,,1,2,3,1,0,1,1,0,0,2018/2019
"Antetokounmpo,Giannis",721,1247,.578,52,203,.256,669,1044,.641,500,686,.729,159,739,898,424,92,268,110,232,1994,2018/2019
"Antetokounmpo,Kostas",0,3,.000,0,0,,0,3,.000,2,4,.500,0,1,1,0,2,1,0,0,2,2018/2019
"Anthony,Carmelo",49,121,.405,21,64,.328,28,57,.491,15,22,.682,9,45,54,5,4,8,7,32,134,2018/2019
"Anunoby,OG",183,404,.453,67,202,.332,116,202,.574,36,62,.581,58,139,197,47,46,55,22,140,469,2018/2019
"Arcidiacono,Ryan",187,418,.447,81,217,.373,106,201,.527,89,102,.873,27,192,219,269,65,63,4,171,544,2018/2019
"Ariza,Trevor",294,736,.399,145,434,.334,149,302,.493,130,164,.793,50,321,371,252,91,106,21,130,863,2018/2019
"Ariza,Trevor",86,227,.379,50,139,.360,36,88,.409,36,43,.837,16,129,145,87,38,39,8,44,258,2018/2019
"Ariza,Trevor",208,509,.409,95,295,.322,113,214,.528,94,121,.777,34,192,226,165,53,67,13,86,605,2018/2019
"Augustin,D.J.",318,677,.470,131,311,.421,187,366,.511,181,209,.866,41,162,203,426,52,128,4,115,948,2018/2019
"Ayton,Deandre",509,870,.585,0,4,.000,509,866,.588,141,189,.746,223,506,729,125,61,126,67,209,1159,2018/2019
"Bacon,Dwayne",122,257,.475,38,87,.437,84,170,.494,34,46,.739,8,81,89,47,12,18,5,72,316,2018/2019
"Bagley,Marvin",356,706,.504,30,96,.313,326,610,.534,181,262,.691,162,309,471,62,33,98,59,120,923,2018/2019
"Baker,Ron",4,20,.200,1,13,.077,3,7,.429,5,6,.833,1,10,11,15,6,5,1,18,14,2018/2019
"Baker,Ron",4,16,.250,1,9,.111,3,7,.429,5,6,.833,1,6,7,13,5,3,0,16,14,2018/2019
"Baker,Ron",0,4,.000,0,4,.000,0,0,,0,0,,0,4,4,2,1,2,1,2,0,2018/2019
"Baldwin,Wade",10,33,.303,2,9,.222,8,24,.333,8,11,.727,2,13,15,12,1,14,2,11,30,2018/2019
"Ball,Lonzo",185,456,.406,75,228,.329,110,228,.482,20,48,.417,54,197,251,255,69,103,19,114,465,2018/2019
"Bamba,Mohamed",117,243,.481,21,70,.300,96,173,.555,37,63,.587,64,169,233,39,13,43,64,102,292,2018/2019
"Barea,J.J.",161,385,.418,38,128,.297,123,257,.479,55,78,.705,13,82,95,211,22,72,1,50,415,2018/2019
"Barnes,Harrison",431,1027,.420,174,441,.395,257,586,.439,229,278,.824,57,304,361,115,50,98,13,122,1265,2018/2019
"Barnes,Harrison",290,717,.404,121,311,.389,169,406,.416,165,198,.833,36,171,207,62,33,68,11,79,866,2018/2019
"Barnes,Harrison",141,310,.455,53,130,.408,88,180,.489,64,80,.800,21,133,154,53,17,30,2,43,399,2018/2019
"Barton,Will",185,460,.402,67,196,.342,118,264,.447,57,74,.770,32,167,199,124,18,65,22,82,494,2018/2019
"Bates-Diop,Keita",60,142,.423,13,52,.250,47,90,.522,18,28,.643,16,67,83,17,18,14,14,29,151,2018/2019
"Batum,Nicolas",253,562,.450,116,298,.389,137,264,.519,77,89,.865,71,319,390,247,71,117,43,140,699,2018/2019
"Bayless,Jerryd",82,230,.357,29,98,.296,53,132,.402,16,28,.571,11,51,62,119,18,32,2,56,209,2018/2019
"Baynes,Aron",105,223,.471,21,61,.344,84,162,.519,53,62,.855,88,152,240,57,12,40,34,125,284,2018/2019
"Bazemore,Kent",278,691,.402,96,300,.320,182,391,.465,127,175,.726,37,224,261,152,89,121,42,170,779,2018/2019
"Beal,Bradley",764,1609,.475,209,596,.351,555,1013,.548,362,448,.808,89,322,411,448,121,224,58,226,2099,2018/2019
"Beasley,Malik",349,737,.474,163,405,.402,186,332,.560,56,66,.848,35,165,200,97,55,55,10,116,917,2018/2019
"Beasley,Michael",75,153,.490,3,17,.176,72,136,.529,28,39,.718,13,47,60,25,9,27,10,42,181,2018/2019
"Belinelli,Marco",285,690,.413,147,395,.372,138,295,.468,112,124,.903,16,182,198,132,35,72,8,121,829,2018/2019
"Bell,Jordan",99,192,.516,0,2,.000,99,190,.521,25,41,.610,55,129,184,76,20,42,51,80,223,2018/2019
"Bembry,DeAndre'",275,616,.446,50,173,.289,225,443,.508,87,136,.640,54,304,358,202,105,142,41,190,687,2018/2019
"Bender,Dragan",88,197,.447,22,101,.218,66,96,.688,32,54,.593,34,149,183,56,18,37,22,90,230,2018/2019
"Bertāns,Dairis",12,47,.255,10,34,.294,2,13,.154,0,0,,2,7,9,10,1,2,0,7,34,2018/2019
"Bertāns,Dāvis",204,453,.450,145,338,.429,59,115,.513,53,60,.883,23,241,264,100,35,43,33,133,606,2018/2019
"Beverley,Patrick",194,477,.407,112,282,.397,82,195,.421,96,123,.780,76,312,388,300,67,85,43,265,596,2018/2019
"Birch,Khem",91,151,.603,0,1,.000,91,150,.607,58,83,.699,79,111,190,38,18,20,29,72,240,2018/2019
"Biyombo,Bismack",89,156,.571,0,0,,89,156,.571,58,91,.637,81,166,247,33,11,34,41,103,236,2018/2019
"Bjelica,Nemanja",284,593,.479,103,257,.401,181,336,.539,70,92,.761,125,319,444,147,54,82,56,197,741,2018/2019
"Blakeney,Antonio",166,396,.419,36,91,.396,130,305,.426,50,76,.658,7,99,106,42,12,35,9,41,418,2018/2019
"Bledsoe,Eric",470,971,.484,124,377,.329,346,594,.582,177,236,.750,82,280,362,430,116,165,29,156,1241,2018/2019
"Blossomgame,Jaron",47,106,.443,10,39,.256,37,67,.552,10,13,.769,26,72,98,13,7,11,8,20,114,2018/2019
"Bogdanović,Bogdan",361,863,.418,134,372,.360,227,491,.462,134,162,.827,40,203,243,267,72,117,15,142,990,2018/2019
"Bogdanović,Bojan",522,1051,.497,164,386,.425,358,665,.538,246,305,.807,33,300,333,161,69,134,1,138,1454,2018/2019
"Bogut,Andrew",18,36,.500,0,0,,18,36,.500,3,3,1.000,12,43,55,11,3,8,8,22,39,2018/2019
"Bolden,Jonah",80,162,.494,34,96,.354,46,66,.697,13,27,.481,47,118,165,40,17,36,39,99,207,2018/2019
"Bonga,Isaac",5,33,.152,0,8,.000,5,25,.200,9,15,.600,9,16,25,15,9,6,4,9,19,2018/2019
"Booker,Devin",586,1255,.467,135,414,.326,451,841,.536,393,454,.866,39,226,265,433,56,264,13,200,1700,2018/2019
"Boucher,Chris",34,76,.447,12,37,.324,22,39,.564,13,15,.867,16,40,56,2,6,7,24,31,93,2018/2019
"Bradley,Avery",248,608,.408,86,245,.351,162,363,.446,43,50,.860,43,132,175,152,41,89,16,167,625,2018/2019
"Bradley,Avery",161,420,.383,58,172,.337,103,248,.415,20,25,.800,35,96,131,96,27,61,16,133,400,2018/2019
"Bradley,Avery",87,188,.463,28,73,.384,59,115,.513,23,25,.920,8,36,44,56,14,28,0,34,225,2018/2019
"Bradley,Tony",8,16,.500,0,0,,8,16,.500,1,2,.500,9,6,15,1,2,3,2,6,17,2018/2019
"Brewer,Corey",53,123,.431,14,44,.318,39,79,.494,31,43,.721,26,50,76,39,32,19,7,63,151,2018/2019
"Brewer,Corey",20,49,.408,4,14,.286,16,35,.457,9,13,.692,4,13,17,10,12,8,2,16,53,2018/2019
"Brewer,Corey",33,74,.446,10,30,.333,23,44,.523,22,30,.733,22,37,59,29,20,11,5,47,98,2018/2019
"Bridges,Mikal",242,563,.430,105,313,.335,137,250,.548,95,118,.805,56,208,264,173,129,70,38,201,684,2018/2019
"Bridges,Miles",237,511,.464,65,200,.325,172,311,.553,58,77,.753,67,256,323,95,55,50,49,111,597,2018/2019
"Briscoe,Isaiah",55,138,.399,11,34,.324,44,104,.423,15,26,.577,5,69,74,87,11,31,2,66,136,2018/2019
"Broekhoff,Ryan",57,126,.452,38,93,.409,19,33,.576,15,19,.789,8,55,63,22,6,16,4,35,167,2018/2019
"Brogdon,Malcolm",378,748,.505,104,244,.426,274,504,.544,141,152,.928,65,223,288,205,46,91,13,102,1001,2018/2019
"Brooks,Dillon",49,122,.402,15,40,.375,34,82,.415,22,30,.733,9,22,31,16,10,19,4,50,135,2018/2019
"Brooks,MarShon",76,169,.450,15,54,.278,61,115,.530,23,33,.697,12,33,45,25,9,21,4,33,190,2018/2019
"Brown,Bruce",125,314,.398,24,93,.258,101,221,.457,45,60,.750,48,137,185,91,40,46,36,178,319,2018/2019
"Brown,Jaylen",368,792,.465,95,276,.344,273,516,.529,133,202,.658,65,248,313,100,69,99,32,186,964,2018/2019
"Brown,Lorenzo",23,71,.324,6,28,.214,17,43,.395,3,3,1.000,5,26,31,28,12,16,5,22,55,2018/2019
"Brown,Sterling",145,312,.465,53,147,.361,92,165,.558,29,42,.690,29,155,184,84,25,46,8,88,372,2018/2019
"Brown,Troy",97,234,.415,22,69,.319,75,165,.455,32,47,.681,35,110,145,80,21,30,5,56,248,2018/2019
"Brunson,Jalen",264,565,.467,63,181,.348,201,384,.523,87,120,.725,25,144,169,230,37,88,4,127,678,2018/2019
"Bryant,Thomas",309,502,.616,33,99,.333,276,403,.685,107,137,.781,113,341,454,92,25,60,67,126,758,2018/2019
"Bullock,Reggie",245,594,.412,148,393,.377,97,201,.483,73,85,.859,22,151,173,129,40,65,12,109,711,2018/2019
"Bullock,Reggie",182,441,.413,114,294,.388,68,147,.463,56,64,.875,20,103,123,109,24,54,5,79,534,2018/2019
"Bullock,Reggie",63,153,.412,34,99,.343,29,54,.537,17,21,.810,2,48,50,20,16,11,7,30,177,2018/2019
"Burke,Trey",236,548,.431,56,159,.352,180,389,.463,103,124,.831,28,71,99,159,33,49,7,58,631,2018/2019
"Burke,Trey",148,358,.413,30,86,.349,118,272,.434,62,75,.827,15,47,62,94,21,29,5,33,388,2018/2019
"Burke,Trey",88,190,.463,26,73,.356,62,117,.530,41,49,.837,13,24,37,65,12,20,2,25,243,2018/2019
"Burks,Alec",192,474,.405,61,168,.363,131,306,.428,116,141,.823,30,205,235,128,39,65,21,91,561,2018/2019
"Burks,Alec",47,114,.412,16,43,.372,31,71,.437,33,38,.868,2,25,27,20,6,15,4,22,143,2018/2019
"Burks,Alec",136,340,.400,45,119,.378,91,221,.412,79,98,.806,26,160,186,98,25,46,16,62,396,2018/2019
"Burks,Alec",9,20,.450,0,6,.000,9,14,.643,4,5,.800,2,20,22,10,8,4,1,7,22,2018/2019
"Burton,Deonte",33,82,.402,8,27,.296,25,55,.455,8,12,.667,4,24,28,9,6,9,8,31,82,2018/2019
"Butler,Jimmy",418,904,.462,67,193,.347,351,711,.494,312,365,.855,121,221,342,263,123,95,39,111,1215,2018/2019
"Butler,Jimmy",74,157,.471,17,45,.378,57,112,.509,48,61,.787,16,36,52,43,24,14,10,18,213,2018/2019
"Butler,Jimmy",344,747,.461,50,148,.338,294,599,.491,264,304,.868,105,185,290,220,99,81,29,93,1002,2018/2019
"Caboclo,Bruno",96,225,.427,48,130,.369,48,95,.505,42,50,.840,42,116,158,50,14,38,33,81,282,2018/2019
"Calderón,José",45,120,.375,14,57,.246,31,63,.492,9,11,.818,11,49,60,115,16,35,3,64,113,2018/2019
"Caldwell-Pope,Kentavious",325,756,.430,151,435,.347,174,321,.542,137,158,.867,48,190,238,110,73,65,13,137,938,2018/2019
"Canaan,Isaiah",64,164,.390,34,96,.354,30,68,.441,19,24,.792,6,52,58,84,14,35,2,52,181,2018/2019
"Canaan,Isaiah",51,129,.395,25,72,.347,26,57,.456,15,20,.750,5,44,49,62,12,29,0,46,142,2018/2019
"Canaan,Isaiah",11,29,.379,7,19,.368,4,10,.400,4,4,1.000,0,5,5,19,2,4,1,4,33,2018/2019
"Canaan,Isaiah",2,6,.333,2,5,.400,0,1,.000,0,0,,1,3,4,3,0,2,1,2,6,2018/2019
"Capela,Clint",474,732,.648,0,0,,474,732,.648,166,261,.636,298,550,848,96,44,94,102,168,1114,2018/2019
"Carroll,DeMarre",227,575,.395,106,310,.342,121,265,.457,184,242,.760,68,281,349,85,31,73,10,114,744,2018/2019
"Carter,Jevon",56,185,.303,34,102,.333,22,83,.265,26,32,.813,14,52,66,69,26,33,11,55,172,2018/2019
"Carter,Vince",196,468,.419,123,316,.389,73,152,.480,47,66,.712,31,163,194,87,44,48,27,141,562,2018/2019
"Carter,Wendell",180,371,.485,6,32,.188,174,339,.513,89,112,.795,87,220,307,78,26,65,58,152,455,2018/2019
"Carter-Williams,Michael",46,123,.374,10,38,.263,36,85,.424,32,53,.604,19,51,70,70,20,20,15,48,134,2018/2019
"Carter-Williams,Michael",25,61,.410,7,19,.368,18,42,.429,12,26,.462,3,10,13,21,9,10,6,27,69,2018/2019
"Carter-Williams,Michael",21,62,.339,3,19,.158,18,43,.419,20,27,.741,16,41,57,49,11,10,9,21,65,2018/2019
"Caruso,Alex",77,173,.445,24,50,.480,53,123,.431,51,64,.797,20,47,67,77,24,42,9,54,229,2018/2019
"Casspi,Omri",86,161,.534,15,43,.349,71,118,.602,39,58,.672,17,98,115,26,20,23,9,35,226,2018/2019
"Cauley-Stein,Willie",412,741,.556,1,2,.500,411,739,.556,140,254,.551,181,497,678,194,96,84,51,227,965,2018/2019
"Caupain,Troy",4,8,.500,2,3,.667,2,5,.400,0,0,,1,2,3,4,1,0,0,0,10,2018/2019
"Cavanaugh,Tyler",3,10,.300,1,5,.200,2,5,.400,2,2,1.000,3,5,8,1,0,1,0,3,9,2018/2019
"Chandler,Tyson",61,99,.616,0,1,.000,61,98,.622,51,87,.586,92,215,307,37,21,42,23,110,173,2018/2019
"Chandler,Tyson",8,12,.667,0,0,,8,12,.667,10,18,.556,7,32,39,6,2,7,1,21,26,2018/2019
"Chandler,Tyson",53,87,.609,0,1,.000,53,86,.616,41,69,.594,85,183,268,31,19,35,22,89,147,2018/2019
"Chandler,Wilson",114,273,.418,59,158,.373,55,115,.478,18,25,.720,48,167,215,82,25,46,21,123,305,2018/2019
"Chandler,Wilson",91,207,.440,46,118,.390,45,89,.506,13,18,.722,44,124,168,72,22,39,18,94,241,2018/2019
"Chandler,Wilson",23,66,.348,13,40,.325,10,26,.385,5,7,.714,4,43,47,10,3,7,3,29,64,2018/2019
"Chealey,Joe",1,3,.333,0,0,,1,3,.333,0,0,,0,0,0,1,0,0,0,1,2,2018/2019
"Chiozza,Chris",2,8,.250,2,5,.400,0,3,.000,0,0,,1,3,4,4,1,1,1,2,6,2018/2019
"Chriss,Marquese",67,180,.372,16,72,.222,51,108,.472,32,45,.711,40,102,142,22,17,36,11,81,182,2018/2019
"Chriss,Marquese",11,34,.324,1,15,.067,10,19,.526,6,7,.857,7,21,28,6,2,12,4,17,29,2018/2019
"Chriss,Marquese",56,146,.384,15,57,.263,41,89,.461,26,38,.684,33,81,114,16,15,24,7,64,153,2018/2019
"Clark,Gary",50,151,.331,41,138,.297,9,13,.692,7,7,1.000,24,92,116,18,20,7,26,47,148,2018/2019
"Clark,Ian",151,383,.394,66,202,.327,85,181,.470,33,37,.892,13,76,89,94,22,58,8,95,401,2018/2019
"Clarkson,Jordan",529,1180,.448,144,445,.324,385,735,.524,162,192,.844,82,188,270,196,57,135,13,112,1364,2018/2019
"Collins,John",465,831,.560,55,158,.348,410,673,.609,203,266,.763,219,376,595,121,22,120,39,199,1188,2018/2019
"Collins,Zach",189,400,.473,40,121,.331,149,279,.534,94,126,.746,109,215,324,71,25,77,66,174,512,2018/2019
"Collison,Darren",308,659,.467,79,194,.407,229,465,.492,158,190,.832,36,196,232,459,110,125,9,138,853,2018/2019
"Colson,Bonzie",13,39,.333,5,21,.238,8,18,.444,8,9,.889,8,22,30,3,5,3,1,3,39,2018/2019
"Conley,Mike",490,1120,.438,155,426,.364,335,694,.483,343,406,.845,40,199,239,449,94,130,22,123,1478,2018/2019
"Connaughton,Pat",163,350,.466,66,200,.330,97,150,.647,29,40,.725,61,197,258,122,33,33,25,81,421,2018/2019
"Cook,Quinn",204,439,.465,81,200,.405,123,239,.515,20,26,.769,22,135,157,116,20,50,3,92,509,2018/2019
"Cousins,DeMarcus",178,371,.480,26,95,.274,152,276,.551,106,144,.736,43,204,247,107,40,72,44,109,488,2018/2019
"Covington,Robert",156,362,.431,85,225,.378,71,137,.518,68,89,.764,28,165,193,46,74,47,47,126,465,2018/2019
"Covington,Robert",50,117,.427,30,77,.390,20,40,.500,17,23,.739,7,60,67,14,24,22,23,45,147,2018/2019
"Covington,Robert",106,245,.433,55,148,.372,51,97,.526,51,66,.773,21,105,126,32,50,25,24,81,318,2018/2019
"Crabbe,Allen",137,373,.367,98,259,.378,39,114,.342,41,56,.732,16,132,148,46,23,46,13,102,413,2018/2019
"Craig,Torrey",160,362,.442,61,188,.324,99,174,.569,49,70,.700,89,174,263,72,37,44,46,175,430,2018/2019
"Crawford,Jamal",174,438,.397,67,202,.332,107,236,.453,93,110,.845,8,77,85,229,33,99,12,75,508,2018/2019
"Creek,Mitch",8,16,.500,0,2,.000,8,14,.571,5,7,.714,6,6,12,6,2,1,0,3,21,2018/2019
"Creek,Mitch",5,10,.500,0,1,.000,5,9,.556,5,7,.714,5,5,10,5,1,0,0,3,15,2018/2019
"Creek,Mitch",3,6,.500,0,1,.000,3,5,.600,0,0,,1,1,2,1,1,1,0,0,6,2018/2019
"Crowder,Jae",318,797,.399,173,522,.331,145,275,.527,142,197,.721,60,324,384,133,64,85,31,170,951,2018/2019
"Cunningham,Dante",75,158,.475,30,65,.462,45,93,.484,14,18,.778,48,140,188,50,27,22,13,71,194,2018/2019
"Curry,Seth",212,465,.456,113,251,.450,99,214,.463,44,52,.846,27,93,120,66,36,61,12,97,581,2018/2019
"Curry,Stephen",632,1340,.472,354,810,.437,278,530,.525,263,287,.916,45,324,369,361,92,192,25,166,1881,2018/2019
"Daniels,Troy",113,275,.411,74,194,.381,39,81,.481,18,23,.783,13,60,73,26,26,27,5,79,318,2018/2019
"Davis,Anthony",530,1026,.517,48,145,.331,482,881,.547,344,433,.794,174,498,672,218,88,112,135,132,1452,2018/2019
"Davis,Deyonta",15,22,.682,0,1,.000,15,21,.714,6,10,.600,10,26,36,5,3,3,5,12,36,2018/2019
"Davis,Ed",186,302,.616,0,2,.000,186,300,.620,100,162,.617,216,478,694,61,35,64,33,226,472,2018/2019
"Davis,Tyler",0,1,.000,0,0,,0,1,.000,0,0,,1,0,1,0,0,0,0,0,0,2018/2019
"Dedmon,Dewayne",259,526,.492,83,217,.382,176,309,.570,92,113,.814,105,375,480,90,69,84,71,214,693,2018/2019
"Dekker,Sam",120,256,.469,19,62,.306,101,194,.521,28,46,.609,53,95,148,46,38,24,7,47,287,2018/2019
"Dekker,Sam",22,48,.458,5,13,.385,17,35,.486,8,10,.800,9,24,33,9,11,5,0,13,57,2018/2019
"Dekker,Sam",98,208,.471,14,49,.286,84,159,.528,20,36,.556,44,71,115,37,27,19,7,34,230,2018/2019
"Delgado,Ángel",1,5,.200,0,0,,1,5,.200,1,2,.500,2,2,4,0,1,0,0,2,3,2018/2019
"Dellavedova,Matthew",98,242,.405,44,130,.338,54,112,.482,42,52,.808,6,71,77,181,14,68,2,75,282,2018/2019
"Dellavedova,Matthew",6,19,.316,4,11,.364,2,8,.250,4,4,1.000,0,10,10,29,2,11,0,9,20,2018/2019
"Dellavedova,Matthew",92,223,.413,40,119,.336,52,104,.500,38,48,.792,6,61,67,152,12,57,2,66,262,2018/2019
"Deng,Luol",59,118,.500,14,44,.318,45,74,.608,25,35,.714,20,53,73,18,15,14,8,24,157,2018/2019
"DeRozan,DeMar",631,1313,.481,7,45,.156,624,1268,.492,366,441,.830,54,408,462,475,86,199,36,177,1635,2018/2019
"Derrickson,Marcus",16,33,.485,10,20,.500,6,13,.462,4,5,.800,8,5,13,1,0,3,1,9,46,2018/2019
"Diallo,Cheick",168,271,.620,1,4,.250,167,267,.625,50,67,.746,75,257,332,33,29,49,33,113,387,2018/2019
"Diallo,Hamidou",75,165,.455,4,24,.167,71,141,.504,36,59,.610,38,59,97,17,21,23,10,77,190,2018/2019
"Dieng,Gorgui",189,377,.501,19,56,.339,170,321,.530,88,106,.830,81,230,311,72,48,57,41,134,485,2018/2019
"Dinwiddie,Spencer",366,828,.442,124,370,.335,242,458,.528,287,356,.806,26,140,166,311,40,152,17,187,1143,2018/2019
"DiVincenzo,Donte",50,124,.403,22,83,.265,28,41,.683,9,12,.750,16,49,65,31,13,19,6,38,131,2018/2019
"Dončić,Luka",506,1186,.427,168,514,.327,338,672,.503,346,485,.713,86,477,563,429,77,247,25,137,1526,2018/2019
"Dorsey,Tyler",107,264,.405,44,132,.333,63,132,.477,38,61,.623,27,86,113,56,14,27,2,53,296,2018/2019
"Dorsey,Tyler",32,89,.360,10,39,.256,22,50,.440,16,26,.615,9,34,43,17,7,10,1,20,90,2018/2019
"Dorsey,Tyler",75,175,.429,34,93,.366,41,82,.500,22,35,.629,18,52,70,39,7,17,1,33,206,2018/2019
"Dotson,Damyean",290,698,.415,126,342,.368,164,356,.461,73,98,.745,34,228,262,135,58,71,10,135,779,2018/2019
"Dozier,PJ",8,21,.381,2,8,.250,6,13,.462,1,2,.500,6,11,17,5,2,0,0,2,19,2018/2019
"Dragić,Goran",179,433,.413,57,164,.348,122,269,.454,79,101,.782,20,91,111,174,30,71,5,81,494,2018/2019
"Drummond,Andre",561,1052,.533,5,38,.132,556,1014,.548,243,412,.590,423,809,1232,112,136,175,138,272,1370,2018/2019
"Dudley,Jared",101,239,.423,53,151,.351,48,88,.545,32,46,.696,34,121,155,83,36,43,16,131,287,2018/2019
"Dunn,Kris",215,506,.425,34,96,.354,181,410,.441,55,69,.797,19,168,187,277,68,104,21,166,519,2018/2019
"Durant,Kevin",721,1383,.521,137,388,.353,584,995,.587,448,506,.885,33,464,497,457,58,225,84,155,2027,2018/2019
"Duval,Trevon",2,3,.667,1,1,1.000,1,2,.500,0,0,,0,1,1,2,0,0,0,0,5,2018/2019
"Edwards,Vince",1,4,.250,1,4,.250,0,0,,0,0,,1,1,2,0,0,0,0,0,3,2018/2019
"Ellenson,Henry",39,95,.411,17,38,.447,22,57,.386,19,25,.760,5,61,66,16,7,9,2,27,114,2018/2019
"Ellenson,Henry",4,10,.400,2,4,.500,2,6,.333,2,2,1.000,0,9,9,1,0,0,0,2,12,2018/2019
"Ellenson,Henry",35,85,.412,15,34,.441,20,51,.392,17,23,.739,5,52,57,15,7,9,2,25,102,2018/2019
"Ellington,Wayne",184,457,.403,138,372,.371,46,85,.541,39,49,.796,14,93,107,72,54,40,6,92,545,2018/2019
"Ellington,Wayne",69,184,.375,57,155,.368,12,29,.414,14,16,.875,6,41,47,29,24,14,3,40,209,2018/2019
"Ellington,Wayne",115,273,.421,81,217,.373,34,56,.607,25,33,.758,8,52,60,43,30,26,3,52,336,2018/2019
"Embiid,Joel",580,1199,.484,79,263,.300,501,936,.535,522,649,.804,160,711,871,234,46,226,122,211,1761,2018/2019
"Ennis,James",138,294,.469,55,156,.353,83,138,.601,58,81,.716,60,122,182,41,41,34,23,150,389,2018/2019
"Ennis,James",104,211,.493,44,120,.367,60,91,.659,42,58,.724,37,80,117,27,38,23,16,111,294,2018/2019
"Ennis,James",34,83,.410,11,36,.306,23,47,.489,16,23,.696,23,42,65,14,3,11,7,39,95,2018/2019
"Eubanks,Drew",15,26,.577,0,0,,15,26,.577,11,13,.846,6,28,34,7,2,8,5,11,41,2018/2019
"Evans,Jacob",18,53,.340,4,15,.267,14,38,.368,0,1,.000,6,19,25,23,5,11,3,28,40,2018/2019
"Evans,Jawun",3,14,.214,0,3,.000,3,11,.273,0,0,,1,11,12,10,3,6,0,8,6,2018/2019
"Evans,Jawun",3,13,.231,0,2,.000,3,11,.273,0,0,,1,11,12,10,3,6,0,8,6,2018/2019
"Evans,Jawun",0,1,.000,0,1,.000,0,0,,0,0,,0,0,0,0,0,0,0,0,0,2018/2019
"Evans,Tyreke",257,660,.389,77,216,.356,180,444,.405,115,160,.719,33,168,201,166,58,118,18,117,706,2018/2019
"Exum,Dante",101,241,.419,18,62,.290,83,179,.464,68,86,.791,16,52,68,110,14,52,5,69,288,2018/2019
"Faried,Kenneth",156,265,.589,8,25,.320,148,240,.617,64,99,.646,97,153,250,20,17,33,23,82,384,2018/2019
"Faried,Kenneth",25,42,.595,1,5,.200,24,37,.649,10,16,.625,15,29,44,2,2,6,4,8,61,2018/2019
"Faried,Kenneth",131,223,.587,7,20,.350,124,203,.611,54,83,.651,82,124,206,18,15,27,19,74,323,2018/2019
"Favors,Derrick",363,619,.586,17,78,.218,346,541,.640,154,228,.675,207,353,560,89,56,84,106,163,897,2018/2019
"Felício,Cristiano",95,179,.531,0,4,.000,95,175,.543,50,73,.685,79,139,218,37,11,33,7,69,240,2018/2019
"Felton,Raymond",55,135,.407,20,61,.328,35,74,.473,12,13,.923,4,30,34,52,10,14,6,29,142,2018/2019
"Ferguson,Terrance",185,431,.429,106,290,.366,79,141,.560,37,51,.725,33,108,141,72,40,47,16,231,513,2018/2019
"Ferrell,Yogi",153,352,.435,54,149,.362,99,203,.488,60,67,.896,13,96,109,137,36,40,4,64,420,2018/2019
"Finney-Smith,Dorian",228,528,.432,79,254,.311,149,274,.544,73,103,.709,138,251,389,95,69,74,36,186,608,2018/2019
"Forbes,Bryn",361,791,.456,176,413,.426,185,378,.489,69,78,.885,18,221,239,175,45,80,4,159,967,2018/2019
"Fournier,Evan",468,1069,.438,153,450,.340,315,619,.509,137,170,.806,38,220,258,295,71,154,12,225,1226,2018/2019
"Fox,De'Aaron",505,1102,.458,86,232,.371,419,870,.482,303,417,.727,43,261,304,590,133,227,45,204,1399,2018/2019
"Frazier,Melvin",7,21,.333,0,6,.000,7,15,.467,1,4,.250,3,2,5,1,1,1,0,6,15,2018/2019
"Frazier,Tim",116,261,.444,37,101,.366,79,160,.494,41,54,.759,41,127,168,248,30,76,5,112,310,2018/2019
"Frazier,Tim",88,195,.451,27,77,.351,61,118,.517,32,41,.780,32,105,137,206,25,60,4,93,235,2018/2019
"Frazier,Tim",28,66,.424,10,24,.417,18,42,.429,9,13,.692,9,22,31,42,5,16,1,19,75,2018/2019
"Fredette,Jimmer",8,29,.276,0,13,.000,8,16,.500,6,6,1.000,1,6,7,8,3,5,0,5,22,2018/2019
"Frye,Channing",43,117,.368,32,79,.405,11,38,.289,11,14,.786,4,48,52,20,6,13,5,44,129,2018/2019
"Fultz,Markelle",65,155,.419,4,14,.286,61,141,.433,21,37,.568,26,44,70,59,17,25,5,52,155,2018/2019
"Gallinari,Danilo",409,884,.463,161,372,.433,248,512,.484,367,406,.904,54,363,417,178,49,99,23,129,1346,2018/2019
"Galloway,Langston",228,587,.388,135,380,.355,93,207,.449,81,96,.844,49,122,171,85,37,24,8,135,672,2018/2019
"Garrett,Billy",11,27,.407,0,8,.000,11,19,.579,4,4,1.000,0,3,3,7,1,2,1,3,26,2018/2019
"Gasol,Marc",390,870,.448,99,273,.363,291,597,.487,192,253,.759,80,547,627,349,84,155,86,217,1071,2018/2019
"Gasol,Marc",303,683,.444,76,221,.344,227,462,.491,152,201,.756,56,399,455,248,60,119,63,147,834,2018/2019
"Gasol,Marc",87,187,.465,23,52,.442,64,135,.474,40,52,.769,24,148,172,101,24,36,23,70,237,2018/2019
"Gasol,Pau",42,94,.447,6,13,.462,36,81,.444,28,40,.700,22,115,137,52,5,16,15,29,118,2018/2019
"Gasol,Pau",41,88,.466,5,10,.500,36,78,.462,27,38,.711,22,105,127,50,5,14,14,28,114,2018/2019
"Gasol,Pau",1,6,.167,1,3,.333,0,3,.000,1,2,.500,0,10,10,2,0,2,1,1,4,2018/2019
"Gay,Rudy",376,746,.504,74,184,.402,302,562,.537,120,147,.816,63,407,470,182,54,114,34,159,946,2018/2019
"George,Paul",707,1614,.438,292,757,.386,415,857,.484,453,540,.839,105,523,628,318,170,205,34,214,2159,2018/2019
"Gibson,Taj",304,537,.566,11,34,.324,293,503,.583,134,177,.757,172,286,458,84,53,73,39,186,753,2018/2019
"Giles,Harry",175,348,.503,0,6,.000,175,342,.512,58,91,.637,66,156,222,85,31,73,22,150,408,2018/2019
"Gilgeous-Alexander,Shai",341,716,.476,51,139,.367,290,577,.503,156,195,.800,57,175,232,270,96,141,45,175,889,2018/2019
"Gobert,Rudy",476,712,.669,0,0,,476,712,.669,332,522,.636,309,732,1041,161,66,130,187,231,1284,2018/2019
"Goodwin,Brandon",6,23,.261,2,6,.333,4,17,.235,9,11,.818,1,2,3,14,0,3,0,7,23,2018/2019
"Gordon,Aaron",470,1046,.449,121,347,.349,349,699,.499,185,253,.731,129,445,574,289,57,162,56,172,1246,2018/2019
"Gordon,Eric",384,938,.409,216,600,.360,168,338,.497,119,152,.783,17,131,148,129,41,90,27,143,1103,2018/2019
"Gortat,Marcin",99,186,.532,0,0,,99,186,.532,35,48,.729,67,194,261,65,6,50,24,92,233,2018/2019
"Graham,Devonte'",74,216,.343,34,121,.281,40,95,.421,35,46,.761,10,53,63,121,23,30,2,48,217,2018/2019
"Graham,Treveon",64,191,.335,38,128,.297,26,63,.413,18,22,.818,23,84,107,34,13,17,7,68,184,2018/2019
"Grant,Jerami",409,823,.497,115,293,.392,294,530,.555,157,221,.710,96,321,417,79,61,67,100,214,1090,2018/2019
"Grant,Jerian",92,220,.418,40,110,.364,52,110,.473,26,40,.650,19,79,98,156,44,51,6,78,250,2018/2019
"Grantham,Donte",0,2,.000,0,2,.000,0,0,,0,0,,0,0,0,0,0,0,0,0,0,2018/2019
"Green,Danny",293,630,.465,198,435,.455,95,195,.487,37,44,.841,60,257,317,126,73,75,53,171,821,2018/2019
"Green,Draymond",188,422,.445,47,165,.285,141,257,.549,63,91,.692,60,421,481,454,95,169,70,197,486,2018/2019
"Green,Gerald",231,578,.400,156,441,.354,75,137,.547,57,68,.838,30,152,182,40,33,55,27,126,675,2018/2019
"Green,JaMychal",230,476,.483,71,176,.403,159,300,.530,80,101,.792,104,305,409,50,45,87,34,193,611,2018/2019
"Green,JaMychal",151,312,.484,38,96,.396,113,216,.523,63,80,.788,72,180,252,36,33,64,26,123,403,2018/2019
"Green,JaMychal",79,164,.482,33,80,.413,46,84,.548,17,21,.810,32,125,157,14,12,23,8,70,208,2018/2019
"Green,Jeff",326,687,.475,111,320,.347,215,367,.586,183,206,.888,57,252,309,137,43,101,39,160,946,2018/2019
"Griffin,Blake",619,1341,.462,189,522,.362,430,819,.525,414,550,.753,100,465,565,402,52,253,28,199,1841,2018/2019
"Hamilton,Daniel",23,60,.383,8,23,.348,15,37,.405,3,6,.500,10,37,47,22,6,16,1,19,57,2018/2019
"Hannahs,Dusty",3,12,.250,0,5,.000,3,7,.429,2,2,1.000,0,1,1,5,1,1,0,1,8,2018/2019
"Hardaway,Tim",390,993,.393,162,477,.340,228,516,.442,232,276,.841,33,189,222,159,54,105,8,141,1174,2018/2019
"Hardaway,Tim",282,726,.388,117,337,.347,165,389,.424,199,233,.854,26,135,161,122,42,81,6,106,880,2018/2019
"Hardaway,Tim",108,267,.404,45,140,.321,63,127,.496,33,43,.767,7,54,61,37,12,24,2,35,294,2018/2019
"Harden,James",843,1909,.442,378,1028,.368,465,881,.528,754,858,.879,66,452,518,586,158,387,58,244,2818,2018/2019
"Harkless,Maurice",189,388,.487,33,120,.275,156,268,.582,49,73,.671,77,192,269,74,67,45,53,163,460,2018/2019
"Harrell,Montrezl",546,888,.615,3,17,.176,543,871,.623,266,414,.643,184,351,535,162,71,132,110,255,1361,2018/2019
"Harris,Devin",132,347,.380,62,200,.310,70,147,.476,102,134,.761,12,100,112,122,35,56,16,133,428,2018/2019
"Harris,Gary",270,637,.424,82,242,.339,188,395,.476,115,144,.799,41,119,160,127,55,68,19,113,737,2018/2019
"Harris,Joe",374,748,.500,183,386,.474,191,362,.528,110,133,.827,52,239,291,181,38,121,17,182,1041,2018/2019
"Harris,Tobias",611,1254,.487,156,393,.397,455,861,.528,266,307,.866,69,576,645,229,51,151,37,184,1644,2018/2019
"Harris,Tobias",424,855,.496,112,258,.434,312,597,.523,192,219,.877,37,395,432,150,40,109,24,123,1152,2018/2019
"Harris,Tobias",187,399,.469,44,135,.326,143,264,.542,74,88,.841,32,181,213,79,11,42,13,61,492,2018/2019
"Harrison,Andrew",16,53,.302,5,25,.200,11,28,.393,17,18,.944,6,14,20,24,4,12,2,34,54,2018/2019
"Harrison,Andrew",1,2,.500,0,1,.000,1,1,1.000,0,0,,0,0,0,0,0,0,0,1,2,2018/2019
"Harrison,Andrew",12,39,.308,3,14,.214,9,25,.360,16,16,1.000,4,11,15,17,4,10,2,26,43,2018/2019
"Harrison,Andrew",3,12,.250,2,10,.200,1,2,.500,1,2,.500,2,3,5,7,0,2,0,7,9,2018/2019
"Harrison,Shaquille",184,426,.432,24,89,.270,160,337,.475,82,123,.667,33,189,222,139,89,60,30,124,474,2018/2019
"Hart,Josh",189,464,.407,92,274,.336,97,190,.511,55,80,.688,35,213,248,93,64,58,40,147,525,2018/2019
"Hartenstein,Isaiah",20,41,.488,2,6,.333,18,35,.514,11,14,.786,21,26,47,15,7,13,12,56,53,2018/2019
"Haslem,Udonis",11,33,.333,0,12,.000,11,21,.524,3,4,.750,3,24,27,2,0,3,0,9,25,2018/2019
"Hayward,Gordon",296,635,.466,77,231,.333,219,404,.542,156,187,.834,51,271,322,244,62,105,23,104,825,2018/2019
"Henson,John",31,67,.463,11,31,.355,20,36,.556,6,10,.600,16,55,71,14,7,12,11,16,79,2018/2019
"Hernangómez,Juan",138,314,.439,66,181,.365,72,133,.541,66,86,.767,64,201,265,55,27,37,24,94,408,2018/2019
"Hernangómez,Willy",153,295,.519,15,39,.385,138,256,.539,100,144,.694,117,194,311,60,16,58,20,98,421,2018/2019
"Hezonja,Mario",191,464,.412,42,152,.276,149,312,.478,87,114,.763,28,211,239,88,57,88,8,110,511,2018/2019
"Hicks,Isaiah",4,8,.500,0,0,,4,8,.500,4,5,.800,2,5,7,2,1,1,3,5,12,2018/2019
"Hield,Buddy",623,1360,.458,278,651,.427,345,709,.487,171,193,.886,106,306,412,205,58,146,33,202,1695,2018/2019
"Highsmith,Haywood",4,10,.400,1,5,.200,3,5,.600,0,2,.000,0,5,5,2,1,1,0,1,9,2018/2019
"Hilário,Nenê",60,116,.517,0,3,.000,60,113,.531,31,47,.660,34,89,123,26,18,11,15,87,151,2018/2019
"Hill,George",170,376,.452,48,153,.314,122,223,.547,70,85,.824,39,109,148,135,52,51,8,102,458,2018/2019
"Hill,George",55,107,.514,13,28,.464,42,79,.532,17,20,.850,12,15,27,36,12,20,1,35,140,2018/2019
"Hill,George",115,269,.428,35,125,.280,80,144,.556,53,65,.815,27,94,121,99,40,31,7,67,318,2018/2019
"Hill,Solomon",68,178,.382,32,101,.317,36,77,.468,23,32,.719,34,99,133,55,23,31,10,80,191,2018/2019
"Holiday,Aaron",105,262,.401,43,127,.339,62,135,.459,41,50,.820,5,62,67,87,21,40,13,71,294,2018/2019
"Holiday,Jrue",547,1159,.472,118,363,.325,429,796,.539,208,271,.768,75,259,334,518,109,210,54,148,1420,2018/2019
"Holiday,Justin",300,777,.386,162,465,.348,138,312,.442,95,106,.896,46,277,323,146,121,104,36,164,857,2018/2019
"Holiday,Justin",151,394,.383,97,270,.359,54,124,.435,41,46,.891,19,150,169,85,67,47,21,79,440,2018/2019
"Holiday,Justin",149,383,.389,65,195,.333,84,188,.447,54,60,.900,27,127,154,61,54,57,15,85,417,2018/2019
"Holland,John",0,0,,0,0,,0,0,,0,0,,0,0,0,0,0,0,0,0,0,2018/2019
"Hollis-Jefferson,Rondae",200,487,.411,9,49,.184,191,438,.436,118,183,.645,83,227,310,96,44,68,27,107,527,2018/2019
"Holmes,Richaun",222,365,.608,0,0,,222,365,.608,128,175,.731,115,216,331,60,42,52,79,194,572,2018/2019
"Hood,Rodney",292,671,.435,84,236,.356,208,435,.478,137,155,.884,25,132,157,126,59,55,12,146,805,2018/2019
"Hood,Rodney",194,454,.427,55,152,.362,139,302,.460,104,114,.912,18,94,112,92,38,36,5,101,547,2018/2019
"Hood,Rodney",98,217,.452,29,84,.345,69,133,.519,33,41,.805,7,38,45,34,21,19,7,45,258,2018/2019
"Horford,Al",387,723,.535,73,203,.360,314,520,.604,78,95,.821,120,338,458,283,59,102,86,126,925,2018/2019
"House,Danuel",118,252,.468,74,178,.416,44,74,.595,56,71,.789,25,115,140,40,21,35,11,80,366,2018/2019
"Howard,Dwight",43,69,.623,0,0,,43,69,.623,29,48,.604,24,59,83,4,7,16,4,34,115,2018/2019
"Huerter,Kevin",275,657,.419,136,353,.385,139,304,.457,41,56,.732,60,185,245,214,65,109,25,155,727,2018/2019
"Humphries,Isaac",6,21,.286,3,11,.273,3,10,.300,0,0,,4,7,11,0,1,0,0,7,15,2018/2019
"Hunter,R.J.",6,13,.462,4,10,.400,2,3,.667,1,2,.500,1,2,3,3,1,0,0,3,17,2018/2019
"Hutchison,Chandler",96,209,.459,14,50,.280,82,159,.516,23,38,.605,31,154,185,34,23,25,6,59,229,2018/2019
"Ibaka,Serge",464,877,.529,49,169,.290,415,708,.586,135,177,.763,156,445,601,99,29,114,103,211,1112,2018/2019
"Iguodala,Andre",151,302,.500,48,144,.333,103,158,.652,39,67,.582,48,204,252,216,61,52,51,95,389,2018/2019
"İlyasova,Ersan",167,381,.438,58,160,.363,109,221,.493,61,74,.824,94,208,302,52,32,48,20,172,453,2018/2019
"Ingles,Joe",359,802,.448,189,483,.391,170,319,.533,87,123,.707,35,295,330,469,98,193,20,180,994,2018/2019
"Ingram,Andre",0,6,.000,0,3,.000,0,3,.000,0,0,,1,1,2,0,1,1,0,0,0,2018/2019
"Ingram,Brandon",362,729,.497,31,94,.330,331,635,.521,195,289,.675,41,226,267,154,28,129,31,149,950,2018/2019
"Irving,Kyrie",604,1241,.487,174,434,.401,430,807,.533,214,245,.873,71,264,335,464,103,172,34,167,1596,2018/2019
"Isaac,Jonathan",262,611,.429,86,266,.323,176,345,.510,110,135,.815,99,312,411,80,59,75,98,143,720,2018/2019
"Iwundu,Wesley",113,274,.412,29,79,.367,84,195,.431,84,103,.816,37,147,184,73,28,44,22,123,339,2018/2019
"Jackson,Demetrius",8,15,.533,2,6,.333,6,9,.667,4,4,1.000,2,1,3,5,2,1,0,4,22,2018/2019
"Jackson,Frank",194,447,.434,53,169,.314,141,278,.507,54,73,.740,25,109,134,69,25,48,2,92,495,2018/2019
"Jackson,Jaren",298,589,.506,51,142,.359,247,447,.553,151,197,.766,73,199,272,64,52,98,82,220,798,2018/2019
"Jackson,Josh",347,841,.413,73,225,.324,274,616,.445,143,213,.671,66,281,347,183,74,173,56,209,910,2018/2019
"Jackson,Justin",217,485,.447,87,245,.355,130,240,.542,62,79,.785,44,168,212,96,32,29,14,99,583,2018/2019
"Jackson,Justin",125,295,.424,55,159,.346,70,136,.515,41,50,.820,25,121,146,68,23,22,13,67,346,2018/2019
"Jackson,Justin",92,190,.484,32,86,.372,60,104,.577,21,29,.724,19,47,66,28,9,7,1,32,237,2018/2019
"Jackson,Reggie",441,1047,.421,174,471,.369,267,576,.464,204,236,.864,45,171,216,344,55,148,9,208,1260,2018/2019
"James,LeBron",558,1095,.510,111,327,.339,447,768,.582,278,418,.665,57,408,465,454,72,197,33,94,1505,2018/2019
"Jefferson,Amile",10,16,.625,0,0,,10,16,.625,7,8,.875,6,15,21,3,3,1,3,8,27,2018/2019
"Jenkins,John",42,105,.400,22,58,.379,20,47,.426,15,18,.833,6,31,37,22,0,9,2,10,121,2018/2019
"Jenkins,John",2,2,1.000,2,2,1.000,0,0,,0,0,,0,1,1,1,0,0,0,0,6,2018/2019
"Jenkins,John",40,103,.388,20,56,.357,20,47,.426,15,18,.833,6,30,36,21,0,9,2,10,115,2018/2019
"Jerebko,Jonas",163,355,.459,69,188,.367,94,167,.563,64,80,.800,72,216,288,96,27,43,18,137,459,2018/2019
"Johnson,Alize",4,16,.250,1,2,.500,3,14,.214,4,8,.500,4,15,19,1,1,0,3,7,13,2018/2019
"Johnson,Amir",79,157,.503,12,40,.300,67,117,.573,31,41,.756,47,100,147,60,16,45,13,99,201,2018/2019
"Johnson,B.J.",9,18,.500,3,7,.429,6,11,.545,2,2,1.000,2,6,8,0,2,2,0,4,23,2018/2019
"Johnson,B.J.",8,16,.500,3,6,.500,5,10,.500,2,2,1.000,2,6,8,0,2,2,0,3,21,2018/2019
"Johnson,B.J.",1,2,.500,0,1,.000,1,1,1.000,0,0,,0,0,0,0,0,0,0,1,2,2018/2019
"Johnson,James",164,379,.433,50,149,.336,114,230,.496,50,70,.714,22,154,176,135,35,74,27,114,428,2018/2019
"Johnson,Stanley",171,440,.389,62,215,.288,109,225,.484,50,64,.781,34,183,217,88,60,81,14,114,454,2018/2019
"Johnson,Stanley",133,349,.381,51,181,.282,82,168,.488,41,51,.804,25,150,175,60,48,55,13,92,358,2018/2019
"Johnson,Stanley",38,91,.418,11,34,.324,27,57,.474,9,13,.692,9,33,42,28,12,26,1,22,96,2018/2019
"Johnson,Tyler",217,526,.413,90,260,.346,127,266,.477,95,127,.748,34,139,173,166,54,77,27,97,619,2018/2019
"Johnson,Tyler",171,401,.426,72,204,.353,99,197,.503,61,88,.693,19,102,121,112,40,63,21,72,475,2018/2019
"Johnson,Tyler",46,125,.368,18,56,.321,28,69,.406,34,39,.872,15,37,52,54,14,14,6,25,144,2018/2019
"Johnson,Wesley",45,128,.352,25,76,.329,20,52,.385,13,19,.684,12,60,72,23,14,18,12,63,128,2018/2019
"Johnson,Wesley",35,88,.398,19,50,.380,16,38,.421,6,9,.667,10,44,54,16,12,12,7,45,95,2018/2019
"Johnson,Wesley",10,40,.250,6,26,.231,4,14,.286,7,10,.700,2,16,18,7,2,6,5,18,33,2018/2019
"Jokić,Nikola",616,1206,.511,83,270,.307,533,936,.569,289,352,.821,228,637,865,580,108,248,55,228,1604,2018/2019
"Jones,Damian",53,74,.716,0,0,,53,74,.716,24,37,.649,31,44,75,28,12,16,25,63,130,2018/2019
"Jones,Derrick",160,324,.494,28,91,.308,132,233,.567,74,122,.607,96,144,240,37,46,43,42,123,422,2018/2019
"Jones,Jalen",26,62,.419,10,28,.357,16,34,.471,19,27,.704,11,23,34,7,9,8,2,27,81,2018/2019
"Jones,Jemerrio",12,33,.364,2,10,.200,10,23,.435,1,2,.500,16,33,49,13,7,5,5,10,27,2018/2019
"Jones,Terrence",1,4,.250,0,2,.000,1,2,.500,0,1,.000,0,4,4,0,0,1,0,1,2,2018/2019
"Jones,Tyus",185,446,.415,40,126,.317,145,320,.453,58,69,.841,23,111,134,327,81,47,5,78,468,2018/2019
"Jordan,DeAndre",286,446,.641,0,0,,286,446,.641,186,264,.705,225,677,902,156,42,153,73,167,758,2018/2019
"Jordan,DeAndre",208,323,.644,0,0,,208,323,.644,135,198,.682,161,525,686,99,33,111,53,125,551,2018/2019
"Jordan,DeAndre",78,123,.634,0,0,,78,123,.634,51,66,.773,64,152,216,57,9,42,20,42,207,2018/2019
"Joseph,Cory",226,548,.412,55,171,.322,171,377,.454,30,43,.698,39,240,279,321,94,80,22,131,537,2018/2019
"Kaminsky,Frank",138,298,.463,50,139,.360,88,159,.553,79,107,.738,39,124,163,63,12,41,12,68,405,2018/2019
"Kanter,Enes",375,683,.549,10,34,.294,365,649,.562,155,197,.787,257,402,659,116,32,118,26,167,915,2018/2019
"Kanter,Enes",251,468,.536,7,22,.318,244,446,.547,105,129,.814,171,290,461,84,18,79,17,106,614,2018/2019
"Kanter,Enes",124,215,.577,3,12,.250,121,203,.596,50,68,.735,86,112,198,32,14,39,9,61,301,2018/2019
"Kennard,Luke",228,520,.438,106,269,.394,122,251,.486,51,61,.836,12,171,183,114,26,57,10,92,613,2018/2019
"Kidd-Gilchrist,Michael",158,332,.476,16,47,.340,142,285,.498,95,123,.772,88,158,246,61,32,43,39,156,427,2018/2019
"King,George",0,0,,0,0,,0,0,,0,0,,0,1,1,0,0,0,0,0,0,2018/2019
"Kleber,Maxi",175,386,.453,77,218,.353,98,168,.583,58,74,.784,90,239,329,70,36,54,78,143,485,2018/2019
"Knight,Brandon",99,260,.381,41,129,.318,58,131,.443,27,34,.794,10,49,59,71,21,30,2,62,266,2018/2019
"Knight,Brandon",11,47,.234,5,32,.156,6,15,.400,9,11,.818,1,8,9,9,2,5,0,14,36,2018/2019
"Knight,Brandon",88,213,.413,36,97,.371,52,116,.448,18,23,.783,9,41,50,62,19,25,2,48,230,2018/2019
"Knox,Kevin",338,914,.370,125,364,.343,213,550,.387,162,226,.717,61,274,335,82,43,114,24,175,963,2018/2019
"Korkmaz,Furkan",98,245,.400,47,144,.326,51,101,.505,36,44,.818,16,91,107,52,29,25,2,62,279,2018/2019
"Kornet,Luke",107,283,.378,70,193,.363,37,90,.411,38,46,.826,28,107,135,54,27,25,42,41,322,2018/2019
"Korver,Kyle",201,483,.416,138,348,.397,63,135,.467,60,73,.822,9,153,162,81,25,59,12,106,600,2018/2019
"Korver,Kyle",35,76,.461,25,54,.463,10,22,.455,13,16,.813,0,29,29,17,3,17,2,22,108,2018/2019
"Korver,Kyle",166,407,.408,113,294,.384,53,113,.469,47,57,.825,9,124,133,64,22,42,10,84,492,2018/2019
"Koufos,Kosta",73,153,.477,0,0,,73,153,.477,10,24,.417,52,125,177,36,15,27,18,68,156,2018/2019
"Kurucs,Rodions",202,449,.450,58,184,.315,144,265,.543,72,92,.783,56,190,246,52,41,77,25,146,534,2018/2019
"Kuzma,Kyle",496,1087,.456,128,422,.303,368,665,.553,188,250,.752,60,322,382,178,41,133,26,170,1308,2018/2019
"Labissière,Skal",26,49,.531,6,13,.462,20,36,.556,9,17,.529,9,34,43,11,5,11,6,29,67,2018/2019
"Labissière,Skal",13,30,.433,4,11,.364,9,19,.474,6,11,.545,4,20,24,6,2,7,3,21,36,2018/2019
"Labissière,Skal",13,19,.684,2,2,1.000,11,17,.647,3,6,.500,5,14,19,5,3,4,3,8,31,2018/2019
"Lamb,Jeremy",431,979,.440,115,330,.348,316,649,.487,231,260,.888,65,369,434,172,88,80,32,140,1208,2018/2019
"LaVine,Zach",530,1135,.467,120,321,.374,410,814,.504,312,375,.832,40,254,294,283,60,215,26,140,1492,2018/2019
"Layman,Jake",216,424,.509,59,181,.326,157,243,.646,50,71,.704,56,161,217,53,31,46,30,116,541,2018/2019
"Leaf,T.J.",99,183,.541,8,31,.258,91,152,.599,19,31,.613,43,82,125,24,9,12,19,35,225,2018/2019
"Lee,Courtney",53,129,.411,16,55,.291,37,74,.500,14,21,.667,9,45,54,37,21,14,3,32,136,2018/2019
"Lee,Courtney",21,47,.447,5,16,.313,16,31,.516,9,14,.643,6,21,27,16,8,5,2,13,56,2018/2019
"Lee,Courtney",32,82,.390,11,39,.282,21,43,.488,5,7,.714,3,24,27,21,13,9,1,19,80,2018/2019
"Lee,Damion",56,127,.441,27,68,.397,29,59,.492,19,22,.864,8,56,64,13,13,11,0,28,158,2018/2019
"Lemon,Walt",38,87,.437,2,5,.400,36,82,.439,8,11,.727,4,23,27,30,11,10,1,14,86,2018/2019
"Len,Alex",320,648,.494,74,204,.363,246,444,.554,140,216,.648,158,266,424,86,27,97,69,200,854,2018/2019
"Leonard,Kawhi",560,1129,.496,112,302,.371,448,827,.542,364,426,.854,78,361,439,199,106,121,24,87,1596,2018/2019
"Leonard,Meyers",132,242,.545,50,111,.450,82,131,.626,43,51,.843,49,184,233,75,13,43,9,105,357,2018/2019
"Leuer,Jon",66,113,.584,1,11,.091,65,102,.637,23,31,.742,27,70,97,14,12,23,4,60,156,2018/2019
"LeVert,Caris",207,483,.429,48,154,.312,159,329,.483,85,123,.691,35,116,151,156,42,69,14,77,547,2018/2019
"Lillard,Damian",681,1533,.444,237,643,.369,444,890,.499,468,513,.912,68,303,371,551,88,212,34,148,2067,2018/2019
"Lin,Jeremy",238,541,.440,55,187,.294,183,354,.517,176,210,.838,22,157,179,231,47,124,13,144,707,2018/2019
"Lin,Jeremy",180,386,.466,44,132,.333,136,254,.535,142,168,.845,16,103,119,181,38,98,7,96,546,2018/2019
"Lin,Jeremy",58,155,.374,11,55,.200,47,100,.470,34,42,.810,6,54,60,50,9,26,6,48,161,2018/2019
"Livingston,Shaun",109,210,.519,0,2,.000,109,208,.524,40,51,.784,42,75,117,114,31,38,27,74,258,2018/2019
"Lofton,Zach",0,1,.000,0,1,.000,0,0,,0,0,,0,0,0,0,1,1,0,0,0,2018/2019
"Looney,Kevon",217,347,.625,1,10,.100,216,337,.641,65,105,.619,194,223,417,123,46,51,53,211,500,2018/2019
"Lopez,Brook",355,786,.452,187,512,.365,168,274,.613,112,133,.842,33,363,396,98,51,82,179,189,1009,2018/2019
"Lopez,Robin",304,535,.568,7,31,.226,297,504,.589,89,123,.724,140,146,286,89,11,96,78,124,704,2018/2019
"Love,Kevin",109,283,.385,53,147,.361,56,136,.412,103,114,.904,33,206,239,48,6,42,5,54,374,2018/2019
"Lowry,Kyle",304,739,.411,157,453,.347,147,286,.514,161,194,.830,41,271,312,564,91,182,31,166,926,2018/2019
"Loyd,Jordan",8,18,.444,4,8,.500,4,10,.400,9,11,.818,1,8,9,6,0,2,0,5,29,2018/2019
"Lucas,Kalin",0,1,.000,0,1,.000,0,0,,2,2,1.000,0,3,3,1,0,0,0,1,2,2018/2019
"Luwawu-Cabarrot,Timothé",82,218,.376,36,116,.310,46,102,.451,31,41,.756,11,86,97,26,19,21,8,73,231,2018/2019
"Luwawu-Cabarrot,Timothé",13,43,.302,5,22,.227,8,21,.381,4,6,.667,4,14,18,4,4,5,1,14,35,2018/2019
"Luwawu-Cabarrot,Timothé",69,175,.394,31,94,.330,38,81,.469,27,35,.771,7,72,79,22,15,16,7,59,196,2018/2019
"Lydon,Tyler",9,18,.500,4,10,.400,5,8,.625,1,3,.333,7,11,18,6,2,4,0,10,23,2018/2019
"Lyles,Trey",207,495,.418,51,200,.255,156,295,.529,81,116,.698,44,202,246,87,30,68,23,93,546,2018/2019
"Machado,Scott",4,6,.667,1,1,1.000,3,5,.600,1,1,1.000,0,0,0,3,1,0,0,2,10,2018/2019
"Mack,Shelvin",163,403,.404,46,130,.354,117,273,.429,58,84,.690,18,86,104,183,47,66,4,84,430,2018/2019
"Mack,Shelvin",161,389,.414,46,128,.359,115,261,.441,53,75,.707,18,84,102,182,45,62,4,81,421,2018/2019
"Mack,Shelvin",2,14,.143,0,2,.000,2,12,.167,5,9,.556,0,2,2,1,2,4,0,3,9,2018/2019
"Macon,Daryl",10,27,.370,5,11,.455,5,16,.313,4,7,.571,2,10,12,7,1,6,0,8,29,2018/2019
"Macura,J.P.",3,9,.333,0,4,.000,3,5,.600,0,0,,0,3,3,2,0,0,0,0,6,2018/2019
"Mahinmi,Ian",47,104,.452,3,16,.188,44,88,.500,42,61,.689,48,80,128,25,25,21,16,84,139,2018/2019
"Maker,Thon",109,268,.407,49,153,.320,60,115,.522,56,84,.667,41,161,202,45,21,33,51,105,323,2018/2019
"Maker,Thon",59,134,.440,26,78,.333,33,56,.589,20,37,.541,17,79,96,18,10,9,18,55,164,2018/2019
"Maker,Thon",50,134,.373,23,75,.307,27,59,.458,36,47,.766,24,82,106,27,11,24,33,50,159,2018/2019
"Marjanović,Boban",160,260,.615,4,10,.400,156,250,.624,98,131,.748,87,178,265,54,16,59,27,90,422,2018/2019
"Marjanović,Boban",85,140,.607,0,2,.000,85,138,.616,72,95,.758,55,97,152,22,11,37,17,57,242,2018/2019
"Marjanović,Boban",75,120,.625,4,8,.500,71,112,.634,26,36,.722,32,81,113,32,5,22,10,33,180,2018/2019
"Markkanen,Lauri",342,795,.430,120,332,.361,222,463,.479,170,195,.872,74,396,470,75,37,85,33,122,974,2018/2019
"Martin,Jarell",43,104,.413,20,57,.351,23,47,.489,9,11,.818,11,62,73,18,3,11,8,51,115,2018/2019
"Mason,Frank",71,169,.420,14,64,.219,57,105,.543,39,57,.684,6,37,43,84,16,36,4,34,195,2018/2019
"Maten,Yante",1,4,.250,0,1,.000,1,3,.333,0,0,,1,2,3,0,1,0,0,0,2,2018/2019
"Matthews,Wesley",279,698,.400,150,403,.372,129,295,.437,132,163,.810,32,138,170,160,54,91,17,160,840,2018/2019
"Matthews,Wesley",194,469,.414,100,263,.380,94,206,.456,87,110,.791,20,82,102,100,33,58,12,102,575,2018/2019
"Matthews,Wesley",4,19,.211,2,10,.200,2,9,.222,4,5,.800,1,2,3,5,1,2,1,2,14,2018/2019
"Matthews,Wesley",81,210,.386,48,130,.369,33,80,.413,41,48,.854,11,54,65,55,20,31,4,56,251,2018/2019
"Mbah a Moute,Luc",8,18,.444,2,6,.333,6,12,.500,2,5,.400,2,5,7,2,1,2,1,8,20,2018/2019
"McCall,Tahjere",2,3,.667,0,1,.000,2,2,1.000,0,1,.000,0,1,1,0,0,0,0,2,4,2018/2019
"McCaw,Patrick",26,63,.413,9,28,.321,17,35,.486,13,15,.867,7,41,48,29,23,17,2,38,74,2018/2019
"McCaw,Patrick",2,9,.222,1,4,.250,1,5,.200,0,0,,0,3,3,2,2,3,0,1,5,2018/2019
"McCaw,Patrick",24,54,.444,8,24,.333,16,30,.533,13,15,.867,7,38,45,27,21,14,2,37,69,2018/2019
"McCollum,CJ",571,1243,.459,167,445,.375,404,798,.506,159,192,.828,62,220,282,207,55,106,28,172,1468,2018/2019
"McConnell,T.J.",220,419,.525,14,42,.333,206,377,.546,29,37,.784,28,146,174,258,79,91,17,105,483,2018/2019
"McDermott,Doug",207,422,.491,84,206,.408,123,216,.569,66,79,.835,17,92,109,67,18,42,8,104,564,2018/2019
"McGee,JaVale",400,641,.624,1,12,.083,399,629,.634,96,152,.632,195,371,566,52,47,108,148,208,897,2018/2019
"McGruder,Rodney",186,461,.403,79,225,.351,107,236,.453,52,72,.722,60,178,238,112,36,64,12,115,503,2018/2019
"McKinnie,Alfonzo",134,275,.487,42,118,.356,92,157,.586,27,48,.563,81,166,247,31,18,30,15,134,337,2018/2019
"McLemore,Ben",25,64,.391,17,41,.415,8,23,.348,8,12,.667,3,14,17,4,6,5,3,22,75,2018/2019
"McRae,Jordan",61,130,.469,10,35,.286,51,95,.537,28,35,.800,6,34,40,30,13,15,7,26,160,2018/2019
"Meeks,Jodie",21,39,.538,8,18,.444,13,21,.619,1,1,1.000,1,11,12,8,1,2,1,5,51,2018/2019
"Mejri,Salah",55,112,.491,11,34,.324,44,78,.564,20,32,.625,36,95,131,35,10,21,26,55,141,2018/2019
"Melton,De'Anthony",100,256,.391,29,95,.305,71,161,.441,21,28,.750,25,109,134,159,68,75,23,113,250,2018/2019
"Metu,Chimezie",19,58,.328,0,2,.000,19,56,.339,13,17,.765,9,27,36,13,6,15,2,14,51,2018/2019
"Middleton,Khris",506,1148,.441,179,474,.378,327,674,.485,216,258,.837,50,411,461,331,80,174,7,172,1407,2018/2019
"Miles,C.J.",112,311,.360,67,203,.330,45,108,.417,48,58,.828,13,82,95,36,26,30,15,79,339,2018/2019
"Miles,C.J.",70,206,.340,43,137,.314,27,69,.391,35,44,.795,12,56,68,22,18,21,10,62,218,2018/2019
"Miles,C.J.",42,105,.400,24,66,.364,18,39,.462,13,14,.929,1,26,27,14,8,9,5,17,121,2018/2019
"Miller,Darius",189,484,.390,133,364,.365,56,120,.467,56,71,.789,14,114,128,146,40,59,23,165,567,2018/2019
"Miller,Malcolm",11,26,.423,10,21,.476,1,5,.200,3,4,.750,1,4,5,1,1,1,1,5,35,2018/2019
"Mills,Patty",282,663,.425,159,404,.394,123,259,.475,88,103,.854,24,158,182,245,49,93,10,129,811,2018/2019
"Millsap,Paul",322,665,.484,58,159,.365,264,506,.522,181,249,.727,153,352,505,141,83,95,54,183,883,2018/2019
"Milton,Shake",34,87,.391,14,44,.318,20,43,.465,5,7,.714,9,26,35,18,8,6,8,29,87,2018/2019
"Mirotić,Nikola",238,542,.439,116,318,.365,122,224,.545,105,124,.847,60,279,339,55,31,48,34,107,697,2018/2019
"Mirotić,Nikola",182,407,.447,85,231,.368,97,176,.551,85,101,.842,46,218,264,35,21,37,25,86,534,2018/2019
"Mirotić,Nikola",56,135,.415,31,87,.356,25,48,.521,20,23,.870,14,61,75,20,10,11,9,21,163,2018/2019
"Mitchell,Donovan",661,1530,.432,188,519,.362,473,1011,.468,319,396,.806,59,257,316,322,106,218,31,208,1829,2018/2019
"Mitrou-Long,Naz",6,20,.300,2,11,.182,4,9,.444,2,2,1.000,1,5,6,15,1,8,1,10,16,2018/2019
"Monk,Malik",227,586,.387,109,330,.330,118,256,.461,90,102,.882,16,121,137,117,37,86,19,106,653,2018/2019
"Monroe,Greg",92,189,.487,1,5,.200,91,184,.495,45,72,.625,67,105,172,24,14,32,8,66,230,2018/2019
"Monroe,Greg",74,161,.460,0,4,.000,74,157,.471,35,61,.574,60,96,156,16,13,31,8,61,183,2018/2019
"Monroe,Greg",3,5,.600,0,0,,3,5,.600,0,0,,3,0,3,1,0,0,0,0,6,2018/2019
"Monroe,Greg",15,23,.652,1,1,1.000,14,22,.636,10,11,.909,4,9,13,7,1,1,0,5,41,2018/2019
"Moore,E'Twaun",256,532,.481,76,176,.432,180,356,.506,45,59,.763,35,92,127,102,40,59,8,112,633,2018/2019
"Moreland,Eric",3,7,.429,1,1,1.000,2,6,.333,0,0,,4,16,20,4,1,5,1,9,7,2018/2019
"Moreland,Eric",0,0,,0,0,,0,0,,0,0,,0,3,3,0,0,0,0,1,0,2018/2019
"Moreland,Eric",3,7,.429,1,1,1.000,2,6,.333,0,0,,4,13,17,4,1,5,1,8,7,2018/2019
"Morris,Jaylen",4,10,.400,1,3,.333,3,7,.429,1,2,.500,0,5,5,4,2,1,0,1,10,2018/2019
"Morris,Marcus",377,844,.447,146,389,.375,231,455,.508,146,173,.844,76,382,458,109,43,92,25,181,1046,2018/2019
"Morris,Markieff",204,484,.421,68,203,.335,136,281,.484,71,92,.772,61,204,265,79,36,54,22,175,547,2018/2019
"Morris,Markieff",143,328,.436,48,144,.333,95,184,.516,57,73,.781,41,133,174,60,25,47,20,117,391,2018/2019
"Morris,Markieff",61,156,.391,20,59,.339,41,97,.423,14,19,.737,20,71,91,19,11,7,2,58,156,2018/2019
"Morris,Monte",346,702,.493,94,227,.414,252,475,.531,65,81,.802,35,159,194,297,73,52,4,102,851,2018/2019
"Motiejūnas,Donatas",3,6,.500,0,0,,3,6,.500,0,2,.000,2,1,3,1,0,3,1,6,6,2018/2019
"Motley,Johnathan",39,73,.534,0,3,.000,39,70,.557,24,40,.600,18,33,51,11,5,16,3,27,102,2018/2019
"Mudiay,Emmanuel",330,740,.446,69,210,.329,261,530,.492,144,186,.774,33,163,196,228,43,140,19,103,873,2018/2019
"Murray,Jamal",513,1173,.437,152,414,.367,361,759,.476,189,223,.848,65,252,317,363,67,158,27,153,1367,2018/2019
"Musa,Džanan",9,22,.409,1,10,.100,8,12,.667,0,2,.000,1,4,5,2,2,4,0,1,19,2018/2019
"Muscala,Mike",145,361,.402,89,256,.348,56,105,.533,70,85,.824,57,187,244,76,22,48,38,130,449,2018/2019
"Muscala,Mike",109,278,.392,68,199,.342,41,79,.519,63,77,.818,51,149,200,62,18,43,27,112,349,2018/2019
"Muscala,Mike",36,83,.434,21,57,.368,15,26,.577,7,8,.875,6,38,44,14,4,5,11,18,100,2018/2019
"Mykhailiuk,Sviatoslav",46,140,.329,29,89,.326,17,51,.333,12,20,.600,9,27,36,37,14,21,1,25,133,2018/2019
"Mykhailiuk,Sviatoslav",44,132,.333,27,85,.318,17,47,.362,12,20,.600,8,26,34,33,13,20,1,25,127,2018/2019
"Mykhailiuk,Sviatoslav",2,8,.250,2,4,.500,0,4,.000,0,0,,1,1,2,4,1,1,0,0,6,2018/2019
"Nader,Abdel",91,215,.423,32,100,.320,59,115,.513,27,36,.750,14,102,116,20,20,26,12,68,241,2018/2019
"Nance,Larry",249,479,.520,33,98,.337,216,381,.567,96,134,.716,168,384,552,214,100,97,40,192,627,2018/2019
"Napier,Shabazz",169,435,.389,76,228,.333,93,207,.449,115,138,.833,18,82,100,143,41,66,16,67,529,2018/2019
"Neto,Raul",74,161,.460,20,60,.333,54,101,.535,28,33,.848,6,56,62,93,14,35,4,49,196,2018/2019
"Niang,Georges",86,181,.475,43,105,.410,43,76,.566,20,24,.833,11,76,87,35,10,23,6,57,235,2018/2019
"Noah,Joakim",110,213,.516,0,1,.000,110,212,.519,78,109,.716,58,180,238,89,20,50,31,96,298,2018/2019
"Noel,Nerlens",162,276,.587,0,0,,162,276,.587,54,79,.684,127,198,325,45,66,48,96,166,378,2018/2019
"Nowitzki,Dirk",135,376,.359,64,205,.312,71,171,.415,39,50,.780,5,153,158,35,9,18,18,76,373,2018/2019
"Ntilikina,Frank",95,282,.337,33,115,.287,62,167,.371,23,30,.767,12,75,87,121,30,56,14,104,246,2018/2019
"Nunnally,James",12,34,.353,8,25,.320,4,9,.444,4,4,1.000,0,5,5,7,1,1,0,10,36,2018/2019
"Nunnally,James",9,21,.429,5,13,.385,4,8,.500,4,4,1.000,0,4,4,5,1,1,0,4,27,2018/2019
"Nunnally,James",3,13,.231,3,12,.250,0,1,.000,0,0,,0,1,1,2,0,0,0,6,9,2018/2019
"Nurkić,Jusuf",420,826,.508,3,29,.103,417,797,.523,282,365,.773,243,505,748,233,71,168,103,250,1125,2018/2019
"Nwaba,David",126,262,.481,24,75,.320,102,187,.545,58,85,.682,41,122,163,54,36,29,17,106,334,2018/2019
"O'Neale,Royce",163,343,.475,68,176,.386,95,167,.569,32,42,.762,22,263,285,124,54,70,24,172,426,2018/2019
"O'Quinn,Kyle",69,136,.507,1,12,.083,68,124,.548,17,21,.810,29,90,119,56,9,31,25,68,156,2018/2019
"Ojeleye,Semi",67,158,.424,28,89,.315,39,69,.565,24,39,.615,24,62,86,23,10,19,4,43,186,2018/2019
"Okafor,Jahlil",212,362,.586,1,5,.200,211,357,.591,59,89,.663,82,196,278,40,15,52,40,96,484,2018/2019
"Okobo,Elie",114,290,.393,39,132,.295,75,158,.475,37,47,.787,12,86,98,127,32,69,7,109,304,2018/2019
"Okogie,Josh",196,508,.386,60,215,.279,136,293,.464,118,162,.728,41,177,218,91,88,63,33,166,570,2018/2019
"Oladipo,Victor",249,588,.423,74,216,.343,175,372,.470,103,141,.730,21,181,202,186,60,82,11,72,675,2018/2019
"Olynyk,Kelly",261,564,.463,113,319,.354,148,245,.604,152,185,.822,72,303,375,140,53,114,37,183,787,2018/2019
"Osman,Cedi",360,844,.427,130,374,.348,230,470,.489,141,181,.779,45,312,357,195,60,114,11,195,991,2018/2019
"Oubre,Kelly",375,842,.445,108,338,.320,267,504,.530,189,244,.775,71,254,325,84,84,103,59,181,1047,2018/2019
"Oubre,Kelly",132,305,.433,41,132,.311,91,173,.526,68,85,.800,24,105,129,20,27,30,20,71,373,2018/2019
"Oubre,Kelly",243,537,.453,67,206,.325,176,331,.532,121,159,.761,47,149,196,64,57,73,39,110,674,2018/2019
"Pachulia,Zaza",85,193,.440,0,4,.000,85,189,.450,97,124,.782,99,166,265,91,31,57,17,151,267,2018/2019
"Parker,Jabari",369,749,.493,61,195,.313,308,554,.556,131,184,.712,79,342,421,152,46,151,30,145,930,2018/2019
"Parker,Jabari",220,464,.474,37,114,.325,183,350,.523,79,108,.731,41,200,241,84,23,84,14,87,556,2018/2019
"Parker,Jabari",149,285,.523,24,81,.296,125,204,.613,52,76,.684,38,142,180,68,23,67,16,58,374,2018/2019
"Parker,Tony",213,463,.460,13,51,.255,200,412,.485,91,124,.734,14,69,83,207,21,75,7,53,530,2018/2019
"Parsons,Chandler",68,182,.374,29,94,.309,39,88,.443,22,25,.880,4,66,70,43,19,32,5,45,187,2018/2019
"Patterson,Patrick",82,219,.374,46,137,.336,36,82,.439,19,30,.633,42,105,147,31,16,22,13,46,229,2018/2019
"Patton,Justin",2,7,.286,0,2,.000,2,5,.400,1,2,.500,2,4,6,3,2,0,0,5,5,2018/2019
"Paul,Chris",302,720,.419,127,355,.358,175,365,.479,175,203,.862,36,229,265,473,114,152,18,146,906,2018/2019
"Payne,Cameron",96,223,.430,25,84,.298,71,139,.511,33,41,.805,13,59,72,106,28,45,9,64,250,2018/2019
"Payne,Cameron",69,168,.411,16,59,.271,53,109,.486,22,25,.880,10,43,53,83,20,34,6,49,176,2018/2019
"Payne,Cameron",27,55,.491,9,25,.360,18,30,.600,11,16,.688,3,16,19,23,8,11,3,15,74,2018/2019
"Payton,Elfrid",179,412,.434,33,105,.314,146,307,.476,55,74,.743,49,171,220,320,44,112,17,81,446,2018/2019
"Payton,Gary",5,8,.625,1,2,.500,4,6,.667,0,0,,1,1,2,4,3,1,1,2,11,2018/2019
"Pinson,Theo",25,73,.342,12,46,.261,13,27,.481,19,22,.864,4,32,36,21,6,18,0,15,81,2018/2019
"Plumlee,Mason",262,442,.593,2,10,.200,260,432,.602,111,198,.561,165,359,524,243,66,126,76,252,637,2018/2019
"Plumlee,Miles",32,48,.667,0,0,,32,48,.667,16,30,.533,16,23,39,17,6,10,4,14,80,2018/2019
"Pöltl,Jakob",187,290,.645,0,0,,187,290,.645,49,92,.533,178,232,410,93,29,48,68,124,423,2018/2019
"Pondexter,Quincy",29,58,.500,6,18,.333,23,40,.575,34,42,.810,8,38,46,24,11,13,1,24,98,2018/2019
"Porter,Otto",299,643,.465,104,256,.406,195,387,.504,78,96,.813,54,260,314,120,82,65,31,108,780,2018/2019
"Porter,Otto",202,442,.457,65,176,.369,137,266,.515,49,64,.766,40,191,231,80,64,40,22,79,518,2018/2019
"Porter,Otto",97,201,.483,39,80,.488,58,121,.479,29,32,.906,14,69,83,40,18,25,9,29,262,2018/2019
"Portis,Bobby",279,628,.444,75,191,.393,204,437,.467,77,97,.794,109,294,403,72,35,74,20,145,710,2018/2019
"Portis,Bobby",122,271,.450,27,72,.375,95,199,.477,39,50,.780,46,115,161,29,11,29,8,61,310,2018/2019
"Portis,Bobby",157,357,.440,48,119,.403,109,238,.458,38,47,.809,63,179,242,43,24,45,12,84,400,2018/2019
"Powell,Dwight",290,486,.597,39,127,.307,251,359,.699,196,254,.772,140,271,411,112,44,67,50,201,815,2018/2019
"Powell,Norman",193,400,.483,68,170,.400,125,230,.543,62,75,.827,16,123,139,91,39,65,13,96,516,2018/2019
"Poythress,Alex",40,81,.494,9,23,.391,31,58,.534,18,29,.621,29,47,76,17,4,13,10,47,107,2018/2019
"Qi,Zhou",1,1,1.000,0,0,,1,1,1.000,0,0,,0,0,0,0,0,0,0,0,2,2018/2019
"Rabb,Ivan",116,212,.547,3,15,.200,113,197,.574,49,69,.710,70,136,206,54,17,35,14,90,284,2018/2019
"Randle,Chasson",91,217,.419,46,115,.400,45,102,.441,43,62,.694,10,46,56,97,25,43,3,91,271,2018/2019
"Randle,Julius",571,1089,.524,67,195,.344,504,894,.564,356,487,.731,162,472,634,229,52,208,45,246,1565,2018/2019
"Redick,J.J.",452,1027,.440,240,605,.397,212,422,.502,228,255,.894,20,166,186,206,32,101,17,129,1372,2018/2019
"Reed,Davon",5,12,.417,2,4,.500,3,8,.375,0,0,,2,4,6,3,1,1,0,3,12,2018/2019
"Reynolds,Cameron",33,78,.423,21,51,.412,12,27,.444,8,9,.889,4,27,31,13,6,5,2,26,95,2018/2019
"Richardson,Josh",423,1026,.412,164,460,.357,259,566,.458,199,231,.861,54,209,263,298,79,113,34,200,1209,2018/2019
"Richardson,Malachi",9,29,.310,8,25,.320,1,4,.250,4,5,.800,2,11,13,0,1,8,0,13,30,2018/2019
"Rivers,Austin",232,572,.406,104,327,.318,128,245,.522,50,95,.526,25,137,162,167,47,68,23,207,618,2018/2019
"Rivers,Austin",76,194,.392,33,106,.311,43,88,.489,25,46,.543,10,61,71,58,18,36,10,72,210,2018/2019
"Rivers,Austin",156,378,.413,71,221,.321,85,157,.541,25,49,.510,15,76,91,109,29,32,13,135,408,2018/2019
"Robinson,Devin",19,32,.594,0,2,.000,19,30,.633,9,14,.643,6,14,20,6,4,2,6,11,47,2018/2019
"Robinson,Duncan",18,46,.391,10,35,.286,8,11,.727,4,6,.667,2,17,19,5,5,4,0,11,50,2018/2019
"Robinson,Glenn",74,176,.420,18,62,.290,56,114,.491,32,40,.800,17,54,71,21,14,18,8,45,198,2018/2019
"Robinson,Jerome",44,110,.400,18,57,.316,26,53,.491,6,9,.667,3,38,41,19,11,13,3,46,112,2018/2019
"Robinson,Mitchell",202,291,.694,0,0,,202,291,.694,81,135,.600,177,246,423,37,52,35,161,217,485,2018/2019
"Rondo,Rajon",175,432,.405,51,142,.359,124,290,.428,23,36,.639,34,209,243,367,57,127,7,100,424,2018/2019
"Rose,Derrick",363,753,.482,54,146,.370,309,607,.509,137,160,.856,33,107,140,220,31,82,12,57,917,2018/2019
"Ross,Terrence",440,1027,.428,217,566,.383,223,461,.484,126,144,.875,27,253,280,135,72,90,29,119,1223,2018/2019
"Rozier,Terry",258,666,.387,119,337,.353,139,329,.422,73,93,.785,32,275,307,231,68,68,21,101,708,2018/2019
"Rubio,Ricky",295,730,.404,79,254,.311,216,476,.454,195,228,.855,33,210,243,416,91,180,10,180,864,2018/2019
"Russell,D'Angelo",659,1517,.434,234,635,.369,425,882,.482,160,205,.780,53,262,315,563,100,253,20,141,1712,2018/2019
"Sabonis,Domantas",413,700,.590,9,17,.529,404,683,.592,208,291,.715,186,504,690,212,48,160,30,239,1043,2018/2019
"Sampson,Brandon",28,60,.467,11,29,.379,17,31,.548,4,6,.667,3,13,16,10,8,12,3,19,71,2018/2019
"Sampson,JaKarr",29,54,.537,5,14,.357,24,40,.600,17,21,.810,5,27,32,4,4,4,3,8,80,2018/2019
"Šarić,Dario",304,696,.437,118,323,.365,186,373,.499,132,150,.880,126,331,457,127,45,97,9,182,858,2018/2019
"Šarić,Dario",48,132,.364,21,70,.300,27,62,.435,27,30,.900,21,65,86,26,4,25,3,39,144,2018/2019
"Šarić,Dario",256,564,.454,97,253,.383,159,311,.511,105,120,.875,105,266,371,101,41,72,6,143,714,2018/2019
"Satoranský,Tomáš",257,530,.485,64,162,.395,193,368,.524,131,160,.819,82,197,279,399,82,120,13,172,709,2018/2019
"Schröder,Dennis",457,1104,.414,124,364,.341,333,740,.450,186,227,.819,38,246,284,323,65,172,12,189,1224,2018/2019
"Scott,Mike",168,420,.400,101,252,.401,67,168,.399,22,33,.667,43,233,276,66,26,44,13,156,459,2018/2019
"Scott,Mike",92,230,.400,52,133,.391,40,97,.412,12,18,.667,24,150,174,44,17,27,8,88,248,2018/2019
"Scott,Mike",76,190,.400,49,119,.412,27,71,.380,10,15,.667,19,83,102,22,9,17,5,68,211,2018/2019
"Sefolosha,Thabo",71,149,.477,34,78,.436,37,71,.521,14,22,.636,8,115,123,27,43,25,5,41,190,2018/2019
"Selden,Wayne",196,483,.406,55,174,.316,141,309,.456,67,92,.728,37,143,180,109,33,79,13,131,514,2018/2019
"Selden,Wayne",65,161,.404,20,63,.317,45,98,.459,22,29,.759,16,28,44,36,10,23,6,48,172,2018/2019
"Selden,Wayne",131,322,.407,35,111,.315,96,211,.455,45,63,.714,21,115,136,73,23,56,7,83,342,2018/2019
"Sexton,Collin",519,1206,.430,119,296,.402,400,910,.440,214,255,.839,57,179,236,243,44,185,6,186,1371,2018/2019
"Shamet,Landry",240,557,.431,167,396,.422,73,161,.453,75,93,.806,21,113,134,117,37,45,10,155,722,2018/2019
"Shamet,Landry",153,347,.441,99,245,.404,54,102,.529,44,54,.815,14,64,78,59,24,26,8,106,449,2018/2019
"Shamet,Landry",87,210,.414,68,151,.450,19,59,.322,31,39,.795,7,49,56,58,13,19,2,49,273,2018/2019
"Shumpert,Iman",167,446,.374,95,273,.348,72,173,.416,36,45,.800,27,156,183,112,59,50,24,127,465,2018/2019
"Shumpert,Iman",133,348,.382,74,202,.366,59,146,.404,34,41,.829,19,110,129,91,47,38,20,92,374,2018/2019
"Shumpert,Iman",34,98,.347,21,71,.296,13,27,.481,2,4,.500,8,46,54,21,12,12,4,35,91,2018/2019
"Siakam,Pascal",519,945,.549,79,214,.369,440,731,.602,237,302,.785,124,425,549,248,73,154,52,241,1354,2018/2019
"Sibert,Jordan",1,1,1.000,1,1,1.000,0,0,,0,0,,0,0,0,0,0,0,0,0,3,2018/2019
"Simmons,Ben",540,960,.563,0,6,.000,540,954,.566,257,428,.600,172,525,697,610,112,274,61,209,1337,2018/2019
"Simmons,Jonathon",133,350,.380,28,104,.269,105,246,.427,72,97,.742,27,99,126,128,29,68,15,89,366,2018/2019
"Simmons,Jonathon",104,286,.364,19,83,.229,85,203,.419,56,72,.778,23,77,100,95,18,56,14,68,283,2018/2019
"Simmons,Jonathon",29,64,.453,9,21,.429,20,43,.465,16,25,.640,4,22,26,33,11,12,1,21,83,2018/2019
"Simmons,Kobi",0,0,,0,0,,0,0,,0,0,,0,0,0,0,0,0,0,0,0,2018/2019
"Simons,Anfernee",28,63,.444,10,29,.345,18,34,.529,9,16,.563,3,10,13,13,1,11,0,9,75,2018/2019
"Smart,Marcus",239,567,.422,126,346,.364,113,221,.511,104,129,.806,57,177,234,321,143,123,28,201,708,2018/2019
"Smith,Dennis",278,650,.428,67,208,.322,211,442,.477,99,156,.635,32,123,155,252,67,154,20,129,722,2018/2019
"Smith,Dennis",157,357,.440,43,125,.344,114,232,.491,57,82,.695,18,79,97,138,40,100,11,82,414,2018/2019
"Smith,Dennis",121,293,.413,24,83,.289,97,210,.462,42,74,.568,14,44,58,114,27,54,9,47,308,2018/2019
"Smith,Ish",205,489,.419,44,135,.326,161,354,.455,47,62,.758,23,122,145,203,28,61,11,109,501,2018/2019
"Smith,J.R.",27,79,.342,12,39,.308,15,40,.375,8,10,.800,0,18,18,21,11,11,3,19,74,2018/2019
"Smith,Jason",21,59,.356,9,26,.346,12,33,.364,14,16,.875,16,36,52,14,3,13,7,30,65,2018/2019
"Smith,Jason",15,37,.405,4,10,.400,11,27,.407,10,12,.833,11,26,37,12,1,7,5,21,44,2018/2019
"Smith,Jason",4,13,.308,3,9,.333,1,4,.250,2,2,1.000,3,8,11,1,2,5,2,6,13,2018/2019
"Smith,Jason",2,9,.222,2,7,.286,0,2,.000,2,2,1.000,2,2,4,1,0,1,0,3,8,2018/2019
"Smith,Zhaire",14,34,.412,6,16,.375,8,18,.444,6,8,.750,3,10,13,10,2,6,2,8,40,2018/2019
"Snell,Tony",163,361,.452,81,204,.397,82,157,.522,37,42,.881,29,128,157,68,26,23,18,90,444,2018/2019
"Spalding,Ray",25,47,.532,0,3,.000,25,44,.568,4,12,.333,15,33,48,5,9,9,8,23,54,2018/2019
"Spalding,Ray",0,0,,0,0,,0,0,,0,0,,0,0,0,0,0,0,0,0,0,2018/2019
"Spalding,Ray",25,47,.532,0,3,.000,25,44,.568,4,12,.333,15,33,48,5,9,9,8,23,54,2018/2019
"Spellman,Omari",98,244,.402,44,128,.344,54,116,.466,32,45,.711,72,122,194,47,26,31,25,67,272,2018/2019
"Stauskas,Nik",136,338,.402,70,188,.372,66,150,.440,57,64,.891,18,109,127,81,21,51,7,50,399,2018/2019
"Stauskas,Nik",96,229,.419,43,125,.344,53,104,.510,32,36,.889,10,70,80,62,14,40,4,31,267,2018/2019
"Stauskas,Nik",40,109,.367,27,63,.429,13,46,.283,25,28,.893,8,39,47,19,7,11,3,19,132,2018/2019
"Stephens,D.J.",1,2,.500,0,0,,1,2,.500,0,0,,0,0,0,0,1,1,0,0,2,2018/2019
"Stephenson,Lance",184,432,.426,73,197,.371,111,235,.472,50,73,.685,32,183,215,140,41,86,7,111,491,2018/2019
"Sumner,Edmond",22,64,.344,7,27,.259,15,37,.405,15,24,.625,9,15,24,10,12,10,5,26,66,2018/2019
"Swanigan,Caleb",18,53,.340,1,7,.143,17,46,.370,6,9,.667,17,47,64,11,6,18,1,28,43,2018/2019
"Swanigan,Caleb",14,44,.318,1,5,.200,13,39,.333,6,7,.857,13,39,52,7,4,16,0,22,35,2018/2019
"Swanigan,Caleb",4,9,.444,0,2,.000,4,7,.571,0,2,.000,4,8,12,4,2,2,1,6,8,2018/2019
"Tatum,Jayson",466,1036,.450,116,311,.373,350,725,.483,195,228,.855,70,407,477,168,84,122,57,168,1243,2018/2019
"Teague,Jeff",176,416,.423,35,105,.333,141,311,.453,123,153,.804,16,90,106,343,43,97,18,90,510,2018/2019
"Temple,Garrett",208,493,.422,90,264,.341,118,229,.515,80,107,.748,28,188,216,106,76,70,30,204,586,2018/2019
"Temple,Garrett",166,387,.429,74,210,.352,92,177,.520,57,76,.750,18,134,152,69,50,54,25,134,463,2018/2019
"Temple,Garrett",42,106,.396,16,54,.296,26,52,.500,23,31,.742,10,54,64,37,26,16,5,70,123,2018/2019
"Teodosić,Miloš",17,40,.425,10,27,.370,7,13,.538,4,7,.571,3,13,16,32,3,21,1,27,48,2018/2019
"Terrell,Jared",12,39,.308,4,17,.235,8,22,.364,3,6,.500,1,5,6,12,3,10,2,16,31,2018/2019
"Terry,Emanuel",4,7,.571,0,0,,4,7,.571,2,4,.500,3,4,7,2,3,2,0,4,10,2018/2019
"Terry,Emanuel",4,6,.667,0,0,,4,6,.667,1,2,.500,2,4,6,1,3,2,0,4,9,2018/2019
"Terry,Emanuel",0,1,.000,0,0,,0,1,.000,1,2,.500,1,0,1,1,0,0,0,0,1,2018/2019
"Theis,Daniel",146,266,.549,26,67,.388,120,199,.603,56,76,.737,87,138,225,68,21,33,42,161,374,2018/2019
"Thomas,Isaiah",34,99,.343,12,43,.279,22,56,.393,17,27,.630,5,8,13,23,5,18,1,17,97,2018/2019
"Thomas,Khyri",22,69,.319,10,35,.286,12,34,.353,7,11,.636,4,16,20,8,7,4,5,22,61,2018/2019
"Thomas,Lance",78,197,.396,22,79,.278,56,118,.475,27,36,.750,21,96,117,27,17,24,7,83,205,2018/2019
"Thompson,Klay",655,1402,.467,241,599,.402,414,803,.516,129,158,.816,37,262,299,186,84,115,47,157,1680,2018/2019
"Thompson,Tristan",201,380,.529,0,0,,201,380,.529,68,106,.642,173,265,438,86,28,59,16,89,470,2018/2019
"Thornwell,Sindarius",17,49,.347,3,15,.200,14,34,.412,25,34,.735,5,39,44,18,14,20,7,41,62,2018/2019
"Tolliver,Anthony",99,259,.382,81,215,.377,18,44,.409,47,60,.783,15,162,177,46,17,36,21,91,326,2018/2019
"Towns,Karl-Anthony",681,1314,.518,142,355,.400,539,959,.562,376,450,.836,263,691,954,259,67,240,125,292,1880,2018/2019
"Trent,Gary",16,50,.320,5,21,.238,11,29,.379,3,7,.429,1,10,11,5,1,4,2,4,40,2018/2019
"Trier,Allonzo",232,518,.448,52,132,.394,180,386,.466,179,223,.803,31,166,197,119,28,116,14,117,695,2018/2019
"Tucker,P.J.",207,523,.396,146,387,.377,61,136,.449,41,59,.695,121,358,479,96,132,63,39,252,601,2018/2019
"Turner,Evan",204,443,.460,11,52,.212,193,391,.494,75,106,.708,37,291,328,283,33,114,18,110,494,2018/2019
"Turner,Myles",380,780,.487,76,196,.388,304,584,.521,148,201,.736,101,430,531,115,60,100,199,195,984,2018/2019
"Udoh,Ekpe",50,72,.694,0,0,,50,72,.694,19,30,.633,27,63,90,28,10,13,31,36,119,2018/2019
"Ulis,Tyler",0,0,,0,0,,0,0,,0,0,,0,0,0,0,0,0,0,0,0,2018/2019
"Valančiūnas,Jonas",301,538,.559,14,48,.292,287,490,.586,147,185,.795,106,313,419,70,19,90,53,146,763,2018/2019
"Valančiūnas,Jonas",149,259,.575,9,30,.300,140,229,.611,77,94,.819,54,162,216,29,13,39,23,82,384,2018/2019
"Valančiūnas,Jonas",152,279,.545,5,18,.278,147,261,.563,70,91,.769,52,151,203,41,6,51,30,64,379,2018/2019
"Vanderbilt,Jarred",9,19,.474,0,1,.000,9,18,.500,6,10,.600,7,16,23,3,6,8,1,8,24,2018/2019
"VanVleet,Fred",246,600,.410,112,296,.378,134,304,.441,97,115,.843,21,146,167,307,57,82,20,110,701,2018/2019
"Vonleh,Noah",207,440,.470,46,137,.336,161,303,.531,111,156,.712,113,415,528,129,46,88,51,174,571,2018/2019
"Vučević,Nikola",701,1354,.518,84,231,.364,617,1123,.549,179,227,.789,224,736,960,307,81,159,89,157,1665,2018/2019
"Wade,Dwyane",416,960,.433,86,261,.330,330,699,.472,165,233,.708,69,216,285,301,59,166,38,118,1083,2018/2019
"Wagner,Moritz",71,171,.415,22,77,.286,49,94,.521,43,53,.811,17,68,85,24,11,39,13,57,207,2018/2019
"Waiters,Dion",198,478,.414,109,289,.377,89,189,.471,22,44,.500,7,109,116,121,29,64,9,72,527,2018/2019
"Walker,Kemba",731,1684,.434,260,731,.356,471,953,.494,380,450,.844,52,309,361,484,102,211,34,131,2102,2018/2019
"Walker,Lonnie",16,46,.348,5,13,.385,11,33,.333,8,10,.800,0,17,17,9,7,4,3,7,45,2018/2019
"Wall,John",245,552,.444,51,169,.302,194,383,.507,122,175,.697,15,101,116,279,49,121,29,71,663,2018/2019
"Wallace,Tyrone",92,217,.424,4,19,.211,88,198,.444,30,57,.526,20,81,101,42,21,36,7,83,218,2018/2019
"Waller-Prince,Taurean",262,594,.441,123,315,.390,139,279,.498,95,116,.819,22,177,199,118,53,100,19,141,742,2018/2019
"Wanamaker,Brad",50,105,.476,16,39,.410,34,66,.515,24,28,.857,3,38,41,56,12,19,2,34,140,2018/2019
"Warren,T.J.",297,611,.486,77,180,.428,220,431,.510,101,124,.815,31,143,174,64,51,52,29,119,772,2018/2019
"Washburn,Julian",16,48,.333,5,24,.208,11,24,.458,3,4,.750,8,33,41,14,13,7,2,16,40,2018/2019
"Watanabe,Yuta",15,51,.294,2,16,.125,13,35,.371,7,10,.700,4,27,31,8,4,6,1,11,39,2018/2019
"Welsh,Thomas",7,13,.538,3,7,.429,4,6,.667,1,2,.500,0,4,4,5,0,1,0,3,18,2018/2019
"Westbrook,Russell",630,1473,.428,119,411,.290,511,1062,.481,296,451,.656,109,698,807,784,142,325,33,245,1675,2018/2019
"White,Derrick",260,543,.479,48,142,.338,212,401,.529,95,123,.772,35,212,247,263,67,97,47,145,663,2018/2019
"White,Okaro",0,2,.000,0,2,.000,0,0,,0,0,,1,1,2,0,0,0,0,0,0,2018/2019
"Whiteside,Hassan",388,680,.571,2,16,.125,386,664,.581,109,243,.449,257,560,817,56,46,97,136,192,887,2018/2019
"Wiggins,Andrew",498,1209,.412,118,348,.339,380,861,.441,207,296,.699,83,269,352,184,70,138,48,153,1321,2018/2019
"Williams,Alan",8,13,.615,0,1,.000,8,12,.667,2,4,.500,4,15,19,3,1,1,0,2,18,2018/2019
"Williams,C.J.",17,35,.486,5,16,.313,12,19,.632,0,1,.000,1,7,8,12,6,5,0,16,39,2018/2019
"Williams,Johnathan",65,110,.591,0,2,.000,65,108,.602,27,48,.563,48,51,99,13,8,16,7,62,157,2018/2019
"Williams,Kenrich",107,279,.384,52,156,.333,55,123,.447,13,19,.684,55,164,219,83,45,36,19,95,279,2018/2019
"Williams,Lou",484,1138,.425,105,291,.361,379,847,.447,425,485,.876,40,182,222,402,57,181,11,80,1498,2018/2019
"Williams,Marvin",275,652,.422,140,382,.366,135,270,.500,66,86,.767,76,331,407,92,71,47,61,156,756,2018/2019
"Williams,Robert",36,51,.706,0,0,,36,51,.706,9,15,.600,27,54,81,7,9,10,40,36,81,2018/2019
"Williams,Troy",44,98,.449,14,44,.318,30,54,.556,9,15,.600,12,47,59,11,10,9,8,37,111,2018/2019
"Wilson,D.J.",104,251,.414,46,127,.362,58,124,.468,26,47,.553,45,177,222,52,18,32,20,85,280,2018/2019
"Winslow,Justise",324,749,.433,96,256,.375,228,493,.462,86,137,.628,63,292,355,282,72,142,19,177,830,2018/2019
"Wood,Christian",61,117,.521,9,26,.346,52,91,.571,41,56,.732,17,66,83,8,7,17,10,17,172,2018/2019
"Wood,Christian",12,25,.480,3,5,.600,9,20,.450,10,15,.667,4,16,20,2,0,3,0,3,37,2018/2019
"Wood,Christian",49,92,.533,6,21,.286,43,71,.606,31,41,.756,13,50,63,6,7,14,10,14,135,2018/2019
"Wright,Delon",242,558,.434,50,168,.298,192,390,.492,119,150,.793,68,198,266,248,88,77,30,103,653,2018/2019
"Wright,Delon",127,293,.433,30,90,.333,97,203,.478,53,61,.869,39,86,125,110,46,37,15,53,337,2018/2019
"Wright,Delon",115,265,.434,20,78,.256,95,187,.508,66,89,.742,29,112,141,138,42,40,15,50,316,2018/2019
"Yabusele,Guerschon",35,77,.455,9,28,.321,26,49,.531,15,22,.682,23,30,53,15,8,15,7,32,94,2018/2019
"Young,Nick",3,9,.333,3,8,.375,0,1,.000,0,0,,0,1,1,2,0,2,1,4,9,2018/2019
"Young,Thaddeus",443,841,.527,51,146,.349,392,695,.564,87,135,.644,192,331,523,204,123,123,36,194,1024,2018/2019
"Young,Trae",525,1256,.418,156,482,.324,369,774,.477,343,414,.829,64,237,301,653,72,308,15,140,1549,2018/2019
"Zeller,Cody",190,345,.551,6,22,.273,184,323,.570,111,141,.787,110,223,333,102,38,62,41,164,497,2018/2019
"Zeller,Tyler",16,30,.533,0,1,.000,16,29,.552,14,18,.778,11,13,24,4,1,4,3,20,46,2018/2019
"Zeller,Tyler",0,2,.000,0,1,.000,0,1,.000,0,0,,2,4,6,1,0,0,0,4,0,2018/2019
"Zeller,Tyler",16,28,.571,0,0,,16,28,.571,14,18,.778,9,9,18,3,1,4,3,16,46,2018/2019
"Žižić,Ante",183,331,.553,0,0,,183,331,.553,93,132,.705,108,212,320,53,13,61,22,113,459,2018/2019
"Zubac,Ivica",212,379,.559,0,0,,212,379,.559,101,126,.802,115,247,362,63,14,70,51,137,525,2018/2019
"Zubac,Ivica",112,193,.580,0,0,,112,193,.580,57,66,.864,54,108,162,25,4,33,27,73,281,2018/2019
"Zubac,Ivica",100,186,.538,0,0,,100,186,.538,44,60,.733,61,139,200,38,10,37,24,64,244,2018/2019
